event_time,event_name,surface,num_of_sets,playerA,playerB,winner,score,round,duration_minutes,a_aces,a_double_faults,a_first_serve_hits,a_first_serve_total,a_first_serve_won,a_first_serve_played,a_second_serve_won,a_second_serve_played,a_break_points_saved,a_break_points_total,a_service_games,a_service_points_won,a_service_points_total,b_aces,b_double_faults,b_first_serve_hits,b_first_serve_total,b_first_serve_won,b_first_serve_played,b_second_serve_won,b_second_serve_played,b_break_points_saved,b_break_points_total,b_service_games,b_service_points_won,b_service_points_total
2012-01-01 00:00:00.000,Brisbane Australia ATP World Tour 250,HARD,2,Andy Murray,Mikhail Kukushkin,Andy Murray,5-7; 6-3; 6-2,R32,130,10,0,57,92,41,57,17,35,4,7,15,58,92,4,3,41,77,29,41,15,36,4,9,14,44,77
2012-01-01 00:00:00.000,Brisbane Australia ATP World Tour 250,HARD,2,Gilles Muller,Ricardo Mello,Gilles Muller,6-7(3); 7-6(4); 6-3,R32,136,23,1,55,104,47,55,31,49,3,3,17,78,104,3,5,67,103,54,67,20,36,1,2,16,74,103
2012-01-01 00:00:00.000,Brisbane Australia ATP World Tour 250,HARD,2,Marcos Baghdatis,Ryan Harrison,Marcos Baghdatis,7-6(7); 6-4,R32,101,8,3,31,71,26,31,26,40,5,6,11,52,71,14,1,48,79,36,48,17,31,2,4,11,53,79
2012-01-01 00:00:00.000,Brisbane Australia ATP World Tour 250,HARD,2,Kei Nishikori,Cedrik-Marcel Stebe,Kei Nishikori,3-6; 6-1; 6-4,R32,130,1,2,49,75,31,49,16,26,3,6,13,47,75,4,2,49,90,27,49,23,41,9,14,13,50,90
2012-01-01 00:00:00.000,Brisbane Australia ATP World Tour 250,HARD,2,Denis Istomin,Florian Mayer,Denis Istomin,7-6(5); 2-3 RET,R32,69,10,1,28,56,23,28,18,28,2,2,8,41,56,2,1,38,55,28,38,11,17,0,0,9,39,55
2012-01-01 00:00:00.000,Brisbane Australia ATP World Tour 250,HARD,2,Tommy Haas,Marinko Matosevic,Tommy Haas,6-3; 7-5,R32,99,4,2,40,66,32,40,14,26,6,7,11,46,66,4,2,45,77,28,45,15,32,10,13,10,43,77
2012-01-01 00:00:00.000,Brisbane Australia ATP World Tour 250,HARD,2,Tatsuma Ito,Benjamin Mitchell,Tatsuma Ito,6-4; 6-2,R32,70,6,0,30,52,24,30,15,22,2,2,9,39,52,11,6,44,68,30,44,7,24,8,11,9,37,68
2012-01-01 00:00:00.000,Brisbane Australia ATP World Tour 250,HARD,2,Bernard Tomic,Julien Benneteau,Bernard Tomic,6-2; 4-6; 7-5,R32,147,7,2,53,92,36,53,23,39,4,7,15,59,92,14,12,71,121,48,71,19,50,16,21,15,67,121
2012-01-01 00:00:00.000,Brisbane Australia ATP World Tour 250,HARD,2,Radek Stepanek,Matthew Ebden,Radek Stepanek,6-4; 3-6; 6-3,R32,132,8,4,51,91,38,51,22,40,3,4,14,60,91,5,3,64,99,43,64,19,35,10,12,14,62,99
2012-01-01 00:00:00.000,Brisbane Australia ATP World Tour 250,HARD,2,Jarkko Nieminen,Jesse Levine,Jarkko Nieminen,7-6(4); 6-2,R32,101,3,0,53,71,32,53,10,18,6,9,10,42,71,3,6,63,90,36,63,10,27,9,14,10,46,90
2012-01-01 00:00:00.000,Brisbane Australia ATP World Tour 250,HARD,2,Igor Andreev,Adrian Mannarino,Igor Andreev,7-6(6); 6-2,R32,86,7,3,41,70,33,41,16,29,2,3,10,49,70,3,3,35,60,24,35,13,25,3,6,10,37,60
2012-01-01 00:00:00.000,Brisbane Australia ATP World Tour 250,HARD,2,Alexandr Dolgopolov,Alejandro Falla,Alexandr Dolgopolov,7-6(3); 6-2,R32,81,5,0,37,75,26,37,16,38,4,7,10,42,75,0,3,33,58,16,33,12,25,4,9,10,28,58
2012-01-01 00:00:00.000,Brisbane Australia ATP World Tour 250,HARD,2,Philipp Petzschner,Jurgen Melzer,Philipp Petzschner,6-1; 7-5,R32,66,8,1,37,61,31,37,13,24,2,2,10,44,61,5,2,34,54,21,34,9,20,0,3,9,30,54
2012-01-01 00:00:00.000,Brisbane Australia ATP World Tour 250,HARD,2,Santiago Giraldo,John Millman,Santiago Giraldo,6-3; 6-3,R32,60,5,0,36,54,30,36,9,18,2,2,9,39,54,4,1,28,46,18,28,9,18,1,4,9,27,46
2012-01-01 00:00:00.000,Brisbane Australia ATP World Tour 250,HARD,2,James Duckworth,Nicolas Mahut,James Duckworth,6-4; 6-4,R32,71,5,1,31,52,25,31,12,21,1,3,10,37,52,5,5,32,52,21,32,9,20,3,7,10,30,52
2012-01-01 00:00:00.000,Brisbane Australia ATP World Tour 250,HARD,2,Gilles Simon,Ryan Sweeting,Gilles Simon,6-3; 6-4,R32,83,3,1,43,63,32,43,10,20,1,2,10,42,63,2,4,31,60,23,31,10,29,5,8,9,33,60
2012-01-01 00:00:00.000,Brisbane Australia ATP World Tour 250,HARD,2,Andy Murray,Gilles Muller,Andy Murray,4-6; 7-6(4); 6-0,R16,120,9,5,49,82,44,49,12,33,2,4,14,56,82,10,1,56,92,39,56,17,36,2,6,14,56,92
2012-01-01 00:00:00.000,Brisbane Australia ATP World Tour 250,HARD,2,Marcos Baghdatis,Kei Nishikori,Marcos Baghdatis,6-3; 6-4,R16,79,10,2,33,63,26,33,13,30,3,5,10,39,63,0,0,30,50,16,30,9,20,3,7,9,25,50
2012-01-01 00:00:00.000,Brisbane Australia ATP World Tour 250,HARD,2,Denis Istomin,Tommy Haas,Denis Istomin,W/O,R16,0,0,0,0,0,0,0,0,0,0,0,0,0,0,0,0,0,0,0,0,0,0,0,0,0,0,0
2012-01-01 00:00:00.000,Brisbane Australia ATP World Tour 250,HARD,2,Bernard Tomic,Tatsuma Ito,Bernard Tomic,6-1; 6-2,R16,44,10,1,30,45,24,30,7,15,0,1,8,31,45,1,2,23,39,11,23,5,16,1,6,7,16,39
2012-01-01 00:00:00.000,Brisbane Australia ATP World Tour 250,HARD,2,Radek Stepanek,Jarkko Nieminen,Radek Stepanek,7-6(3); 6-2,R16,89,3,0,39,63,26,39,15,24,3,5,10,41,63,3,1,39,66,22,39,14,27,0,4,10,36,66
2012-01-01 00:00:00.000,Brisbane Australia ATP World Tour 250,HARD,2,Alexandr Dolgopolov,Igor Andreev,Alexandr Dolgopolov,6-7(3); 7-6(9); 6-2,R16,158,0,2,78,120,54,78,24,42,6,8,16,78,120,10,4,71,115,52,71,22,44,5,9,16,74,115
2012-01-01 00:00:00.000,Brisbane Australia ATP World Tour 250,HARD,2,Santiago Giraldo,Philipp Petzschner,Santiago Giraldo,6-4; 6-4,R16,76,1,2,35,59,27,35,15,24,0,0,10,42,59,9,1,38,66,29,38,13,28,1,3,10,42,66
2012-01-01 00:00:00.000,Brisbane Australia ATP World Tour 250,HARD,2,Gilles Simon,James Duckworth,Gilles Simon,6-3; 7-5,R16,90,11,4,31,66,26,31,21,35,0,1,11,47,66,8,1,38,67,25,38,15,29,5,8,10,40,67
2012-01-01 00:00:00.000,Brisbane Australia ATP World Tour 250,HARD,2,Andy Murray,Marcos Baghdatis,Andy Murray,6-2; 6-2,Q,66,3,2,31,52,26,31,10,21,2,2,8,36,52,2,3,19,40,12,19,7,21,0,4,8,19,40
2012-01-01 00:00:00.000,Brisbane Australia ATP World Tour 250,HARD,2,Bernard Tomic,Denis Istomin,Bernard Tomic,6-3; 7-6(4),Q,79,8,0,45,72,36,45,15,27,0,0,11,51,72,8,2,32,57,26,32,15,25,0,1,10,41,57
2012-01-01 00:00:00.000,Brisbane Australia ATP World Tour 250,HARD,2,Alexandr Dolgopolov,Radek Stepanek,Alexandr Dolgopolov,4-6; 6-3; 6-3,Q,136,16,2,52,88,33,52,21,36,3,6,14,54,88,2,4,48,92,34,48,18,44,8,13,14,52,92
2012-01-01 00:00:00.000,Brisbane Australia ATP World Tour 250,HARD,2,Gilles Simon,Santiago Giraldo,Gilles Simon,7-6(2); 6-4,Q,108,5,1,47,78,34,47,18,31,6,8,11,52,78,2,0,52,78,32,52,13,26,5,8,11,45,78
2012-01-01 00:00:00.000,Brisbane Australia ATP World Tour 250,HARD,2,Andy Murray,Bernard Tomic,Andy Murray,6-3; 6-2,S,71,13,1,34,48,30,34,8,14,0,0,9,38,48,3,1,29,52,21,29,10,23,8,11,8,31,52
2012-01-01 00:00:00.000,Brisbane Australia ATP World Tour 250,HARD,2,Alexandr Dolgopolov,Gilles Simon,Alexandr Dolgopolov,6-3; 6-4,S,82,3,0,27,48,23,27,15,21,1,1,9,38,48,6,1,38,65,24,38,16,27,4,7,10,40,65
2012-01-01 00:00:00.000,Brisbane Australia ATP World Tour 250,HARD,2,Andy Murray,Alexandr Dolgopolov,Andy Murray,6-1; 6-3,F,66,9,2,30,47,25,30,9,17,3,4,8,34,47,2,4,35,66,19,35,11,31,5,10,8,30,66
2012-01-02 00:00:00.000,Chennai India ATP World Tour 250,HARD,2,Janko Tipsarevic,N/A Bye,Janko Tipsarevic,,R32,0,0,0,0,0,0,0,0,0,0,0,0,0,0,0,0,0,0,0,0,0,0,0,0,0,0,0
2012-01-02 00:00:00.000,Chennai India ATP World Tour 250,HARD,2,Yuki Bhambri,Karol Beck,Yuki Bhambri,6-2; 6-3,R32,80,1,2,29,46,22,29,9,17,1,3,9,31,46,1,1,33,62,15,33,13,29,8,13,8,28,62
2012-01-02 00:00:00.000,Chennai India ATP World Tour 250,HARD,2,Andreas Beck,Vasek Pospisil,Andreas Beck,6-3; 7-6(8),R32,111,0,4,47,74,33,47,17,27,4,5,10,50,74,15,3,57,95,39,57,16,38,3,6,11,55,95
2012-01-02 00:00:00.000,Chennai India ATP World Tour 250,HARD,2,David Goffin,Xavier Malisse,David Goffin,4-6; 6-2; 6-3,R32,113,8,3,51,85,40,51,18,34,3,4,14,58,85,4,1,43,77,31,43,19,34,9,12,13,50,77
2012-01-02 00:00:00.000,Chennai India ATP World Tour 250,HARD,2,Stan Wawrinka,N/A Bye,Stan Wawrinka,,R32,0,0,0,0,0,0,0,0,0,0,0,0,0,0,0,0,0,0,0,0,0,0,0,0,0,0,0
2012-01-02 00:00:00.000,Chennai India ATP World Tour 250,HARD,2,Edouard Roger-Vasselin,Eric Prodon,Edouard Roger-Vasselin,6-4; 6-3,R32,71,5,2,30,49,22,30,12,19,2,3,9,34,49,2,3,33,59,21,33,13,26,3,7,10,34,59
2012-01-02 00:00:00.000,Chennai India ATP World Tour 250,HARD,2,Go Soeda,Frederico Gil,Go Soeda,6-2; 6-7(4); 7-5,R32,159,6,1,64,103,48,64,19,39,2,4,16,67,103,5,2,70,105,45,70,18,35,6,11,16,63,105
2012-01-02 00:00:00.000,Chennai India ATP World Tour 250,HARD,2,Ivan Dodig,Vishnu Vardhan,Ivan Dodig,4-6; 7-6(8); 6-1,R32,155,8,2,65,101,47,65,20,36,6,8,15,67,101,11,5,59,86,41,59,13,27,0,3,14,54,86
2012-01-02 00:00:00.000,Chennai India ATP World Tour 250,HARD,2,Dudi Sela,Fabio Fognini,Dudi Sela,6-0; 6-1,R32,59,2,0,17,33,14,17,11,16,1,1,6,25,33,1,4,32,58,17,32,5,26,8,14,7,22,58
2012-01-02 00:00:00.000,Chennai India ATP World Tour 250,HARD,2,Benoit Paire,Pere Riba,Benoit Paire,6-2; 6-1,R32,55,8,2,25,44,24,25,11,19,1,1,8,35,44,0,5,20,52,13,20,12,32,4,8,7,25,52
2012-01-02 00:00:00.000,Chennai India ATP World Tour 250,HARD,2,Victor Hanescu,Sam Querrey,Victor Hanescu,6-3; 6-4,R32,76,3,0,39,57,29,39,11,18,2,3,10,40,57,9,8,41,65,29,41,7,24,1,4,9,36,65
2012-01-02 00:00:00.000,Chennai India ATP World Tour 250,HARD,2,Milos Raonic,N/A Bye,Milos Raonic,,R32,0,0,0,0,0,0,0,0,0,0,0,0,0,0,0,0,0,0,0,0,0,0,0,0,0,0,0
2012-01-02 00:00:00.000,Chennai India ATP World Tour 250,HARD,2,Yuichi Sugita,Olivier Rochus,Yuichi Sugita,6-3; 6-4,R32,100,3,1,51,78,37,51,11,27,6,7,10,48,78,0,0,32,54,19,32,13,22,4,7,9,32,54
2012-01-02 00:00:00.000,Chennai India ATP World Tour 250,HARD,2,Yen-Hsun Lu,Thiemo de Bakker,Yen-Hsun Lu,6-3; 6-3,R32,86,1,3,36,57,29,36,9,21,0,1,9,38,57,5,0,32,56,20,32,10,24,2,6,9,30,56
2012-01-02 00:00:00.000,Chennai India ATP World Tour 250,HARD,2,Steve Darcis,Blaz Kavcic,Steve Darcis,4-6; 7-5; 6-3,R32,177,6,3,60,109,42,60,24,49,7,11,16,66,109,13,7,58,107,37,58,25,49,8,13,15,62,107
2012-01-02 00:00:00.000,Chennai India ATP World Tour 250,HARD,2,Nicolas Almagro,N/A Bye,Nicolas Almagro,,R32,0,0,0,0,0,0,0,0,0,0,0,0,0,0,0,0,0,0,0,0,0,0,0,0,0,0,0
2012-01-02 00:00:00.000,Chennai India ATP World Tour 250,HARD,2,Janko Tipsarevic,Yuki Bhambri,Janko Tipsarevic,6-1; 6-3,R16,62,5,1,20,41,17,20,16,21,1,1,8,33,41,3,2,22,39,12,22,9,17,0,4,8,21,39
2012-01-02 00:00:00.000,Chennai India ATP World Tour 250,HARD,2,David Goffin,Andreas Beck,David Goffin,4-6; 6-4; 6-2,R16,138,6,4,43,82,30,43,25,39,6,8,14,55,82,4,0,71,98,43,71,14,27,12,16,14,57,98
2012-01-02 00:00:00.000,Chennai India ATP World Tour 250,HARD,2,Stan Wawrinka,Edouard Roger-Vasselin,Stan Wawrinka,3-6; 6-3; 7-5,R16,145,10,1,52,82,35,52,19,30,2,6,15,54,82,4,0,70,104,43,70,16,34,6,11,15,59,104
2012-01-02 00:00:00.000,Chennai India ATP World Tour 250,HARD,2,Go Soeda,Ivan Dodig,Go Soeda,7-6(6); 6-3,R16,108,4,3,43,73,32,43,18,30,3,4,11,50,73,12,2,41,69,31,41,11,28,5,7,10,42,69
2012-01-02 00:00:00.000,Chennai India ATP World Tour 250,HARD,2,Dudi Sela,Benoit Paire,Dudi Sela,4-6; 6-2; 6-4,R16,121,3,2,60,87,44,60,17,27,6,7,14,61,87,10,5,58,104,40,58,21,46,4,7,14,61,104
2012-01-02 00:00:00.000,Chennai India ATP World Tour 250,HARD,2,Milos Raonic,Victor Hanescu,Milos Raonic,6-1; 6-4,R16,74,9,1,35,56,27,35,14,21,4,4,9,41,56,4,1,38,52,25,38,5,14,3,6,8,30,52
2012-01-02 00:00:00.000,Chennai India ATP World Tour 250,HARD,2,Yuichi Sugita,Yen-Hsun Lu,Yuichi Sugita,7-6(5); 6-4,R16,141,3,4,51,93,36,51,19,42,7,9,11,55,93,3,4,45,79,34,45,12,34,7,10,11,46,79
2012-01-02 00:00:00.000,Chennai India ATP World Tour 250,HARD,2,Nicolas Almagro,Steve Darcis,Nicolas Almagro,W/O,R16,0,0,0,0,0,0,0,0,0,0,0,0,0,0,0,0,0,0,0,0,0,0,0,0,0,0,0
2012-01-02 00:00:00.000,Chennai India ATP World Tour 250,HARD,2,Janko Tipsarevic,David Goffin,Janko Tipsarevic,6-2; 3-6; 6-2,Q,123,7,0,44,67,36,44,13,23,1,2,12,49,67,10,5,51,91,34,51,19,40,9,13,13,53,91
2012-01-02 00:00:00.000,Chennai India ATP World Tour 250,HARD,2,Go Soeda,Stan Wawrinka,Go Soeda,6-4; 6-4,Q,103,1,4,39,74,25,39,18,35,4,7,10,43,74,4,4,34,65,18,34,13,31,3,8,10,31,65
2012-01-02 00:00:00.000,Chennai India ATP World Tour 250,HARD,2,Milos Raonic,Dudi Sela,Milos Raonic,7-6(4); 6-3,Q,90,15,1,41,69,34,41,19,28,3,3,11,53,69,2,2,31,59,23,31,19,28,0,1,10,42,59
2012-01-02 00:00:00.000,Chennai India ATP World Tour 250,HARD,2,Nicolas Almagro,Yuichi Sugita,Nicolas Almagro,4-6; 7-6(8); 6-4,Q,164,6,0,65,123,43,65,35,58,9,12,16,78,123,3,1,65,105,36,65,30,40,3,6,16,66,105
2012-01-02 00:00:00.000,Chennai India ATP World Tour 250,HARD,2,Janko Tipsarevic,Go Soeda,Janko Tipsarevic,6-1; 6-4,S,79,4,0,31,44,25,31,9,13,0,1,9,34,44,1,1,33,61,21,33,10,28,2,6,8,31,61
2012-01-02 00:00:00.000,Chennai India ATP World Tour 250,HARD,2,Milos Raonic,Nicolas Almagro,Milos Raonic,6-4; 6-4,S,72,17,1,42,54,38,42,4,12,3,3,10,42,54,4,0,45,60,31,45,8,15,4,6,10,39,60
2012-01-02 00:00:00.000,Chennai India ATP World Tour 250,HARD,2,Milos Raonic,Janko Tipsarevic,Milos Raonic,6-7(4); 7-6(4); 7-6(4),F,194,35,1,83,113,73,83,15,30,4,4,18,88,113,8,2,83,138,59,83,34,55,9,9,18,93,138
2012-01-02 00:00:00.000,Doha Qatar ATP World Tour 250,HARD,2,Rafael Nadal,Philipp Kohlschreiber,Rafael Nadal,6-3; 6-7(2); 6-3,R32,153,7,0,67,90,47,67,15,23,2,4,16,62,90,6,1,64,100,41,64,18,36,8,12,14,59,100
2012-01-02 00:00:00.000,Doha Qatar ATP World Tour 250,HARD,2,Denis Gremelmayr,Potito Starace,Denis Gremelmayr,6-3; 6-2,R32,73,3,1,42,68,32,42,11,26,4,5,9,43,68,1,2,36,53,23,36,4,17,4,8,8,27,53
2012-01-02 00:00:00.000,Doha Qatar ATP World Tour 250,HARD,2,Ivo Karlovic,Sergiy Stakhovsky,Ivo Karlovic,6-7(1); 6-2; 7-6(3),R32,130,8,1,66,101,52,66,21,35,4,4,16,73,101,6,3,63,98,50,63,20,35,3,5,16,70,98
2012-01-02 00:00:00.000,Doha Qatar ATP World Tour 250,HARD,2,Mikhail Youzhny,Ernests Gulbis,Mikhail Youzhny,6-4; 6-7(4); 6-2,R32,135,4,2,75,98,51,75,15,23,6,8,15,66,98,11,8,61,96,38,61,17,35,4,9,15,55,96
2012-01-02 00:00:00.000,Doha Qatar ATP World Tour 250,HARD,2,Gael Monfils,Rui Machado,Gael Monfils,7-5; 6-3,R32,81,1,0,47,56,31,47,6,9,0,2,10,37,56,1,2,54,72,29,54,9,18,6,11,11,38,72
2012-01-02 00:00:00.000,Doha Qatar ATP World Tour 250,HARD,2,Benjamin Becker,Igor Kunitsyn,Benjamin Becker,6-4; 7-5,R32,95,3,0,41,61,28,41,11,20,0,2,11,39,61,8,1,47,75,30,47,10,28,3,7,11,40,75
2012-01-02 00:00:00.000,Doha Qatar ATP World Tour 250,HARD,2,Matthias Bachinger,Roberto Bautista Agut,Matthias Bachinger,6-3; 6-4,R32,93,4,1,48,79,30,48,19,31,5,6,10,49,79,4,0,39,64,24,39,12,25,8,11,9,36,64
2012-01-02 00:00:00.000,Doha Qatar ATP World Tour 250,HARD,2,Viktor Troicki,Lukas Rosol,Viktor Troicki,6-4; 7-6(4),R32,79,16,1,42,63,38,42,10,21,2,3,11,48,63,6,4,46,69,33,46,11,23,2,4,11,44,69
2012-01-02 00:00:00.000,Doha Qatar ATP World Tour 250,HARD,2,Alex Bogomolov Jr.,Filippo Volandri,Alex Bogomolov Jr.,5-7; 6-4; 6-2,R32,122,6,0,52,79,34,52,15,27,2,7,15,49,79,0,2,64,105,35,64,19,41,6,13,15,54,105
2012-01-02 00:00:00.000,Doha Qatar ATP World Tour 250,HARD,2,Albert Ramos-Vinolas,Dmitry Tursunov,Albert Ramos-Vinolas,7-5; 6-2,R32,92,3,4,34,59,28,34,13,25,5,6,10,41,59,5,0,47,65,27,47,7,18,8,12,10,34,65
2012-01-02 00:00:00.000,Doha Qatar ATP World Tour 250,HARD,2,Flavio Cipolla,Jabor Mohammed Ali Mutawa,Flavio Cipolla,6-0; 6-0,R32,37,0,1,19,29,18,19,6,10,0,0,6,24,29,0,7,17,37,7,17,3,20,4,10,6,10,37
2012-01-02 00:00:00.000,Doha Qatar ATP World Tour 250,HARD,2,Jo-Wilfried Tsonga,Malek Jaziri,Jo-Wilfried Tsonga,7-6(5); 6-7(5); 6-1,R32,140,12,1,77,121,62,77,23,44,5,5,16,85,121,8,4,64,99,51,64,16,35,2,4,15,67,99
2012-01-02 00:00:00.000,Doha Qatar ATP World Tour 250,HARD,2,Andreas Seppi,Lukasz Kubot,Andreas Seppi,6-2; 6-3,R32,70,5,0,29,46,23,29,10,17,5,6,8,33,46,4,6,32,57,21,32,7,25,7,12,9,28,57
2012-01-02 00:00:00.000,Doha Qatar ATP World Tour 250,HARD,2,Guillermo Garcia-Lopez,Pablo Andujar,Guillermo Garcia-Lopez,6-2; 2-6; 6-3,R32,116,2,4,60,85,42,60,11,25,8,11,13,53,85,1,1,43,66,29,43,12,23,1,5,12,41,66
2012-01-02 00:00:00.000,Doha Qatar ATP World Tour 250,HARD,2,Grega Zemlja,Sergei Bubka,Grega Zemlja,4-6; 6-1; 6-1,R32,92,3,2,42,73,32,42,16,31,6,8,12,48,73,5,4,46,72,26,46,11,26,2,8,12,37,72
2012-01-02 00:00:00.000,Doha Qatar ATP World Tour 250,HARD,2,Roger Federer,Nikolay Davydenko,Roger Federer,6-2; 6-2,R32,54,4,0,35,41,27,35,5,6,0,0,8,32,41,2,3,33,45,19,33,3,12,3,7,8,22,45
2012-01-02 00:00:00.000,Doha Qatar ATP World Tour 250,HARD,2,Rafael Nadal,Denis Gremelmayr,Rafael Nadal,6-2; 6-2,R16,90,1,0,28,40,24,28,9,12,1,1,8,33,40,2,2,50,79,29,50,12,29,11,15,8,41,79
2012-01-02 00:00:00.000,Doha Qatar ATP World Tour 250,HARD,2,Mikhail Youzhny,Ivo Karlovic,Mikhail Youzhny,6-2; 6-7(3); 6-3,R16,128,5,0,77,100,59,77,8,23,8,9,15,67,100,20,2,63,91,41,63,14,28,4,8,14,55,91
2012-01-02 00:00:00.000,Doha Qatar ATP World Tour 250,HARD,2,Gael Monfils,Benjamin Becker,Gael Monfils,7-5; 4-6; 7-5,R16,148,6,5,77,118,52,77,20,41,8,12,17,72,118,3,4,84,132,55,84,21,48,17,22,17,76,132
2012-01-02 00:00:00.000,Doha Qatar ATP World Tour 250,HARD,2,Viktor Troicki,Matthias Bachinger,Viktor Troicki,7-6(6); 6-1,R16,88,7,0,37,57,30,37,12,20,1,2,10,42,57,3,0,46,73,28,46,14,27,4,7,9,42,73
2012-01-02 00:00:00.000,Doha Qatar ATP World Tour 250,HARD,2,Albert Ramos-Vinolas,Alex Bogomolov Jr.,Albert Ramos-Vinolas,W/O,R16,0,0,0,0,0,0,0,0,0,0,0,0,0,0,0,0,0,0,0,0,0,0,0,0,0,0,0
2012-01-02 00:00:00.000,Doha Qatar ATP World Tour 250,HARD,2,Jo-Wilfried Tsonga,Flavio Cipolla,Jo-Wilfried Tsonga,7-6(8); 6-3,R16,107,6,2,40,67,29,40,13,27,1,3,10,42,67,0,1,65,81,38,65,7,16,6,10,11,45,81
2012-01-02 00:00:00.000,Doha Qatar ATP World Tour 250,HARD,2,Andreas Seppi,Guillermo Garcia-Lopez,Andreas Seppi,7-5; 6-3,R16,86,4,1,43,60,28,43,9,17,1,3,10,37,60,0,3,34,60,23,34,11,26,3,8,11,34,60
2012-01-02 00:00:00.000,Doha Qatar ATP World Tour 250,HARD,2,Roger Federer,Grega Zemlja,Roger Federer,6-2; 6-3,R16,61,2,0,32,49,24,32,14,17,2,2,9,38,49,5,0,26,50,19,26,9,24,3,6,8,28,50
2012-01-02 00:00:00.000,Doha Qatar ATP World Tour 250,HARD,2,Rafael Nadal,Mikhail Youzhny,Rafael Nadal,6-4; 6-4,Q,109,1,1,44,67,33,44,10,23,5,6,10,43,67,2,0,42,58,25,42,7,16,3,6,10,32,58
2012-01-02 00:00:00.000,Doha Qatar ATP World Tour 250,HARD,2,Gael Monfils,Viktor Troicki,Gael Monfils,6-2; 6-3,Q,72,4,3,34,49,26,34,7,15,3,4,8,33,49,0,0,38,62,20,38,10,24,6,11,9,30,62
2012-01-02 00:00:00.000,Doha Qatar ATP World Tour 250,HARD,2,Jo-Wilfried Tsonga,Albert Ramos-Vinolas,Jo-Wilfried Tsonga,6-2; 6-1,Q,68,5,2,31,44,26,31,6,13,3,3,7,32,44,0,3,32,56,15,32,12,24,3,8,8,27,56
2012-01-02 00:00:00.000,Doha Qatar ATP World Tour 250,HARD,2,Roger Federer,Andreas Seppi,Roger Federer,6-3; 5-7; 6-4,Q,98,12,2,66,95,47,66,14,29,5,9,16,61,95,6,0,47,78,31,47,16,31,4,9,15,47,78
2012-01-02 00:00:00.000,Doha Qatar ATP World Tour 250,HARD,2,Gael Monfils,Rafael Nadal,Gael Monfils,6-3; 6-4,S,96,4,1,52,68,36,52,8,16,2,3,10,44,68,1,1,36,50,23,36,6,14,0,3,9,29,50
2012-01-02 00:00:00.000,Doha Qatar ATP World Tour 250,HARD,2,Jo-Wilfried Tsonga,Roger Federer,Jo-Wilfried Tsonga,W/O,S,0,0,0,0,0,0,0,0,0,0,0,0,0,0,0,0,0,0,0,0,0,0,0,0,0,0,0
2012-01-02 00:00:00.000,Doha Qatar ATP World Tour 250,HARD,2,Jo-Wilfried Tsonga,Gael Monfils,Jo-Wilfried Tsonga,7-5; 6-3,F,117,2,0,32,60,24,32,20,28,1,2,11,44,60,0,1,37,53,24,37,7,16,0,3,10,31,53
2012-01-09 00:00:00.000,Auckland New Zealand ATP World Tour 250,HARD,2,David Ferrer,N/A Bye,David Ferrer,,R32,0,0,0,0,0,0,0,0,0,0,0,0,0,0,0,0,0,0,0,0,0,0,0,0,0,0,0
2012-01-09 00:00:00.000,Auckland New Zealand ATP World Tour 250,HARD,2,Lukas Rosol,Albert Ramos-Vinolas,Lukas Rosol,6-2; 6-4,R32,74,5,1,37,64,28,37,11,27,6,8,9,39,64,2,0,36,54,18,36,9,18,1,6,9,27,54
2012-01-09 00:00:00.000,Auckland New Zealand ATP World Tour 250,HARD,2,Potito Starace,Albert Montanes,Potito Starace,6-3; 6-2,R32,65,4,0,36,46,29,36,8,10,0,0,9,37,46,1,2,32,67,19,32,18,35,3,6,8,37,67
2012-01-09 00:00:00.000,Auckland New Zealand ATP World Tour 250,HARD,2,Alejandro Falla,Donald Young,Alejandro Falla,4-6; 6-3; 6-3,R32,119,5,5,57,91,34,57,21,34,6,9,14,55,91,4,4,53,85,37,53,11,32,6,11,14,48,85
2012-01-09 00:00:00.000,Auckland New Zealand ATP World Tour 250,HARD,2,Fernando Verdasco,N/A Bye,Fernando Verdasco,,R32,0,0,0,0,0,0,0,0,0,0,0,0,0,0,0,0,0,0,0,0,0,0,0,0,0,0,0
2012-01-09 00:00:00.000,Auckland New Zealand ATP World Tour 250,HARD,2,Carlos Berlocq,Filippo Volandri,Carlos Berlocq,6-5 RET,R32,67,2,2,33,46,18,33,6,13,6,9,5,24,46,0,2,24,45,12,24,8,21,4,8,6,20,45
2012-01-09 00:00:00.000,Auckland New Zealand ATP World Tour 250,HARD,2,Guillermo Garcia-Lopez,Igor Kunitsyn,Guillermo Garcia-Lopez,2-6; 6-4; 6-2,R32,124,3,3,56,87,36,56,14,31,9,14,13,50,87,7,2,49,87,32,49,15,38,4,10,13,47,87
2012-01-09 00:00:00.000,Auckland New Zealand ATP World Tour 250,HARD,2,Adrian Mannarino,Kevin Anderson,Adrian Mannarino,6-3; 6-3,R32,64,3,0,31,43,28,31,8,12,0,0,9,36,43,6,2,26,46,20,26,9,20,2,5,9,29,46
2012-01-09 00:00:00.000,Auckland New Zealand ATP World Tour 250,HARD,2,Thomaz Bellucci,Rui Machado,Thomaz Bellucci,6-3; 7-6(3),R32,103,7,2,37,69,30,37,22,32,1,1,11,52,69,1,4,50,75,34,50,14,25,5,6,10,48,75
2012-01-09 00:00:00.000,Auckland New Zealand ATP World Tour 250,HARD,2,Olivier Rochus,Tobias Kamke,Olivier Rochus,7-5; 6-4,R32,103,0,3,44,64,29,44,9,20,3,6,11,38,64,0,5,40,79,27,40,15,39,9,14,11,42,79
2012-01-09 00:00:00.000,Auckland New Zealand ATP World Tour 250,HARD,2,Benoit Paire,Juan Carlos Ferrero,Benoit Paire,6-3; 6-2,R32,60,8,0,22,53,19,22,20,31,1,1,9,39,53,0,2,33,51,19,33,9,18,5,8,8,28,51
2012-01-09 00:00:00.000,Auckland New Zealand ATP World Tour 250,HARD,2,Juan Ignacio Chela,N/A Bye,Juan Ignacio Chela,,R32,0,0,0,0,0,0,0,0,0,0,0,0,0,0,0,0,0,0,0,0,0,0,0,0,0,0,0
2012-01-09 00:00:00.000,Auckland New Zealand ATP World Tour 250,HARD,2,Philipp Kohlschreiber,Stephane Bohli,Philipp Kohlschreiber,6-4; 4-6; 6-4,R32,112,13,2,38,83,29,38,28,45,4,6,15,57,83,6,3,55,91,41,55,17,36,4,7,15,58,91
2012-01-09 00:00:00.000,Auckland New Zealand ATP World Tour 250,HARD,2,Ryan Harrison,Sam Querrey,Ryan Harrison,6-4; 6-3,R32,70,3,0,39,57,28,39,11,18,3,4,10,39,57,3,4,39,61,24,39,11,22,4,7,9,35,61
2012-01-09 00:00:00.000,Auckland New Zealand ATP World Tour 250,HARD,2,Santiago Giraldo,Michael Venus,Santiago Giraldo,6-4; 6-3,R32,66,2,1,35,51,26,35,12,16,0,0,9,38,51,4,1,31,59,19,31,15,28,2,5,10,34,59
2012-01-09 00:00:00.000,Auckland New Zealand ATP World Tour 250,HARD,2,Nicolas Almagro,N/A Bye,Nicolas Almagro,,R32,0,0,0,0,0,0,0,0,0,0,0,0,0,0,0,0,0,0,0,0,0,0,0,0,0,0,0
2012-01-09 00:00:00.000,Auckland New Zealand ATP World Tour 250,HARD,2,David Ferrer,Lukas Rosol,David Ferrer,6-4; 6-2,R16,61,5,1,41,53,33,41,6,12,0,0,9,39,53,5,2,28,48,22,28,7,20,1,4,9,29,48
2012-01-09 00:00:00.000,Auckland New Zealand ATP World Tour 250,HARD,2,Alejandro Falla,Potito Starace,Alejandro Falla,7-6(3); 6-3,R16,80,2,1,31,55,21,31,19,24,0,1,10,40,55,3,1,47,71,30,47,10,24,4,7,11,40,71
2012-01-09 00:00:00.000,Auckland New Zealand ATP World Tour 250,HARD,2,Fernando Verdasco,Carlos Berlocq,Fernando Verdasco,7-5; 7-6(3),R16,133,6,3,56,81,36,56,14,25,8,11,12,50,81,2,0,57,86,35,57,14,29,9,13,12,49,86
2012-01-09 00:00:00.000,Auckland New Zealand ATP World Tour 250,HARD,2,Guillermo Garcia-Lopez,Adrian Mannarino,Guillermo Garcia-Lopez,6-2; 6-3,R16,92,2,2,38,64,24,38,15,26,5,6,8,39,64,5,0,56,75,30,56,7,19,7,12,9,37,75
2012-01-09 00:00:00.000,Auckland New Zealand ATP World Tour 250,HARD,2,Olivier Rochus,Thomaz Bellucci,Olivier Rochus,7-6(6); 5-7; 7-6(5),R16,193,0,3,74,116,50,74,31,42,1,3,18,81,116,17,3,76,138,58,76,33,62,9,10,18,91,138
2012-01-09 00:00:00.000,Auckland New Zealand ATP World Tour 250,HARD,2,Benoit Paire,Juan Ignacio Chela,Benoit Paire,5-7; 6-2; 6-2,R16,118,12,3,48,88,36,48,18,40,6,10,14,54,88,0,2,61,97,33,61,17,36,6,13,14,50,97
2012-01-09 00:00:00.000,Auckland New Zealand ATP World Tour 250,HARD,2,Philipp Kohlschreiber,Ryan Harrison,Philipp Kohlschreiber,4-6; 6-4; 6-3,R16,116,9,3,51,86,38,51,18,35,4,7,14,56,86,6,7,52,88,34,52,17,36,3,8,15,51,88
2012-01-09 00:00:00.000,Auckland New Zealand ATP World Tour 250,HARD,2,Nicolas Almagro,Santiago Giraldo,Nicolas Almagro,6-4; 6-2,R16,68,11,0,27,42,24,27,12,15,0,0,9,36,42,7,2,35,64,19,35,17,29,5,8,9,36,64
2012-01-09 00:00:00.000,Auckland New Zealand ATP World Tour 250,HARD,2,David Ferrer,Alejandro Falla,David Ferrer,6-4; 4-6; 6-3,Q,127,0,4,60,93,37,60,16,33,4,9,15,53,93,2,3,60,88,34,60,13,28,2,8,14,47,88
2012-01-09 00:00:00.000,Auckland New Zealand ATP World Tour 250,HARD,2,Fernando Verdasco,Guillermo Garcia-Lopez,Fernando Verdasco,7-5; 6-4,Q,146,4,3,38,62,29,38,16,24,3,4,11,45,62,2,4,57,93,33,57,19,36,5,8,11,52,93
2012-01-09 00:00:00.000,Auckland New Zealand ATP World Tour 250,HARD,2,Olivier Rochus,Benoit Paire,Olivier Rochus,6-3; 6-7(5); 7-6(4),Q,150,2,4,84,124,57,84,22,40,6,9,17,79,124,21,6,62,107,48,62,20,45,2,6,16,68,107
2012-01-09 00:00:00.000,Auckland New Zealand ATP World Tour 250,HARD,2,Philipp Kohlschreiber,Nicolas Almagro,Philipp Kohlschreiber,7-6(5); 6-4,Q,94,9,1,46,78,34,46,19,32,2,2,11,53,78,8,2,40,61,34,40,11,21,1,2,11,45,61
2012-01-09 00:00:00.000,Auckland New Zealand ATP World Tour 250,HARD,2,David Ferrer,Fernando Verdasco,David Ferrer,6-3; 6-4,S,90,2,1,37,56,30,37,12,19,0,0,10,42,56,4,4,45,74,31,45,12,29,10,12,9,43,74
2012-01-09 00:00:00.000,Auckland New Zealand ATP World Tour 250,HARD,2,Olivier Rochus,Philipp Kohlschreiber,Olivier Rochus,6-7(4); 6-1; 6-4,S,148,1,4,69,112,48,69,20,43,4,7,15,68,112,8,1,52,87,32,52,18,35,3,9,14,50,87
2012-01-09 00:00:00.000,Auckland New Zealand ATP World Tour 250,HARD,2,David Ferrer,Olivier Rochus,David Ferrer,6-3; 6-4,F,96,9,1,32,70,26,32,19,38,3,4,10,45,70,0,1,33,55,17,33,15,22,1,4,9,32,55
2012-01-09 00:00:00.000,Sydney Australia ATP World Tour 250,HARD,2,Juan Martin Del Potro,N/A Bye,Juan Martin Del Potro,,R32,0,0,0,0,0,0,0,0,0,0,0,0,0,0,0,0,0,0,0,0,0,0,0,0,0,0,0
2012-01-09 00:00:00.000,Sydney Australia ATP World Tour 250,HARD,2,Lukasz Kubot,Ivan Dodig,Lukasz Kubot,7-6(4); 7-5,R32,112,5,2,45,85,34,45,21,40,4,5,12,55,85,6,1,41,65,31,41,15,24,4,6,12,46,65
2012-01-09 00:00:00.000,Sydney Australia ATP World Tour 250,HARD,2,Marcos Baghdatis,Dmitry Tursunov,Marcos Baghdatis,6-4; 6-4,R32,94,14,6,37,73,27,37,19,36,6,7,10,46,73,5,1,38,67,27,38,11,29,5,8,10,38,67
2012-01-09 00:00:00.000,Sydney Australia ATP World Tour 250,HARD,2,Matthew Ebden,Marcel Granollers,Matthew Ebden,6-1; 3-6; 6-3,R32,112,6,5,60,97,42,60,20,37,9,10,13,62,97,9,3,34,65,30,34,12,31,3,6,12,42,65
2012-01-09 00:00:00.000,Sydney Australia ATP World Tour 250,HARD,2,Feliciano Lopez,N/A Bye,Feliciano Lopez,,R32,0,0,0,0,0,0,0,0,0,0,0,0,0,0,0,0,0,0,0,0,0,0,0,0,0,0,0
2012-01-09 00:00:00.000,Sydney Australia ATP World Tour 250,HARD,2,Julien Benneteau,Andreas Seppi,Julien Benneteau,6-3; 6-4,R32,65,6,2,33,53,28,33,13,20,0,0,10,41,53,3,1,32,50,21,32,11,18,1,3,9,32,50
2012-01-09 00:00:00.000,Sydney Australia ATP World Tour 250,HARD,2,Alex Bogomolov Jr.,Robin Haase,Alex Bogomolov Jr.,6-4; 1-6; 6-4,R32,111,2,4,66,94,45,66,12,28,5,8,14,57,94,11,2,43,76,33,43,18,33,4,6,13,51,76
2012-01-09 00:00:00.000,Sydney Australia ATP World Tour 250,HARD,2,Viktor Troicki,Lleyton Hewitt,Viktor Troicki,4-6; 6-3; 6-2,R32,124,13,0,55,86,41,55,13,31,4,7,14,54,86,3,7,47,93,28,47,23,46,8,13,13,51,93
2012-01-09 00:00:00.000,Sydney Australia ATP World Tour 250,HARD,2,Ryan Sweeting,Gilles Muller,Ryan Sweeting,3-6; 7-6(2); 7-5,R32,124,3,4,53,94,45,53,25,41,1,2,16,70,94,10,3,55,90,48,55,19,35,2,3,17,67,90
2012-01-09 00:00:00.000,Sydney Australia ATP World Tour 250,HARD,2,Denis Istomin,Pablo Andujar,Denis Istomin,6-3; 2-6; 6-3,R32,119,6,1,46,77,33,46,20,31,5,7,13,53,77,4,4,52,95,31,52,24,43,7,10,13,55,95
2012-01-09 00:00:00.000,Sydney Australia ATP World Tour 250,HARD,2,Fabio Fognini,Michael Russell,Fabio Fognini,2-6; 6-2; 6-0,R32,105,5,3,46,74,30,46,12,28,4,7,11,42,74,1,1,48,62,21,48,7,14,2,8,11,28,62
2012-01-09 00:00:00.000,Sydney Australia ATP World Tour 250,HARD,2,Richard Gasquet,N/A Bye,Richard Gasquet,,R32,0,0,0,0,0,0,0,0,0,0,0,0,0,0,0,0,0,0,0,0,0,0,0,0,0,0,0
2012-01-09 00:00:00.000,Sydney Australia ATP World Tour 250,HARD,2,Radek Stepanek,Xavier Malisse,Radek Stepanek,6-7(4); 6-4; 6-4,R32,149,14,6,74,115,55,74,21,41,9,10,16,76,115,10,0,62,110,44,62,26,48,7,10,16,70,110
2012-01-09 00:00:00.000,Sydney Australia ATP World Tour 250,HARD,2,Jarkko Nieminen,James Duckworth,Jarkko Nieminen,6-2; 6-2,R32,77,2,1,62,73,41,62,4,11,9,10,8,45,73,3,4,22,54,15,22,9,32,3,8,8,24,54
2012-01-09 00:00:00.000,Sydney Australia ATP World Tour 250,HARD,2,Bobby Reynolds,Sergiy Stakhovsky,Bobby Reynolds,7-5; 6-3,R32,81,3,3,39,69,28,39,15,30,6,8,10,43,69,10,3,36,63,25,36,10,27,2,7,11,35,63
2012-01-09 00:00:00.000,Sydney Australia ATP World Tour 250,HARD,2,John Isner,N/A Bye,John Isner,,R32,0,0,0,0,0,0,0,0,0,0,0,0,0,0,0,0,0,0,0,0,0,0,0,0,0,0,0
2012-01-09 00:00:00.000,Sydney Australia ATP World Tour 250,HARD,2,Juan Martin Del Potro,Lukasz Kubot,Juan Martin Del Potro,6-4; 6-2,R16,95,6,2,43,63,30,43,12,20,4,4,9,42,63,1,4,33,54,20,33,13,21,3,6,9,33,54
2012-01-09 00:00:00.000,Sydney Australia ATP World Tour 250,HARD,2,Marcos Baghdatis,Matthew Ebden,Marcos Baghdatis,3-6; 7-5; 7-6(3),R16,133,4,2,44,88,36,44,29,44,3,5,16,65,88,9,3,72,112,51,72,22,40,7,9,17,73,112
2012-01-09 00:00:00.000,Sydney Australia ATP World Tour 250,HARD,2,Julien Benneteau,Feliciano Lopez,Julien Benneteau,6-3; 6-4,R16,82,4,1,44,59,31,44,12,15,3,3,10,43,59,5,2,30,51,22,30,10,21,0,2,9,32,51
2012-01-09 00:00:00.000,Sydney Australia ATP World Tour 250,HARD,2,Alex Bogomolov Jr.,Viktor Troicki,Alex Bogomolov Jr.,7-6(5); 6-4,R16,104,0,3,53,62,39,53,3,9,0,2,11,42,62,9,3,49,78,33,49,14,29,11,14,11,47,78
2012-01-09 00:00:00.000,Sydney Australia ATP World Tour 250,HARD,2,Denis Istomin,Ryan Sweeting,Denis Istomin,6-2; 6-1,R16,54,8,2,33,45,27,33,7,12,1,1,8,34,45,1,4,28,52,17,28,9,24,3,7,7,26,52
2012-01-09 00:00:00.000,Sydney Australia ATP World Tour 250,HARD,2,Richard Gasquet,Fabio Fognini,Richard Gasquet,6-2; 6-1,R16,56,1,2,28,43,24,28,9,15,2,2,8,33,43,0,3,28,47,14,28,8,19,4,8,7,22,47
2012-01-09 00:00:00.000,Sydney Australia ATP World Tour 250,HARD,2,Jarkko Nieminen,Radek Stepanek,Jarkko Nieminen,7-6(5); 5-7; 6-1,R16,144,4,7,75,101,44,75,11,26,4,10,15,55,101,1,2,71,103,37,71,15,32,6,14,16,52,103
2012-01-09 00:00:00.000,Sydney Australia ATP World Tour 250,HARD,2,Bobby Reynolds,John Isner,Bobby Reynolds,3-6; 6-4; 6-3,R16,112,9,1,57,78,42,57,12,21,1,3,14,54,78,20,3,56,91,41,56,15,35,4,7,14,56,91
2012-01-09 00:00:00.000,Sydney Australia ATP World Tour 250,HARD,2,Marcos Baghdatis,Juan Martin Del Potro,Marcos Baghdatis,7-6(7); 6-4,Q,101,12,1,44,69,32,44,18,25,2,3,11,50,69,7,1,44,66,36,44,12,22,3,5,11,48,66
2012-01-09 00:00:00.000,Sydney Australia ATP World Tour 250,HARD,2,Julien Benneteau,Alex Bogomolov Jr.,Julien Benneteau,6-2; 6-4,Q,95,2,2,26,52,19,26,13,26,3,5,9,32,52,0,2,50,71,26,50,9,21,8,13,9,35,71
2012-01-09 00:00:00.000,Sydney Australia ATP World Tour 250,HARD,2,Denis Istomin,Richard Gasquet,Denis Istomin,6-4; 7-6(4),Q,112,8,3,42,84,31,42,22,42,5,7,11,53,84,9,2,47,80,31,47,16,33,5,8,11,47,80
2012-01-09 00:00:00.000,Sydney Australia ATP World Tour 250,HARD,2,Jarkko Nieminen,Bobby Reynolds,Jarkko Nieminen,6-3; 6-3,Q,68,5,1,37,48,25,37,6,11,4,6,9,31,48,3,2,28,52,19,28,6,24,2,7,9,25,52
2012-01-09 00:00:00.000,Sydney Australia ATP World Tour 250,HARD,2,Julien Benneteau,Marcos Baghdatis,Julien Benneteau,6-4; 6-4,S,116,4,5,57,87,38,57,14,30,8,10,10,52,87,7,2,39,72,24,39,15,33,4,8,10,39,72
2012-01-09 00:00:00.000,Sydney Australia ATP World Tour 250,HARD,2,Jarkko Nieminen,Denis Istomin,Jarkko Nieminen,7-6(12); 6-3,S,105,0,2,60,84,41,60,14,24,1,2,11,55,84,7,2,51,74,37,51,11,23,4,6,10,48,74
2012-01-09 00:00:00.000,Sydney Australia ATP World Tour 250,HARD,2,Jarkko Nieminen,Julien Benneteau,Jarkko Nieminen,6-2; 7-5,F,80,4,1,43,54,32,43,6,11,0,1,10,38,54,2,3,40,57,24,40,8,17,2,6,10,32,57
2012-01-16 00:00:00.000,Australian Open Australia Grand Slams,HARD,3,Novak Djokovic,Paolo Lorenzi,Novak Djokovic,6-2; 6-0; 6-0,R128,92,4,1,45,62,33,45,8,17,4,5,10,41,62,0,5,32,61,18,32,2,29,4,13,10,20,61
2012-01-16 00:00:00.000,Australian Open Australia Grand Slams,HARD,3,Santiago Giraldo,Matteo Viola,Santiago Giraldo,6-4; 6-2; 6-1,R128,101,0,1,38,62,29,38,17,24,2,3,12,46,62,2,4,47,80,26,47,12,33,9,15,13,38,80
2012-01-16 00:00:00.000,Australian Open Australia Grand Slams,HARD,3,Tatsuma Ito,Potito Starace,Tatsuma Ito,6-3; 4-6; 6-3; 6-4,R128,144,10,3,65,112,52,65,26,47,5,7,19,78,112,9,3,73,103,50,73,18,30,4,9,19,68,103
2012-01-16 00:00:00.000,Australian Open Australia Grand Slams,HARD,3,Nicolas Mahut,Radek Stepanek,Nicolas Mahut,7-5; 7-5; 6-3,R128,160,8,4,66,111,52,66,17,45,6,9,17,69,111,3,3,70,102,42,70,13,32,10,16,16,55,102
2012-01-16 00:00:00.000,Australian Open Australia Grand Slams,HARD,3,Milos Raonic,Filippo Volandri,Milos Raonic,6-4; 6-0; 6-2,R128,91,13,4,43,69,36,43,15,26,5,5,12,51,69,0,5,37,84,21,37,21,47,6,12,12,42,84
2012-01-16 00:00:00.000,Australian Open Australia Grand Slams,HARD,3,Philipp Petzschner,Lukas Rosol,Philipp Petzschner,6-0; 6-0; 6-2,R128,85,10,2,31,55,27,31,12,24,0,1,10,39,55,7,5,47,84,21,47,11,37,5,14,10,32,84
2012-01-16 00:00:00.000,Australian Open Australia Grand Slams,HARD,3,Lleyton Hewitt,Cedrik-Marcel Stebe,Lleyton Hewitt,7-5; 6-4; 3-6; 7-5,R128,238,8,2,69,130,53,69,30,61,6,10,21,83,130,13,6,89,151,59,89,31,62,13,19,22,90,151
2012-01-16 00:00:00.000,Australian Open Australia Grand Slams,HARD,3,Andy Roddick,Robin Haase,Andy Roddick,6-3; 6-4; 6-1,R128,103,13,1,56,78,41,56,14,22,4,5,13,55,78,7,6,40,76,27,40,13,36,7,13,13,40,76
2012-01-16 00:00:00.000,Australian Open Australia Grand Slams,HARD,3,Janko Tipsarevic,Dmitry Tursunov,Janko Tipsarevic,5-7; 7-6(12); 6-3; 6-4,R128,223,28,4,88,129,72,88,23,41,2,4,22,95,129,9,5,87,145,65,87,29,58,5,8,21,94,145
2012-01-16 00:00:00.000,Australian Open Australia Grand Slams,HARD,3,James Duckworth,Jurgen Zopp,James Duckworth,6-3; 6-4; 6-4,R128,99,11,3,56,89,44,56,19,33,3,4,15,63,89,6,4,46,77,31,46,15,31,5,9,14,46,77
2012-01-16 00:00:00.000,Australian Open Australia Grand Slams,HARD,3,Andrey Golubev,Mikhail Youzhny,Andrey Golubev,7-5; 6-7(4); 6-4; 4-6; 6-3,R128,293,12,10,122,196,80,122,31,74,15,22,27,111,196,7,6,117,189,73,117,31,72,10,20,26,104,189
2012-01-16 00:00:00.000,Australian Open Australia Grand Slams,HARD,3,Richard Gasquet,Andreas Seppi,Richard Gasquet,6-3; 3-6; 6-3; 6-1,R128,151,9,3,63,97,49,63,15,34,3,6,17,64,97,8,6,59,113,35,59,25,54,10,17,17,60,113
2012-01-16 00:00:00.000,Australian Open Australia Grand Slams,HARD,3,Juan Ignacio Chela,Michael Russell,Juan Ignacio Chela,7-6(3); 6-3; 6-4,R128,186,5,1,72,118,44,72,29,46,6,11,16,73,118,3,7,72,116,40,72,21,44,7,14,15,61,116
2012-01-16 00:00:00.000,Australian Open Australia Grand Slams,HARD,3,Pablo Andujar,Igor Kunitsyn,Pablo Andujar,6-1; 7-6(12); 6-0,R128,132,4,4,53,86,39,53,13,33,3,7,13,52,86,1,3,55,91,30,55,11,36,5,14,12,41,91
2012-01-16 00:00:00.000,Australian Open Australia Grand Slams,HARD,3,Ryan Sweeting,Matthias Bachinger,Ryan Sweeting,6-4; 6-4; 6-2,R128,107,8,5,55,79,47,55,14,24,3,3,14,61,79,4,4,56,94,39,56,18,38,4,8,14,57,94
2012-01-16 00:00:00.000,Australian Open Australia Grand Slams,HARD,3,David Ferrer,Rui Machado,David Ferrer,6-1; 6-4; 6-2,R128,104,2,1,40,68,34,40,14,28,2,4,13,48,68,0,4,54,81,27,54,11,27,2,9,12,38,81
2012-01-16 00:00:00.000,Australian Open Australia Grand Slams,HARD,3,Andy Murray,Ryan Harrison,Andy Murray,4-6; 6-3; 6-4; 6-2,R128,192,8,5,65,120,46,65,33,55,5,7,19,79,120,8,8,77,122,51,77,21,45,9,14,18,72,122
2012-01-16 00:00:00.000,Australian Open Australia Grand Slams,HARD,3,Edouard Roger-Vasselin,Xavier Malisse,Edouard Roger-Vasselin,7-6(6) RET,R128,64,6,0,31,43,23,31,8,12,1,2,6,31,43,3,2,31,57,23,31,12,26,6,7,6,35,57
2012-01-16 00:00:00.000,Australian Open Australia Grand Slams,HARD,3,Michael Llodra,Ernests Gulbis,Michael Llodra,2-6; 6-1; 6-2; 6-2,R128,140,11,2,75,100,53,75,14,25,9,11,16,67,100,6,8,56,96,37,56,16,40,11,17,15,53,96
2012-01-16 00:00:00.000,Australian Open Australia Grand Slams,HARD,3,Alex Bogomolov Jr.,Daniel Gimeno-Traver,Alex Bogomolov Jr.,6-3; 6-2; 6-4,R128,116,3,0,66,75,47,66,5,9,2,4,13,52,75,4,4,80,118,42,80,16,38,7,14,14,58,118
2012-01-16 00:00:00.000,Australian Open Australia Grand Slams,HARD,3,Viktor Troicki,Juan Carlos Ferrero,Viktor Troicki,4-6; 6-7(3); 6-2; 7-6(3); 6-2,R128,227,27,3,96,161,78,96,32,65,6,9,25,110,161,3,3,102,163,67,102,36,61,6,12,25,103,163
2012-01-16 00:00:00.000,Australian Open Australia Grand Slams,HARD,3,Mikhail Kukushkin,Guillermo Garcia-Lopez,Mikhail Kukushkin,6-4; 6-3; 6-0,R128,113,5,0,45,75,34,45,20,30,1,2,13,54,75,1,3,49,77,27,49,14,28,5,11,12,41,77
2012-01-16 00:00:00.000,Australian Open Australia Grand Slams,HARD,3,Thomaz Bellucci,Dudi Sela,Thomaz Bellucci,7-6(5); 6-4; 6-3,R128,144,10,4,47,99,38,47,30,52,4,6,15,68,99,7,5,65,119,42,65,27,54,5,10,16,69,119
2012-01-16 00:00:00.000,Australian Open Australia Grand Slams,HARD,3,Gael Monfils,Marinko Matosevic,Gael Monfils,7-6(5); 6-3; 6-3,R128,142,12,6,61,111,43,61,26,50,8,10,15,69,111,3,7,61,112,41,61,19,51,6,11,15,60,112
2012-01-16 00:00:00.000,Australian Open Australia Grand Slams,HARD,3,Gilles Simon,Danai Udomchoke,Gilles Simon,6-1; 3-6; 6-7(5); 6-3; 6-2,R128,200,13,2,72,135,48,72,40,63,6,11,22,88,135,4,4,82,136,48,82,26,54,3,13,23,74,136
2012-01-16 00:00:00.000,Australian Open Australia Grand Slams,HARD,3,Julien Benneteau,Karol Beck,Julien Benneteau,6-4; 6-2; 7-5,R128,120,6,3,53,84,37,53,23,31,2,3,15,60,84,7,2,50,89,31,50,20,39,7,12,15,51,89
2012-01-16 00:00:00.000,Australian Open Australia Grand Slams,HARD,3,Matthew Ebden,Joao Souza,Matthew Ebden,6-3; 7-6(1); 6-2,R128,137,10,3,62,89,51,62,14,27,1,2,15,65,89,8,2,72,110,45,72,16,38,12,16,14,61,110
2012-01-16 00:00:00.000,Australian Open Australia Grand Slams,HARD,3,Kei Nishikori,Stephane Robert,Kei Nishikori,6-1; 7-6(7); 6-0,R128,112,7,0,62,86,47,62,12,24,2,3,12,59,86,2,5,49,92,31,49,13,43,5,12,13,44,92
2012-01-16 00:00:00.000,Australian Open Australia Grand Slams,HARD,3,Marcel Granollers,Jesse Levine,Marcel Granollers,6-0; 7-6(4); 5-7; 5-7; 6-3,R128,243,24,5,94,149,79,94,26,55,4,7,26,105,149,7,3,119,172,80,119,24,53,11,16,25,104,172
2012-01-16 00:00:00.000,Australian Open Australia Grand Slams,HARD,3,Frederico Gil,Ivan Dodig,Frederico Gil,2-6; 6-1; 6-1; 4-1 RET,R128,121,3,0,56,78,36,56,14,22,11,14,13,50,78,6,4,41,80,26,41,10,39,4,12,14,36,80
2012-01-16 00:00:00.000,Australian Open Australia Grand Slams,HARD,3,Ricardo Mello,Roberto Bautista Agut,Ricardo Mello,6-4; 6-4; 7-5,R128,156,3,4,62,93,42,62,17,31,5,9,16,59,93,6,9,72,129,45,72,21,57,5,12,16,66,129
2012-01-16 00:00:00.000,Australian Open Australia Grand Slams,HARD,3,Jo-Wilfried Tsonga,Denis Istomin,Jo-Wilfried Tsonga,6-4; 3-6; 6-2; 7-5,R128,174,11,5,59,120,42,59,34,61,6,9,19,76,120,9,3,78,112,50,78,18,34,3,9,20,68,112
2012-01-16 00:00:00.000,Australian Open Australia Grand Slams,HARD,3,Mardy Fish,Gilles Muller,Mardy Fish,6-4; 6-4; 6-2,R128,123,11,2,45,73,41,45,18,28,3,3,14,59,73,10,2,65,97,45,65,14,32,9,13,14,59,97
2012-01-16 00:00:00.000,Australian Open Australia Grand Slams,HARD,3,Alejandro Falla,Fabio Fognini,Alejandro Falla,6-3; 6-2; 3-6; 6-1,R128,150,5,3,78,118,53,78,21,40,5,7,17,74,118,2,8,66,119,43,66,20,53,4,11,16,63,119
2012-01-16 00:00:00.000,Australian Open Australia Grand Slams,HARD,3,Pere Riba,Albert Montanes,Pere Riba,7-6(2); 2-6; 6-4; 7-6(5),R128,193,16,3,82,134,57,82,25,52,8,14,21,82,134,2,7,101,154,67,101,26,53,9,14,21,93,154
2012-01-16 00:00:00.000,Australian Open Australia Grand Slams,HARD,3,Philipp Kohlschreiber,Juan Monaco,Philipp Kohlschreiber,7-5; 4-6; 6-3; 6-7(4); 6-0,R128,235,9,2,84,143,64,84,35,59,5,8,24,99,143,2,1,110,154,68,110,22,44,6,14,25,90,154
2012-01-16 00:00:00.000,Australian Open Australia Grand Slams,HARD,3,Yen-Hsun Lu,Rik De Voest,Yen-Hsun Lu,6-4; 3-6; 6-1; 3-6; 6-3,R128,210,7,4,78,132,61,78,25,54,6,9,22,86,132,10,0,91,135,61,91,23,44,5,10,22,84,135
2012-01-16 00:00:00.000,Australian Open Australia Grand Slams,HARD,3,Florent Serra,Steve Darcis,Florent Serra,6-7(3); 3-6; 5-4 RET,R128,151,5,2,65,107,38,65,21,42,8,13,14,59,107,4,1,77,102,50,77,12,25,7,10,15,62,102
2012-01-16 00:00:00.000,Australian Open Australia Grand Slams,HARD,3,Blaz Kavcic,James Ward,Blaz Kavcic,6-4; 6-3; 6-4,R128,137,2,5,61,101,45,61,20,40,4,7,15,65,101,7,3,36,76,24,36,18,40,6,11,14,42,76
2012-01-16 00:00:00.000,Australian Open Australia Grand Slams,HARD,3,Juan Martin Del Potro,Adrian Mannarino,Juan Martin Del Potro,2-6; 6-1; 7-5; 6-4,R128,179,11,6,80,138,60,80,23,58,9,13,19,83,138,7,3,69,101,48,69,11,32,2,8,18,59,101
2012-01-16 00:00:00.000,Australian Open Australia Grand Slams,HARD,3,Alexandr Dolgopolov,Greg Jones,Alexandr Dolgopolov,1-6; 4-6; 6-1; 6-1; 6-2,R128,150,15,1,53,92,41,53,23,39,1,5,19,64,92,8,8,65,121,45,65,21,56,10,18,20,66,121
2012-01-16 00:00:00.000,Australian Open Australia Grand Slams,HARD,3,Tobias Kamke,Victor Hanescu,Tobias Kamke,6-2; 6-1; 6-2,R128,105,1,3,37,66,27,37,18,29,0,2,12,45,66,1,1,71,95,32,71,9,24,16,24,11,41,95
2012-01-16 00:00:00.000,Australian Open Australia Grand Slams,HARD,3,Sam Querrey,Kenny De Schepper,Sam Querrey,6-3; 6-2; 6-2,R128,86,12,4,47,81,42,47,17,34,5,5,13,59,81,5,7,37,71,26,37,12,34,3,8,12,38,71
2012-01-16 00:00:00.000,Australian Open Australia Grand Slams,HARD,3,Bernard Tomic,Fernando Verdasco,Bernard Tomic,4-6; 6-7(3); 6-4; 6-2; 7-5,R128,251,7,3,104,171,73,104,36,67,9,13,26,109,171,15,11,106,178,70,106,36,72,14,21,26,106,178
2012-01-16 00:00:00.000,Australian Open Australia Grand Slams,HARD,3,Ivo Karlovic,Jurgen Melzer,Ivo Karlovic,7-6(3); 7-5; 6-3,R128,124,24,3,81,104,61,81,10,23,5,7,16,71,104,2,8,66,102,47,66,16,36,5,10,17,63,102
2012-01-16 00:00:00.000,Australian Open Australia Grand Slams,HARD,3,Carlos Berlocq,Jesse Huta Galung,Carlos Berlocq,2-6; 6-3; 7-6(3); 6-3,R128,206,9,3,85,127,63,85,15,42,8,13,20,78,127,8,12,64,122,50,64,23,58,7,12,18,73,122
2012-01-16 00:00:00.000,Australian Open Australia Grand Slams,HARD,3,Andreas Beck,Eric Prodon,Andreas Beck,6-4; 6-2; 4-6; 7-5,R128,152,2,8,79,126,58,79,23,47,7,10,20,81,126,14,3,87,127,48,87,27,40,8,14,20,75,127
2012-01-16 00:00:00.000,Australian Open Australia Grand Slams,HARD,3,Roger Federer,Alexander Kudryavtsev,Roger Federer,7-5; 6-2; 6-2,R128,98,14,2,56,87,44,56,18,31,3,4,14,62,87,4,4,36,89,23,36,22,53,7,13,14,45,89
2012-01-16 00:00:00.000,Australian Open Australia Grand Slams,HARD,3,Tomas Berdych,Albert Ramos-Vinolas,Tomas Berdych,7-5; 4-6; 6-2; 6-3,R128,172,7,6,59,113,51,59,29,54,2,4,20,80,113,4,4,61,113,42,61,27,52,2,7,19,69,113
2012-01-16 00:00:00.000,Australian Open Australia Grand Slams,HARD,3,Olivier Rochus,Bjorn Phau,Olivier Rochus,6-1; 6-4; 6-0,R128,94,7,1,41,68,33,41,18,27,3,4,12,51,68,2,4,31,63,14,31,13,32,3,10,11,27,63
2012-01-16 00:00:00.000,Australian Open Australia Grand Slams,HARD,3,Sergiy Stakhovsky,Illya Marchenko,Sergiy Stakhovsky,6-3; 6-7(9); 4-6; 6-3; 7-5,R128,266,13,9,128,199,85,128,37,71,9,13,27,122,199,2,18,97,176,66,97,34,79,13,19,25,100,176
2012-01-16 00:00:00.000,Australian Open Australia Grand Slams,HARD,3,Kevin Anderson,Frederik Nielsen,Kevin Anderson,6-1; 6-2; 6-4,R128,113,5,4,55,86,41,55,17,31,5,6,13,58,86,0,3,48,80,28,48,11,32,7,13,12,39,80
2012-01-16 00:00:00.000,Australian Open Australia Grand Slams,HARD,3,Stan Wawrinka,Benoit Paire,Stan Wawrinka,6-1; 6-1; 7-5,R128,100,1,3,59,98,41,59,24,39,10,11,13,65,98,3,6,45,83,28,45,11,38,4,11,13,39,83
2012-01-16 00:00:00.000,Australian Open Australia Grand Slams,HARD,3,Marcos Baghdatis,Benjamin Becker,Marcos Baghdatis,6-1; 7-6(5); 6-2,R128,109,18,1,36,80,33,36,26,44,5,6,13,59,80,5,1,44,79,32,44,13,35,2,8,14,45,79
2012-01-16 00:00:00.000,Australian Open Australia Grand Slams,HARD,3,Grigor Dimitrov,Jeremy Chardy,Grigor Dimitrov,4-6; 6-3; 3-6; 6-4; 6-4,R128,197,11,6,91,156,68,91,33,65,19,22,24,101,156,19,8,77,140,64,77,29,63,11,15,24,93,140
2012-01-16 00:00:00.000,Australian Open Australia Grand Slams,HARD,3,Nicolas Almagro,Lukasz Kubot,Nicolas Almagro,1-6; 7-5; 6-3; 7-5,R128,182,15,3,82,129,62,82,22,47,9,12,20,84,129,7,15,75,136,53,75,29,61,7,11,20,82,136
2012-01-16 00:00:00.000,Australian Open Australia Grand Slams,HARD,3,John Isner,Benjamin Mitchell,John Isner,6-4; 6-4; 7-6(1),R128,124,19,4,63,95,54,63,16,32,5,6,16,70,95,7,8,48,99,37,48,26,51,5,8,16,63,99
2012-01-16 00:00:00.000,Australian Open Australia Grand Slams,HARD,3,David Nalbandian,Jarkko Nieminen,David Nalbandian,6-4; 4-2 RET,R128,67,3,0,25,44,14,25,12,19,2,4,8,26,44,3,1,36,58,16,36,12,22,1,5,9,28,58
2012-01-16 00:00:00.000,Australian Open Australia Grand Slams,HARD,3,Flavio Cipolla,Nikolay Davydenko,Flavio Cipolla,6-4; 4-6; 3-6; 6-2; 6-1,R128,201,2,6,104,134,58,104,16,30,2,11,22,74,134,3,8,91,139,48,91,21,48,11,22,22,69,139
2012-01-16 00:00:00.000,Australian Open Australia Grand Slams,HARD,3,Feliciano Lopez,Leonardo Mayer,Feliciano Lopez,7-6(5); 6-3; 7-6(2),R128,198,8,6,74,129,57,74,31,55,11,12,17,88,129,13,9,64,118,46,64,28,54,8,10,16,74,118
2012-01-16 00:00:00.000,Australian Open Australia Grand Slams,HARD,3,Lukas Lacko,Ivan Ljubicic,Lukas Lacko,3-6; 4-6; 6-3; 6-4; 6-4,R128,189,27,4,78,122,63,78,28,44,5,8,24,91,122,13,3,80,136,61,80,29,56,7,11,24,90,136
2012-01-16 00:00:00.000,Australian Open Australia Grand Slams,HARD,3,Donald Young,Peter Gojowczyk,Donald Young,6-1; 6-2; 4-6; 1-6; 6-2,R128,158,5,7,73,117,49,73,23,44,5,9,20,72,117,4,4,72,123,41,72,22,51,8,17,20,63,123
2012-01-16 00:00:00.000,Australian Open Australia Grand Slams,HARD,3,Tommy Haas,Denis Kudla,Tommy Haas,7-6(5); 3-6; 6-0; 7-5,R128,144,20,1,73,104,60,73,19,31,1,3,19,79,104,14,8,78,138,56,78,29,60,11,16,20,85,138
2012-01-16 00:00:00.000,Australian Open Australia Grand Slams,HARD,3,Rafael Nadal,Alex Kuznetsov,Rafael Nadal,6-4; 6-1; 6-1,R128,106,8,2,42,62,36,42,13,20,2,2,12,49,62,5,2,49,75,24,49,12,26,4,10,12,36,75
2012-01-16 00:00:00.000,Australian Open Australia Grand Slams,HARD,3,Novak Djokovic,Santiago Giraldo,Novak Djokovic,6-3; 6-2; 6-1,R64,102,9,2,36,65,29,36,19,29,1,2,12,48,65,3,3,38,73,24,38,11,35,6,13,12,35,73
2012-01-16 00:00:00.000,Australian Open Australia Grand Slams,HARD,3,Nicolas Mahut,Tatsuma Ito,Nicolas Mahut,1-6; 7-6(6); 6-2; 6-2,R64,170,8,2,83,121,53,83,14,38,5,11,18,67,121,3,5,77,125,48,77,21,48,9,16,17,69,125
2012-01-16 00:00:00.000,Australian Open Australia Grand Slams,HARD,3,Milos Raonic,Philipp Petzschner,Milos Raonic,6-4; 5-7; 6-2; 7-5,R64,175,17,6,67,123,54,67,30,56,9,11,21,84,123,10,4,73,135,58,73,25,62,2,7,21,83,135
2012-01-16 00:00:00.000,Australian Open Australia Grand Slams,HARD,3,Lleyton Hewitt,Andy Roddick,Lleyton Hewitt,3-6; 6-3; 6-4 RET,R64,132,11,2,45,78,37,45,17,33,3,5,14,54,78,8,2,56,91,38,56,19,35,4,7,14,57,91
2012-01-16 00:00:00.000,Australian Open Australia Grand Slams,HARD,3,Janko Tipsarevic,James Duckworth,Janko Tipsarevic,3-6; 6-2; 7-6(5); 6-4,R64,191,11,3,62,105,49,62,26,43,2,5,19,75,105,9,6,99,145,65,99,20,46,11,15,20,85,145
2012-01-16 00:00:00.000,Australian Open Australia Grand Slams,HARD,3,Richard Gasquet,Andrey Golubev,Richard Gasquet,6-4; 6-2; 3-0 RET,R64,99,5,0,37,60,28,37,12,23,0,2,11,40,60,4,5,54,82,25,54,13,28,11,17,10,38,82
2012-01-16 00:00:00.000,Australian Open Australia Grand Slams,HARD,3,Juan Ignacio Chela,Pablo Andujar,Juan Ignacio Chela,6-4; 6-4; 6-3,R64,144,1,3,68,96,40,68,15,28,7,12,15,55,96,0,5,51,89,26,51,15,38,7,15,14,41,89
2012-01-16 00:00:00.000,Australian Open Australia Grand Slams,HARD,3,David Ferrer,Ryan Sweeting,David Ferrer,6-7(4); 6-2; 3-6; 6-2; 6-3,R64,208,6,5,99,145,68,99,24,46,7,10,23,92,145,5,9,95,147,60,95,24,52,3,10,23,84,147
2012-01-16 00:00:00.000,Australian Open Australia Grand Slams,HARD,3,Andy Murray,Edouard Roger-Vasselin,Andy Murray,6-1; 6-4; 6-4,R64,118,9,2,51,77,43,51,16,26,1,1,14,59,77,2,2,54,95,35,54,18,41,8,12,13,53,95
2012-01-16 00:00:00.000,Australian Open Australia Grand Slams,HARD,3,Michael Llodra,Alex Bogomolov Jr.,Michael Llodra,6-1; 6-3; 4-6; 5-7; 6-4,R64,193,12,8,80,136,53,80,27,56,6,14,24,80,136,1,6,115,150,67,115,12,35,6,17,24,79,150
2012-01-16 00:00:00.000,Australian Open Australia Grand Slams,HARD,3,Mikhail Kukushkin,Viktor Troicki,Mikhail Kukushkin,5-7; 6-4; 6-2; 4-6; 6-3,R64,218,5,3,87,138,62,87,28,51,6,11,25,90,138,7,2,82,155,52,82,38,73,11,18,24,90,155
2012-01-16 00:00:00.000,Australian Open Australia Grand Slams,HARD,3,Gael Monfils,Thomaz Bellucci,Gael Monfils,2-6; 6-0; 6-4; 6-2,R64,165,3,5,70,115,48,70,22,45,9,12,16,70,115,1,2,61,109,38,61,20,48,9,16,16,58,109
2012-01-16 00:00:00.000,Australian Open Australia Grand Slams,HARD,3,Julien Benneteau,Gilles Simon,Julien Benneteau,7-5; 7-6(8); 1-6; 3-6; 6-2,R64,252,6,6,100,158,64,100,28,58,9,16,24,92,158,3,3,110,170,70,110,29,60,11,18,24,99,170
2012-01-16 00:00:00.000,Australian Open Australia Grand Slams,HARD,3,Kei Nishikori,Matthew Ebden,Kei Nishikori,3-6; 1-6; 6-4; 6-1; 6-1,R64,181,2,3,86,127,53,86,21,41,6,12,20,74,127,6,2,83,126,56,83,17,43,11,19,20,73,126
2012-01-16 00:00:00.000,Australian Open Australia Grand Slams,HARD,3,Frederico Gil,Marcel Granollers,Frederico Gil,6-3; 4-6; 6-4; 6-3,R64,168,3,0,76,109,53,76,19,33,3,6,19,72,109,7,5,73,123,51,73,20,50,9,15,19,71,123
2012-01-16 00:00:00.000,Australian Open Australia Grand Slams,HARD,3,Jo-Wilfried Tsonga,Ricardo Mello,Jo-Wilfried Tsonga,7-5; 6-4; 6-4,R64,118,15,3,70,93,52,70,11,23,4,6,16,63,93,2,7,50,95,32,50,24,45,5,10,16,56,95
2012-01-16 00:00:00.000,Australian Open Australia Grand Slams,HARD,3,Alejandro Falla,Mardy Fish,Alejandro Falla,7-6(4); 6-3; 7-6(6),R64,180,5,1,68,116,44,68,28,48,7,11,17,72,116,5,0,63,102,39,63,19,39,1,6,16,58,102
2012-01-16 00:00:00.000,Australian Open Australia Grand Slams,HARD,3,Philipp Kohlschreiber,Pere Riba,Philipp Kohlschreiber,6-0; 4-0 RET,R64,50,1,1,21,26,19,21,2,5,2,2,5,21,26,0,0,18,36,7,18,5,18,2,6,5,12,36
2012-01-16 00:00:00.000,Australian Open Australia Grand Slams,HARD,3,Yen-Hsun Lu,Florent Serra,Yen-Hsun Lu,7-5; 6-2; 6-2,R64,121,4,2,47,68,42,47,15,21,3,3,14,57,68,5,3,65,106,39,65,18,41,7,12,14,57,106
2012-01-16 00:00:00.000,Australian Open Australia Grand Slams,HARD,3,Juan Martin Del Potro,Blaz Kavcic,Juan Martin Del Potro,6-4; 7-5; 6-3,R64,162,14,5,54,85,41,54,15,31,0,3,15,56,85,3,9,63,110,42,63,15,47,5,12,16,57,110
2012-01-16 00:00:00.000,Australian Open Australia Grand Slams,HARD,3,Alexandr Dolgopolov,Tobias Kamke,Alexandr Dolgopolov,4-6; 6-1; 6-1; 3-6; 8-6,R64,198,16,4,91,149,69,91,25,58,10,16,24,94,149,2,9,93,157,53,93,35,64,11,20,23,88,157
2012-01-16 00:00:00.000,Australian Open Australia Grand Slams,HARD,3,Bernard Tomic,Sam Querrey,Bernard Tomic,3-6; 6-3; 7-6(3); 6-3,R64,133,6,1,81,119,62,81,25,38,1,3,20,87,119,23,7,73,118,62,73,18,45,7,10,19,80,118
2012-01-16 00:00:00.000,Australian Open Australia Grand Slams,HARD,3,Ivo Karlovic,Carlos Berlocq,Ivo Karlovic,7-6(4); 3-6; 6-3; 6-4,R64,203,20,2,87,132,63,87,28,45,9,12,20,91,132,1,2,103,138,74,103,16,35,6,9,20,90,138
2012-01-16 00:00:00.000,Australian Open Australia Grand Slams,HARD,3,Roger Federer,Andreas Beck,Roger Federer,W/O,R64,0,0,0,0,0,0,0,0,0,0,0,0,0,0,0,0,0,0,0,0,0,0,0,0,0,0,0
2012-01-16 00:00:00.000,Australian Open Australia Grand Slams,HARD,3,Tomas Berdych,Olivier Rochus,Tomas Berdych,6-1; 6-0; 7-6(4),R64,114,21,1,45,78,41,45,19,33,1,1,13,60,78,1,0,48,80,29,48,17,32,3,8,12,46,80
2012-01-16 00:00:00.000,Australian Open Australia Grand Slams,HARD,3,Kevin Anderson,Sergiy Stakhovsky,Kevin Anderson,3-6; 6-1; 7-6(3); 6-3,R64,155,15,4,81,117,63,81,18,36,1,3,19,81,117,10,4,57,109,42,57,29,52,5,9,18,71,109
2012-01-16 00:00:00.000,Australian Open Australia Grand Slams,HARD,3,Stan Wawrinka,Marcos Baghdatis,Stan Wawrinka,7-6(3); 6-4; 5-7; 6-1,R64,190,4,4,70,132,49,70,31,62,7,12,20,80,132,1,8,77,138,45,77,27,61,7,14,21,72,138
2012-01-16 00:00:00.000,Australian Open Australia Grand Slams,HARD,3,Nicolas Almagro,Grigor Dimitrov,Nicolas Almagro,4-6; 6-3; 6-7(4); 6-4; 6-0,R64,209,9,2,92,143,64,92,32,51,4,7,23,96,143,13,5,93,158,65,93,26,65,14,22,24,91,158
2012-01-16 00:00:00.000,Australian Open Australia Grand Slams,HARD,3,John Isner,David Nalbandian,John Isner,4-6; 6-3; 2-6; 7-6(5); 10-8,R64,281,43,2,120,191,86,120,37,71,10,15,29,123,191,7,5,113,177,82,113,37,64,6,10,28,119,177
2012-01-16 00:00:00.000,Australian Open Australia Grand Slams,HARD,3,Feliciano Lopez,Flavio Cipolla,Feliciano Lopez,7-5; 7-6(4); 6-2,R64,145,6,5,57,103,43,57,22,46,4,7,16,65,103,0,2,84,100,45,84,9,16,6,12,16,54,100
2012-01-16 00:00:00.000,Australian Open Australia Grand Slams,HARD,3,Lukas Lacko,Donald Young,Lukas Lacko,6-3; 6-1; 3-6; 6-3,R64,143,8,1,68,107,49,68,25,39,4,5,17,74,107,2,2,60,103,41,60,20,43,7,12,17,61,103
2012-01-16 00:00:00.000,Australian Open Australia Grand Slams,HARD,3,Rafael Nadal,Tommy Haas,Rafael Nadal,6-4; 6-3; 6-4,R64,149,2,2,51,80,38,51,16,29,2,4,14,54,80,8,4,59,94,36,59,16,35,4,10,15,52,94
2012-01-16 00:00:00.000,Australian Open Australia Grand Slams,HARD,3,Novak Djokovic,Nicolas Mahut,Novak Djokovic,6-0; 6-1; 6-1,R32,74,7,1,32,52,27,32,14,20,1,1,10,41,52,0,5,43,66,21,43,5,23,6,14,10,26,66
2012-01-16 00:00:00.000,Australian Open Australia Grand Slams,HARD,3,Lleyton Hewitt,Milos Raonic,Lleyton Hewitt,4-6; 6-3; 7-6(5); 6-3,R32,186,7,7,77,136,57,77,32,59,6,8,21,89,136,23,6,61,115,47,61,28,54,2,5,19,75,115
2012-01-16 00:00:00.000,Australian Open Australia Grand Slams,HARD,3,Richard Gasquet,Janko Tipsarevic,Richard Gasquet,6-3; 6-3; 6-1,R32,97,7,1,41,68,29,41,20,27,0,1,13,49,68,5,1,37,75,19,37,18,38,6,12,12,37,75
2012-01-16 00:00:00.000,Australian Open Australia Grand Slams,HARD,3,David Ferrer,Juan Ignacio Chela,David Ferrer,7-5; 6-2; 6-1,R32,128,1,4,46,84,30,46,21,38,3,6,14,51,84,1,1,55,86,29,55,8,31,5,13,13,37,86
2012-01-16 00:00:00.000,Australian Open Australia Grand Slams,HARD,3,Andy Murray,Michael Llodra,Andy Murray,6-4; 6-2; 6-0,R32,109,7,2,46,77,32,46,22,31,5,5,12,54,77,2,3,45,78,32,45,6,33,7,13,12,38,78
2012-01-16 00:00:00.000,Australian Open Australia Grand Slams,HARD,3,Mikhail Kukushkin,Gael Monfils,Mikhail Kukushkin,6-2; 7-5; 5-7; 1-6; 6-4,R32,220,5,2,98,148,62,98,24,50,7,15,24,86,148,9,11,106,159,68,106,19,53,17,25,25,87,159
2012-01-16 00:00:00.000,Australian Open Australia Grand Slams,HARD,3,Kei Nishikori,Julien Benneteau,Kei Nishikori,4-6; 7-6(3); 7-6(4); 6-3,R32,205,5,4,85,121,58,85,18,36,1,7,21,76,121,8,3,104,156,62,104,22,52,6,13,22,84,156
2012-01-16 00:00:00.000,Australian Open Australia Grand Slams,HARD,3,Jo-Wilfried Tsonga,Frederico Gil,Jo-Wilfried Tsonga,6-2; 6-2; 6-2,R32,91,7,1,40,70,33,40,19,30,6,6,12,52,70,0,1,48,68,23,48,12,20,1,7,12,35,68
2012-01-16 00:00:00.000,Australian Open Australia Grand Slams,HARD,3,Philipp Kohlschreiber,Alejandro Falla,Philipp Kohlschreiber,6-3; 6-2; 7-6(3),R32,138,4,0,49,93,38,49,29,44,2,3,14,67,93,1,1,66,98,43,66,12,32,3,8,15,55,98
2012-01-16 00:00:00.000,Australian Open Australia Grand Slams,HARD,3,Juan Martin Del Potro,Yen-Hsun Lu,Juan Martin Del Potro,6-2; 6-3; 6-0,R32,112,8,1,34,60,29,34,15,26,0,0,11,44,60,6,3,39,67,22,39,10,28,3,10,12,32,67
2012-01-16 00:00:00.000,Australian Open Australia Grand Slams,HARD,3,Bernard Tomic,Alexandr Dolgopolov,Bernard Tomic,4-6; 7-6(0); 7-6(6); 2-6; 6-3,R32,229,12,2,134,197,84,134,36,63,12,17,26,120,197,22,3,69,151,54,69,43,82,5,9,25,97,151
2012-01-16 00:00:00.000,Australian Open Australia Grand Slams,HARD,3,Roger Federer,Ivo Karlovic,Roger Federer,7-6(6); 7-5; 6-3,R32,137,9,0,61,99,49,61,28,38,2,2,17,77,99,15,3,83,119,63,83,13,36,4,6,16,76,119
2012-01-16 00:00:00.000,Australian Open Australia Grand Slams,HARD,3,Tomas Berdych,Kevin Anderson,Tomas Berdych,7-6(5); 7-6(1); 6-1,R32,167,14,6,57,107,46,57,32,50,4,4,16,78,107,18,5,83,119,59,83,14,36,9,11,15,73,119
2012-01-16 00:00:00.000,Australian Open Australia Grand Slams,HARD,3,Nicolas Almagro,Stan Wawrinka,Nicolas Almagro,7-6(2); 6-2; 6-4,R32,147,7,0,58,90,40,58,21,32,0,3,15,61,90,4,2,72,118,41,72,21,46,11,17,15,62,118
2012-01-16 00:00:00.000,Australian Open Australia Grand Slams,HARD,3,Feliciano Lopez,John Isner,Feliciano Lopez,6-3; 6-7(3); 6-4; 6-7(0); 6-1,R32,206,16,12,86,153,65,86,43,67,3,4,25,108,153,29,3,108,147,78,108,17,39,5,11,25,95,147
2012-01-16 00:00:00.000,Australian Open Australia Grand Slams,HARD,3,Rafael Nadal,Lukas Lacko,Rafael Nadal,6-2; 6-4; 6-2,R32,115,2,0,55,68,47,55,6,13,4,5,13,53,68,8,3,52,78,31,52,11,26,6,12,13,42,78
2012-01-16 00:00:00.000,Australian Open Australia Grand Slams,HARD,3,Novak Djokovic,Lleyton Hewitt,Novak Djokovic,6-1; 6-3; 4-6; 6-3,R16,176,15,3,63,102,46,63,22,39,2,6,18,68,102,3,6,66,124,45,66,21,58,4,12,17,66,124
2012-01-16 00:00:00.000,Australian Open Australia Grand Slams,HARD,3,David Ferrer,Richard Gasquet,David Ferrer,6-4; 6-4; 6-1,R16,107,5,3,46,73,40,46,10,27,1,3,13,50,73,1,3,57,82,29,57,13,25,2,9,14,42,82
2012-01-16 00:00:00.000,Australian Open Australia Grand Slams,HARD,3,Andy Murray,Mikhail Kukushkin,Andy Murray,6-1; 6-1; 1-0 RET,R16,49,4,0,22,34,15,22,7,12,1,3,7,22,34,0,0,33,47,6,33,7,14,4,12,8,13,47
2012-01-16 00:00:00.000,Australian Open Australia Grand Slams,HARD,3,Kei Nishikori,Jo-Wilfried Tsonga,Kei Nishikori,2-6; 6-2; 6-1; 3-6; 6-3,R16,210,1,5,82,125,57,82,23,43,8,12,21,80,125,13,3,82,142,56,82,26,60,12,18,20,82,142
2012-01-16 00:00:00.000,Australian Open Australia Grand Slams,HARD,3,Juan Martin Del Potro,Philipp Kohlschreiber,Juan Martin Del Potro,6-4; 6-2; 6-1,R16,126,5,1,43,69,35,43,14,26,2,3,12,49,69,3,3,50,87,32,50,9,37,9,16,13,41,87
2012-01-16 00:00:00.000,Australian Open Australia Grand Slams,HARD,3,Roger Federer,Bernard Tomic,Roger Federer,6-4; 6-2; 6-2,R16,104,13,3,44,76,37,44,18,32,4,5,13,55,76,0,2,71,95,39,71,10,24,4,10,13,49,95
2012-01-16 00:00:00.000,Australian Open Australia Grand Slams,HARD,3,Tomas Berdych,Nicolas Almagro,Tomas Berdych,4-6; 7-6(5); 7-6(3); 7-6(2),R16,234,27,4,84,149,73,84,38,65,7,9,23,111,149,16,4,90,157,68,90,39,67,8,9,23,107,157
2012-01-16 00:00:00.000,Australian Open Australia Grand Slams,HARD,3,Rafael Nadal,Feliciano Lopez,Rafael Nadal,6-4; 6-4; 6-2,R16,145,4,1,57,71,46,57,9,14,3,4,14,55,71,10,6,62,109,41,62,18,47,13,18,14,59,109
2012-01-16 00:00:00.000,Australian Open Australia Grand Slams,HARD,3,Novak Djokovic,David Ferrer,Novak Djokovic,6-4; 7-6(4); 6-1,Q,164,3,0,47,91,34,47,29,44,2,4,15,63,91,2,1,64,98,39,64,17,34,7,12,14,56,98
2012-01-16 00:00:00.000,Australian Open Australia Grand Slams,HARD,3,Andy Murray,Kei Nishikori,Andy Murray,6-3; 6-3; 6-1,Q,132,4,3,36,81,28,36,26,45,8,10,13,54,81,1,2,56,94,30,56,14,38,11,18,12,44,94
2012-01-16 00:00:00.000,Australian Open Australia Grand Slams,HARD,3,Roger Federer,Juan Martin Del Potro,Roger Federer,6-4; 6-3; 6-2,Q,119,4,1,44,77,39,44,19,33,5,6,14,58,77,5,3,58,87,33,58,16,29,3,8,13,49,87
2012-01-16 00:00:00.000,Australian Open Australia Grand Slams,HARD,3,Rafael Nadal,Tomas Berdych,Rafael Nadal,6-7(5); 7-6(6); 6-4; 6-3,Q,256,7,2,100,142,76,100,21,42,11,13,21,97,142,17,5,100,162,74,100,28,62,8,13,22,102,162
2012-01-16 00:00:00.000,Australian Open Australia Grand Slams,HARD,3,Novak Djokovic,Andy Murray,Novak Djokovic,6-3; 3-6; 6-7(4); 6-1; 7-5,S,290,11,6,104,171,69,104,30,67,17,24,24,99,171,9,10,110,174,69,110,20,64,15,26,25,89,174
2012-01-16 00:00:00.000,Australian Open Australia Grand Slams,HARD,3,Rafael Nadal,Roger Federer,Rafael Nadal,6-7(5); 6-2; 7-6(5); 6-4,S,222,4,1,109,141,75,109,20,32,7,10,21,95,141,11,5,86,135,57,86,27,49,10,16,21,84,135
2012-01-16 00:00:00.000,Australian Open Australia Grand Slams,HARD,3,Novak Djokovic,Rafael Nadal,Novak Djokovic,5-7; 6-4; 6-2; 6-7(5); 7-5,F,353,9,2,98,166,67,98,43,68,2,6,27,110,166,10,4,135,203,88,135,32,68,13,20,27,120,203
2012-01-30 00:00:00.000,Montpellier France ATP World Tour 250,HARD,2,Tomas Berdych,N/A Bye,Tomas Berdych,,R32,0,0,0,0,0,0,0,0,0,0,0,0,0,0,0,0,0,0,0,0,0,0,0,0,0,0,0
2012-01-30 00:00:00.000,Montpellier France ATP World Tour 250,HARD,2,Florent Serra,Tobias Kamke,Florent Serra,6-3; 6-3,R32,82,3,1,40,74,27,40,13,34,5,8,9,40,74,1,2,30,49,13,30,10,19,2,8,9,23,49
2012-01-30 00:00:00.000,Montpellier France ATP World Tour 250,HARD,2,Nicolas Mahut,Albert Ramos-Vinolas,Nicolas Mahut,6-3; 6-2,R32,83,4,2,30,57,22,30,17,27,1,1,9,39,57,4,0,33,56,20,33,12,23,2,5,8,32,56
2012-01-30 00:00:00.000,Montpellier France ATP World Tour 250,HARD,2,Florian Mayer,Gilles Muller,Florian Mayer,7-6(3); 6-3,R32,80,7,0,52,74,40,52,15,22,7,7,11,55,74,15,0,32,53,27,32,14,21,2,3,10,41,53
2012-01-30 00:00:00.000,Montpellier France ATP World Tour 250,HARD,2,Richard Gasquet,N/A Bye,Richard Gasquet,,R32,0,0,0,0,0,0,0,0,0,0,0,0,0,0,0,0,0,0,0,0,0,0,0,0,0,0,0
2012-01-30 00:00:00.000,Montpellier France ATP World Tour 250,HARD,2,Nikolay Davydenko,Stephane Robert,Nikolay Davydenko,6-2; 6-1,R32,59,1,0,25,34,21,25,8,9,1,1,7,29,34,0,6,19,57,19,19,8,38,3,8,8,27,57
2012-01-30 00:00:00.000,Montpellier France ATP World Tour 250,HARD,2,Edouard Roger-Vasselin,Roberto Bautista Agut,Edouard Roger-Vasselin,7-5; 6-2,R32,82,2,1,39,58,34,39,10,19,1,1,10,44,58,4,2,41,60,30,41,6,19,5,8,10,36,60
2012-01-30 00:00:00.000,Montpellier France ATP World Tour 250,HARD,2,Philipp Kohlschreiber,Olivier Rochus,Philipp Kohlschreiber,6-1; 6-4,R32,85,11,2,31,60,26,31,13,29,3,4,9,39,60,1,1,31,54,16,31,12,23,6,10,8,28,54
2012-01-30 00:00:00.000,Montpellier France ATP World Tour 250,HARD,2,Jarkko Nieminen,Maxime Teixeira,Jarkko Nieminen,6-3; 3-6; 6-4,R32,126,1,2,63,82,49,63,8,19,3,4,14,57,82,2,2,79,111,54,79,12,32,11,13,14,66,111
2012-01-30 00:00:00.000,Montpellier France ATP World Tour 250,HARD,2,Paul-Henri Mathieu,Cedrik-Marcel Stebe,Paul-Henri Mathieu,6-4; 6-4,R32,84,7,2,30,52,24,30,12,22,3,5,10,36,52,5,3,28,53,19,28,10,25,2,6,10,29,53
2012-01-30 00:00:00.000,Montpellier France ATP World Tour 250,HARD,2,Michael Russell,Adrian Mannarino,Michael Russell,6-3; 7-5,R32,85,2,4,31,55,26,31,13,24,0,2,11,39,55,4,4,34,68,22,34,14,34,3,7,10,36,68
2012-01-30 00:00:00.000,Montpellier France ATP World Tour 250,HARD,2,Gael Monfils,N/A Bye,Gael Monfils,,R32,0,0,0,0,0,0,0,0,0,0,0,0,0,0,0,0,0,0,0,0,0,0,0,0,0,0,0
2012-01-30 00:00:00.000,Montpellier France ATP World Tour 250,HARD,2,Feliciano Lopez,Igor Kunitsyn,Feliciano Lopez,6-4; 7-6(7),R32,97,19,2,46,75,42,46,11,29,2,2,11,53,75,2,1,47,75,31,47,20,28,6,7,11,51,75
2012-01-30 00:00:00.000,Montpellier France ATP World Tour 250,HARD,2,Guillaume Rufin,Vasek Pospisil,Guillaume Rufin,6-4; 7-6(6),R32,116,4,5,33,74,28,33,26,41,2,2,11,54,74,11,3,53,86,41,53,15,33,5,6,11,56,86
2012-01-30 00:00:00.000,Montpellier France ATP World Tour 250,HARD,2,Flavio Cipolla,Marc Gicquel,Flavio Cipolla,1-6; 6-4; 7-5,R32,133,2,0,69,90,44,69,8,21,6,10,14,52,90,4,2,51,83,37,51,16,32,3,7,15,53,83
2012-01-30 00:00:00.000,Montpellier France ATP World Tour 250,HARD,2,Gilles Simon,N/A Bye,Gilles Simon,,R32,0,0,0,0,0,0,0,0,0,0,0,0,0,0,0,0,0,0,0,0,0,0,0,0,0,0,0
2012-01-30 00:00:00.000,Montpellier France ATP World Tour 250,HARD,2,Tomas Berdych,Florent Serra,Tomas Berdych,6-0; 6-2,R16,55,9,0,30,43,25,30,6,13,3,3,7,31,43,2,2,26,44,15,26,4,18,3,8,7,19,44
2012-01-30 00:00:00.000,Montpellier France ATP World Tour 250,HARD,2,Nicolas Mahut,Florian Mayer,Nicolas Mahut,7-6(3); 6-3,R16,82,9,0,39,60,31,39,13,21,1,2,10,44,60,3,3,42,69,31,42,12,27,1,4,11,43,69
2012-01-30 00:00:00.000,Montpellier France ATP World Tour 250,HARD,2,Richard Gasquet,Nikolay Davydenko,Richard Gasquet,6-3; 6-4,R16,86,10,2,37,56,31,37,10,19,0,0,10,41,56,5,2,41,64,25,41,13,23,3,5,9,38,64
2012-01-30 00:00:00.000,Montpellier France ATP World Tour 250,HARD,2,Philipp Kohlschreiber,Edouard Roger-Vasselin,Philipp Kohlschreiber,6-4; 7-5,R16,83,10,2,52,76,36,52,11,24,0,2,11,47,76,3,0,38,54,21,38,10,16,0,4,11,31,54
2012-01-30 00:00:00.000,Montpellier France ATP World Tour 250,HARD,2,Jarkko Nieminen,Paul-Henri Mathieu,Jarkko Nieminen,7-6(4); 6-1,R16,81,2,0,46,60,33,46,12,14,2,3,10,45,60,7,2,35,56,25,35,8,21,2,5,9,33,56
2012-01-30 00:00:00.000,Montpellier France ATP World Tour 250,HARD,2,Gael Monfils,Michael Russell,Gael Monfils,6-3; 6-3,R16,76,17,2,38,51,32,38,6,13,0,0,9,38,51,2,4,38,69,24,38,15,31,7,10,9,39,69
2012-01-30 00:00:00.000,Montpellier France ATP World Tour 250,HARD,2,Guillaume Rufin,Feliciano Lopez,Guillaume Rufin,7-6(5); 6-3,R16,89,16,2,33,60,27,33,18,27,1,2,10,45,60,13,6,44,72,33,44,10,28,6,9,11,43,72
2012-01-30 00:00:00.000,Montpellier France ATP World Tour 250,HARD,2,Gilles Simon,Flavio Cipolla,Gilles Simon,6-3; 6-2,R16,94,9,0,30,70,23,30,23,40,4,4,9,46,70,0,2,34,51,18,34,10,17,2,5,8,28,51
2012-01-30 00:00:00.000,Montpellier France ATP World Tour 250,HARD,2,Tomas Berdych,Nicolas Mahut,Tomas Berdych,6-3; 6-4,Q,73,14,1,33,47,31,33,7,14,2,3,10,38,47,10,2,36,59,25,36,9,23,2,5,9,34,59
2012-01-30 00:00:00.000,Montpellier France ATP World Tour 250,HARD,2,Philipp Kohlschreiber,Richard Gasquet,Philipp Kohlschreiber,6-2; 3-6; 6-3,Q,101,18,0,48,69,36,48,15,21,1,2,13,51,69,4,4,52,79,38,52,12,27,3,6,13,50,79
2012-01-30 00:00:00.000,Montpellier France ATP World Tour 250,HARD,2,Gael Monfils,Jarkko Nieminen,Gael Monfils,6-3; 6-3,Q,54,9,2,29,42,27,29,9,13,0,0,9,36,42,0,0,27,55,18,27,16,28,2,5,9,34,55
2012-01-30 00:00:00.000,Montpellier France ATP World Tour 250,HARD,2,Gilles Simon,Guillaume Rufin,Gilles Simon,7-6(5); 6-7(2); 6-2,Q,172,9,4,66,112,50,66,18,46,5,8,16,68,112,10,11,61,122,44,61,26,61,10,15,16,70,122
2012-01-30 00:00:00.000,Montpellier France ATP World Tour 250,HARD,2,Tomas Berdych,Philipp Kohlschreiber,Tomas Berdych,6-3; 6-4,S,82,6,2,34,64,34,34,14,30,5,5,10,48,64,11,1,34,53,25,34,9,19,5,7,9,34,53
2012-01-30 00:00:00.000,Montpellier France ATP World Tour 250,HARD,2,Gael Monfils,Gilles Simon,Gael Monfils,4-6; 7-6(4); 6-4,S,146,18,11,69,123,52,69,22,54,9,13,16,74,123,1,4,59,107,44,59,22,48,6,10,16,66,107
2012-01-30 00:00:00.000,Montpellier France ATP World Tour 250,HARD,2,Tomas Berdych,Gael Monfils,Tomas Berdych,6-2; 4-6; 6-3,F,125,12,2,58,93,45,58,17,35,4,5,14,62,93,11,6,56,91,46,56,10,35,7,10,13,56,91
2012-01-30 00:00:00.000,Vina del Mar Chile ATP World Tour 250,CLAY,2,Juan Monaco,N/A Bye,Juan Monaco,,R32,0,0,0,0,0,0,0,0,0,0,0,0,0,0,0,0,0,0,0,0,0,0,0,0,0,0,0
2012-01-30 00:00:00.000,Vina del Mar Chile ATP World Tour 250,CLAY,2,Igor Andreev,Paul Capdeville,Igor Andreev,3-6; 6-3; 6-4,R32,122,3,1,46,85,34,46,23,39,3,5,14,57,85,0,2,57,87,38,57,18,30,6,9,14,56,87
2012-01-30 00:00:00.000,Vina del Mar Chile ATP World Tour 250,CLAY,2,Rogerio Dutra Silva,Maximo Gonzalez,Rogerio Dutra Silva,0-6; 7-6(3); 6-3,R32,173,0,3,66,91,36,66,13,25,2,7,13,49,91,1,4,68,110,42,68,20,42,12,16,14,62,110
2012-01-30 00:00:00.000,Vina del Mar Chile ATP World Tour 250,CLAY,2,Albert Montanes,Ruben Ramirez Hidalgo,Albert Montanes,6-2; 6-4,R32,80,3,4,28,54,18,28,14,26,2,5,9,32,54,1,10,27,50,17,27,5,23,2,8,9,22,50
2012-01-30 00:00:00.000,Vina del Mar Chile ATP World Tour 250,CLAY,2,Pablo Andujar,N/A Bye,Pablo Andujar,,R32,0,0,0,0,0,0,0,0,0,0,0,0,0,0,0,0,0,0,0,0,0,0,0,0,0,0,0
2012-01-30 00:00:00.000,Vina del Mar Chile ATP World Tour 250,CLAY,2,Frederico Gil,Paolo Lorenzi,Frederico Gil,6-3; 5-7; 6-1,R32,146,1,5,58,94,37,58,15,36,4,9,14,52,94,3,3,76,108,40,76,15,32,14,22,14,55,108
2012-01-30 00:00:00.000,Vina del Mar Chile ATP World Tour 250,CLAY,2,Jeremy Chardy,Eric Prodon,Jeremy Chardy,6-4; 6-3,R32,86,8,4,32,67,28,32,15,35,6,7,9,43,67,3,1,42,77,25,42,17,35,6,10,10,42,77
2012-01-30 00:00:00.000,Vina del Mar Chile ATP World Tour 250,CLAY,2,Leonardo Mayer,Santiago Giraldo,Leonardo Mayer,7-6(5); 6-1,R32,91,1,0,34,54,27,34,15,20,0,1,10,42,54,2,1,41,74,26,41,16,33,3,6,9,42,74
2012-01-30 00:00:00.000,Vina del Mar Chile ATP World Tour 250,CLAY,2,Carlos Berlocq,Daniel Gimeno-Traver,Carlos Berlocq,7-5; 6-0,R32,122,6,1,47,66,30,47,10,19,6,8,9,40,66,2,10,39,82,27,39,11,43,9,15,9,38,82
2012-01-30 00:00:00.000,Vina del Mar Chile ATP World Tour 250,CLAY,2,Diego Junqueira,Ricardo Mello,Diego Junqueira,6-4; 6-2,R32,75,0,1,43,51,26,43,5,8,4,7,9,31,51,1,1,42,64,22,42,8,22,11,17,9,30,64
2012-01-30 00:00:00.000,Vina del Mar Chile ATP World Tour 250,CLAY,2,Federico Delbonis,Nicolas Massu,Federico Delbonis,6-0; 6-3,R32,77,1,2,28,37,23,28,6,9,0,0,7,29,37,3,4,36,56,20,36,5,20,7,12,8,25,56
2012-01-30 00:00:00.000,Vina del Mar Chile ATP World Tour 250,CLAY,2,Thomaz Bellucci,N/A Bye,Thomaz Bellucci,,R32,0,0,0,0,0,0,0,0,0,0,0,0,0,0,0,0,0,0,0,0,0,0,0,0,0,0,0
2012-01-30 00:00:00.000,Vina del Mar Chile ATP World Tour 250,CLAY,2,Joao Souza,Filippo Volandri,Joao Souza,1-6; 7-5; 7-6(5),R32,173,2,2,51,100,33,51,33,49,3,6,15,66,100,1,1,82,108,59,82,12,26,9,11,16,71,108
2012-01-30 00:00:00.000,Vina del Mar Chile ATP World Tour 250,CLAY,2,Fernando Gonzalez,Pere Riba,Fernando Gonzalez,6-4; 6-4,R32,88,5,1,37,64,25,37,14,27,3,5,10,39,64,2,2,36,60,22,36,10,24,2,6,10,32,60
2012-01-30 00:00:00.000,Vina del Mar Chile ATP World Tour 250,CLAY,2,Horacio Zeballos,Adrian Ungur,Horacio Zeballos,6-0; 7-5,R32,78,4,0,31,53,20,31,13,22,3,5,9,33,53,2,4,35,54,15,35,7,19,2,8,9,22,54
2012-01-30 00:00:00.000,Vina del Mar Chile ATP World Tour 250,CLAY,2,Juan Ignacio Chela,N/A Bye,Juan Ignacio Chela,,R32,0,0,0,0,0,0,0,0,0,0,0,0,0,0,0,0,0,0,0,0,0,0,0,0,0,0,0
2012-01-30 00:00:00.000,Vina del Mar Chile ATP World Tour 250,CLAY,2,Juan Monaco,Igor Andreev,Juan Monaco,6-2; 6-1,R16,76,1,0,28,50,18,28,13,22,5,7,8,31,50,0,1,25,43,7,25,7,18,6,12,7,14,43
2012-01-30 00:00:00.000,Vina del Mar Chile ATP World Tour 250,CLAY,2,Albert Montanes,Rogerio Dutra Silva,Albert Montanes,7-5; 6-2,R16,94,2,2,37,63,29,37,14,26,1,2,10,43,63,1,1,47,68,30,47,7,21,4,8,10,37,68
2012-01-30 00:00:00.000,Vina del Mar Chile ATP World Tour 250,CLAY,2,Frederico Gil,Pablo Andujar,Frederico Gil,6-2; 6-1,R16,57,1,1,23,37,21,23,7,14,3,4,7,28,37,1,4,25,44,9,25,6,19,2,8,8,15,44
2012-01-30 00:00:00.000,Vina del Mar Chile ATP World Tour 250,CLAY,2,Jeremy Chardy,Leonardo Mayer,Jeremy Chardy,7-5; 6-2,R16,99,4,2,33,62,28,33,16,29,6,7,10,44,62,5,2,36,66,22,36,13,30,6,10,10,35,66
2012-01-30 00:00:00.000,Vina del Mar Chile ATP World Tour 250,CLAY,2,Carlos Berlocq,Diego Junqueira,Carlos Berlocq,6-1; 6-0,R16,63,3,1,23,37,20,23,10,14,0,0,7,30,37,0,0,26,36,9,26,6,10,3,8,6,15,36
2012-01-30 00:00:00.000,Vina del Mar Chile ATP World Tour 250,CLAY,2,Federico Delbonis,Thomaz Bellucci,Federico Delbonis,6-2; 7-5,R16,92,3,2,30,55,23,30,16,25,1,2,10,39,55,0,6,30,65,18,30,18,35,1,5,10,36,65
2012-01-30 00:00:00.000,Vina del Mar Chile ATP World Tour 250,CLAY,2,Joao Souza,Fernando Gonzalez,Joao Souza,6-3; 7-6(6),R16,107,4,2,45,72,31,45,12,27,7,10,10,43,72,1,7,46,75,29,46,8,29,3,8,11,37,75
2012-01-30 00:00:00.000,Vina del Mar Chile ATP World Tour 250,CLAY,2,Juan Ignacio Chela,Horacio Zeballos,Juan Ignacio Chela,6-4; 7-6(2),R16,113,2,1,46,66,38,46,10,20,3,4,11,48,66,5,1,60,89,41,60,11,29,6,8,11,52,89
2012-01-30 00:00:00.000,Vina del Mar Chile ATP World Tour 250,CLAY,2,Juan Monaco,Albert Montanes,Juan Monaco,3-6; 6-1; 6-1,Q,119,0,3,58,78,37,58,9,20,3,7,12,46,78,1,2,46,69,21,46,11,23,5,12,11,32,69
2012-01-30 00:00:00.000,Vina del Mar Chile ATP World Tour 250,CLAY,2,Jeremy Chardy,Frederico Gil,Jeremy Chardy,6-2; 7-6(5),Q,96,3,2,37,61,28,37,15,24,0,1,10,43,61,0,4,40,76,28,40,16,36,9,12,10,44,76
2012-01-30 00:00:00.000,Vina del Mar Chile ATP World Tour 250,CLAY,2,Carlos Berlocq,Federico Delbonis,Carlos Berlocq,6-3; 6-4,Q,93,2,1,36,58,25,36,9,22,4,7,10,34,58,1,3,32,56,19,32,9,24,4,9,9,28,56
2012-01-30 00:00:00.000,Vina del Mar Chile ATP World Tour 250,CLAY,2,Juan Ignacio Chela,Joao Souza,Juan Ignacio Chela,5-7; 7-6(6); 6-1,Q,181,1,4,81,112,51,81,18,31,10,13,16,69,112,6,3,71,101,44,71,18,30,4,8,15,62,101
2012-01-30 00:00:00.000,Vina del Mar Chile ATP World Tour 250,CLAY,2,Juan Monaco,Jeremy Chardy,Juan Monaco,6-1; 6-4,S,87,0,2,48,67,28,48,11,19,11,13,9,39,67,2,4,31,52,18,31,6,21,4,9,8,24,52
2012-01-30 00:00:00.000,Vina del Mar Chile ATP World Tour 250,CLAY,2,Carlos Berlocq,Juan Ignacio Chela,Carlos Berlocq,6-3; 4-6; 6-0,S,146,2,1,44,73,27,44,14,29,5,10,12,41,73,2,1,64,92,29,64,12,28,8,17,13,41,92
2012-01-30 00:00:00.000,Vina del Mar Chile ATP World Tour 250,CLAY,2,Juan Monaco,Carlos Berlocq,Juan Monaco,6-3; 6-7(1); 6-1,F,166,2,1,78,109,52,78,21,31,8,9,15,73,109,1,4,60,85,35,60,17,25,3,7,13,52,85
2012-01-30 00:00:00.000,Zagreb Croatia ATP World Tour 250,HARD,2,Ivan Ljubicic,Karol Beck,Ivan Ljubicic,7-6(5); 3-6; 6-3,R32,138,16,1,72,103,54,72,19,31,5,6,15,73,103,2,3,45,89,38,45,26,44,1,2,15,64,89
2012-01-30 00:00:00.000,Zagreb Croatia ATP World Tour 250,HARD,2,Michael Berrer,Marco Chiudinelli,Michael Berrer,7-6(3); 6-1,R32,71,6,2,44,61,35,44,9,17,5,6,10,44,61,1,1,33,49,22,33,9,16,5,8,9,31,49
2012-01-30 00:00:00.000,Zagreb Croatia ATP World Tour 250,HARD,2,Jurgen Melzer,Philipp Petzschner,Jurgen Melzer,6-1; 6-3,R32,50,6,0,35,44,26,35,8,9,2,2,8,34,44,4,2,36,57,20,36,8,21,0,4,8,28,57
2012-01-30 00:00:00.000,Zagreb Croatia ATP World Tour 250,HARD,2,Andreas Seppi,Daniel Brands,Andreas Seppi,6-4; 7-6(1),R32,86,7,1,45,70,39,45,10,25,0,1,11,49,70,6,3,48,68,32,48,9,20,0,2,11,41,68
2012-01-30 00:00:00.000,Zagreb Croatia ATP World Tour 250,HARD,2,Mikhail Youzhny,Sergiy Stakhovsky,Mikhail Youzhny,6-4; 7-6(4),R32,109,4,2,40,75,32,40,19,35,2,3,11,51,75,7,1,45,80,34,45,15,35,2,4,11,49,80
2012-01-30 00:00:00.000,Zagreb Croatia ATP World Tour 250,HARD,2,Grega Zemlja,Antonio Veic,Grega Zemlja,7-6(5); 7-6(6),R32,120,4,1,63,89,45,63,16,26,4,5,12,61,89,5,3,62,82,47,62,11,20,4,5,12,58,82
2012-01-30 00:00:00.000,Zagreb Croatia ATP World Tour 250,HARD,2,Dudi Sela,Andreas Beck,Dudi Sela,3-6; 6-3; 6-2,R32,107,3,4,47,76,37,47,16,29,5,7,13,53,76,3,2,44,79,28,44,15,35,3,7,13,43,79
2012-01-30 00:00:00.000,Zagreb Croatia ATP World Tour 250,HARD,2,Ivo Karlovic,Blaz Kavcic,Ivo Karlovic,7-6(2); 6-3,R32,83,8,0,33,54,28,33,12,21,0,1,10,40,54,10,2,37,61,28,37,10,24,6,9,11,38,61
2012-01-30 00:00:00.000,Zagreb Croatia ATP World Tour 250,HARD,2,Marcos Baghdatis,Lukas Rosol,Marcos Baghdatis,4-6; 6-3; 6-3,R32,112,7,6,36,75,27,36,19,39,3,7,14,46,75,9,2,60,100,40,60,11,40,6,12,14,51,100
2012-01-30 00:00:00.000,Zagreb Croatia ATP World Tour 250,HARD,2,Lukasz Kubot,Matteo Viola,Lukasz Kubot,6-2; 6-1,R32,61,2,2,28,41,26,28,6,13,0,0,8,32,41,0,5,24,42,14,24,6,18,4,8,7,20,42
2012-01-30 00:00:00.000,Zagreb Croatia ATP World Tour 250,HARD,2,Guillermo Garcia-Lopez,Daniel Evans,Guillermo Garcia-Lopez,6-4; 1-6; 6-1,R32,107,5,5,48,81,33,48,14,33,1,4,12,47,81,2,2,48,80,28,48,19,32,9,13,12,47,80
2012-01-30 00:00:00.000,Zagreb Croatia ATP World Tour 250,HARD,2,Ivan Dodig,Marsel Ilhan,Ivan Dodig,7-6(5); 7-5,R32,124,21,2,43,77,38,43,19,34,2,2,12,57,77,4,0,69,93,45,69,16,24,6,7,12,61,93
2012-01-30 00:00:00.000,Zagreb Croatia ATP World Tour 250,HARD,2,Robin Haase,Kristijan Mesaros,Robin Haase,6-2; 6-3,R32,57,4,1,27,46,22,27,11,19,0,1,9,33,46,6,1,39,52,22,39,5,13,4,8,8,27,52
2012-01-30 00:00:00.000,Zagreb Croatia ATP World Tour 250,HARD,2,Matthias Bachinger,Izak Van der Merwe,Matthias Bachinger,6-3; 6-3,R32,88,6,1,35,51,27,35,11,16,5,5,9,38,51,1,3,49,81,30,49,14,32,11,14,9,44,81
2012-01-30 00:00:00.000,Zagreb Croatia ATP World Tour 250,HARD,2,Lukas Lacko,Potito Starace,Lukas Lacko,7-6(2); 6-7(4); 6-3,R32,133,13,1,63,108,51,63,29,45,1,1,17,80,108,4,1,75,105,51,75,19,30,3,4,16,70,105
2012-01-30 00:00:00.000,Zagreb Croatia ATP World Tour 250,HARD,2,Alex Bogomolov Jr.,Dino Marcan,Alex Bogomolov Jr.,6-3; 6-1,R32,63,4,0,50,58,34,50,5,8,3,3,8,39,58,0,1,31,42,13,31,5,11,1,5,8,18,42
2012-01-30 00:00:00.000,Zagreb Croatia ATP World Tour 250,HARD,2,Michael Berrer,Ivan Ljubicic,Michael Berrer,6-4; 6-4,R16,85,2,0,32,52,26,32,11,20,1,2,10,37,52,11,2,45,68,32,45,8,23,3,6,10,40,68
2012-01-30 00:00:00.000,Zagreb Croatia ATP World Tour 250,HARD,2,Jurgen Melzer,Andreas Seppi,Jurgen Melzer,6-2; 6-3,R16,69,9,2,47,62,33,47,7,15,5,6,9,40,62,1,1,33,50,20,33,6,17,3,7,8,26,50
2012-01-30 00:00:00.000,Zagreb Croatia ATP World Tour 250,HARD,2,Mikhail Youzhny,Grega Zemlja,Mikhail Youzhny,6-1; 6-3,R16,76,3,1,30,42,24,30,8,12,0,0,8,32,42,5,1,37,60,22,37,8,23,7,11,8,30,60
2012-01-30 00:00:00.000,Zagreb Croatia ATP World Tour 250,HARD,2,Ivo Karlovic,Dudi Sela,Ivo Karlovic,6-3; 6-2,R16,66,12,0,32,46,29,32,6,14,1,1,8,35,46,2,0,34,55,21,34,10,21,2,6,9,31,55
2012-01-30 00:00:00.000,Zagreb Croatia ATP World Tour 250,HARD,2,Marcos Baghdatis,Lukasz Kubot,Marcos Baghdatis,6-4; 6-2,R16,77,6,1,40,57,30,40,9,17,1,1,9,39,57,3,2,41,59,23,41,8,18,3,6,9,31,59
2012-01-30 00:00:00.000,Zagreb Croatia ATP World Tour 250,HARD,2,Ivan Dodig,Guillermo Garcia-Lopez,Ivan Dodig,4-6; 6-4; 6-4,R16,157,12,1,59,101,41,59,21,42,6,9,15,62,101,3,1,63,88,40,63,15,25,7,11,15,55,88
2012-01-30 00:00:00.000,Zagreb Croatia ATP World Tour 250,HARD,2,Robin Haase,Matthias Bachinger,Robin Haase,7-6(4); 3-6; 6-3,R16,117,8,4,60,98,42,60,17,38,5,9,15,59,98,9,2,60,89,47,60,10,29,3,7,15,57,89
2012-01-30 00:00:00.000,Zagreb Croatia ATP World Tour 250,HARD,2,Lukas Lacko,Alex Bogomolov Jr.,Lukas Lacko,6-0; 6-7(1); 6-1,R16,115,6,0,48,88,37,48,20,40,5,6,13,57,88,1,1,58,75,31,58,8,17,2,8,12,39,75
2012-01-30 00:00:00.000,Zagreb Croatia ATP World Tour 250,HARD,2,Michael Berrer,Jurgen Melzer,Michael Berrer,5-7; 6-4; 6-4,Q,124,13,1,64,88,47,64,11,24,4,7,16,58,88,12,3,65,98,43,65,17,33,8,12,16,60,98
2012-01-30 00:00:00.000,Zagreb Croatia ATP World Tour 250,HARD,2,Mikhail Youzhny,Ivo Karlovic,Mikhail Youzhny,7-6(10); 3-6; 7-6(6),Q,162,10,2,76,114,57,76,23,38,6,8,16,80,114,22,0,86,104,68,86,12,18,4,5,17,80,104
2012-01-30 00:00:00.000,Zagreb Croatia ATP World Tour 250,HARD,2,Marcos Baghdatis,Ivan Dodig,Marcos Baghdatis,6-4; 7-5,Q,100,9,0,43,61,35,43,9,18,2,3,11,44,61,7,5,44,72,32,44,13,28,3,6,11,45,72
2012-01-30 00:00:00.000,Zagreb Croatia ATP World Tour 250,HARD,2,Lukas Lacko,Robin Haase,Lukas Lacko,6-4; 6-4,Q,69,7,0,38,57,32,38,10,19,4,5,10,42,57,8,2,37,62,25,37,13,25,4,7,10,38,62
2012-01-30 00:00:00.000,Zagreb Croatia ATP World Tour 250,HARD,2,Mikhail Youzhny,Michael Berrer,Mikhail Youzhny,6-3; 6-4,S,89,5,4,38,59,28,38,12,21,2,3,10,40,59,5,1,48,69,26,48,12,21,1,4,9,38,69
2012-01-30 00:00:00.000,Zagreb Croatia ATP World Tour 250,HARD,2,Lukas Lacko,Marcos Baghdatis,Lukas Lacko,7-5; 7-6(3),S,107,2,0,46,70,32,46,18,24,0,2,12,50,70,10,0,51,87,40,51,12,36,4,7,12,52,87
2012-01-30 00:00:00.000,Zagreb Croatia ATP World Tour 250,HARD,2,Mikhail Youzhny,Lukas Lacko,Mikhail Youzhny,6-2; 6-3,F,69,4,1,31,48,22,31,14,17,0,0,9,36,48,6,0,34,50,21,34,7,16,4,7,8,28,50
2012-02-13 00:00:00.000,Rotterdam The Netherlands ATP World Tour 500,HARD,2,Roger Federer,Nicolas Mahut,Roger Federer,6-4; 6-4,R32,67,3,1,34,53,28,34,13,19,0,0,10,41,53,3,0,34,57,26,34,11,23,4,6,10,37,57
2012-02-13 00:00:00.000,Rotterdam The Netherlands ATP World Tour 500,HARD,2,Mikhail Youzhny,Igor Kunitsyn,Mikhail Youzhny,6-0; 6-7(4); 6-0,R32,104,7,1,50,70,39,50,9,20,0,1,12,48,70,0,1,47,81,21,47,16,34,2,9,12,37,81
2012-02-13 00:00:00.000,Rotterdam The Netherlands ATP World Tour 500,HARD,2,Jarkko Nieminen,Igor Sijsling,Jarkko Nieminen,6-1; 6-7(7); 7-5,R32,118,5,1,76,105,50,76,18,29,4,6,16,68,105,11,6,53,90,39,53,14,37,1,6,15,53,90
2012-02-13 00:00:00.000,Rotterdam The Netherlands ATP World Tour 500,HARD,2,Lukasz Kubot,Alexandr Dolgopolov,Lukasz Kubot,6-7(4); 6-4; 6-2,R32,142,5,6,54,96,42,54,21,42,4,6,15,63,96,6,3,50,97,36,50,21,47,7,12,15,57,97
2012-02-13 00:00:00.000,Rotterdam The Netherlands ATP World Tour 500,HARD,2,Paul-Henri Mathieu,Feliciano Lopez,Paul-Henri Mathieu,4-6; 7-6(5); 6-4,R32,170,12,3,57,111,47,57,29,54,8,9,16,76,111,13,2,59,99,48,59,23,40,6,7,16,71,99
2012-02-13 00:00:00.000,Rotterdam The Netherlands ATP World Tour 500,HARD,2,Nikolay Davydenko,Robin Haase,Nikolay Davydenko,7-5; 6-2,R32,87,0,2,47,68,32,47,12,21,2,3,10,44,68,3,2,29,58,19,29,14,29,5,9,10,33,58
2012-02-13 00:00:00.000,Rotterdam The Netherlands ATP World Tour 500,HARD,2,Alex Bogomolov Jr.,Sergiy Stakhovsky,Alex Bogomolov Jr.,6-3; 0-1 RET,R32,44,0,0,17,31,14,17,8,14,1,1,5,22,31,5,1,21,35,14,21,8,14,3,4,5,22,35
2012-02-13 00:00:00.000,Rotterdam The Netherlands ATP World Tour 500,HARD,2,Richard Gasquet,Flavio Cipolla,Richard Gasquet,6-3; 1-6; 6-1,R32,143,3,2,58,98,37,58,20,40,10,13,12,57,98,0,4,48,72,27,48,13,24,7,11,11,40,72
2012-02-13 00:00:00.000,Rotterdam The Netherlands ATP World Tour 500,HARD,2,Viktor Troicki,Thiemo de Bakker,Viktor Troicki,7-6(6); 6-0,R32,84,5,0,33,49,23,33,14,16,0,1,9,37,49,5,2,38,71,22,38,14,33,7,11,9,36,71
2012-02-13 00:00:00.000,Rotterdam The Netherlands ATP World Tour 500,HARD,2,Jesse Huta Galung,Ivan Ljubicic,Jesse Huta Galung,7-6(6); 6-3,R32,107,11,2,43,77,35,43,18,34,5,6,11,53,77,11,2,41,67,30,41,14,26,4,6,10,44,67
2012-02-13 00:00:00.000,Rotterdam The Netherlands ATP World Tour 500,HARD,2,Karol Beck,Philipp Petzschner,Karol Beck,7-6(6); 6-3,R32,106,3,3,42,77,33,42,20,35,6,6,11,53,77,3,2,37,71,25,37,19,34,5,6,10,44,71
2012-02-13 00:00:00.000,Rotterdam The Netherlands ATP World Tour 500,HARD,2,Juan Martin Del Potro,Michael Llodra,Juan Martin Del Potro,6-4; 6-7(3); 6-4,R32,147,8,2,70,108,52,70,22,38,6,6,16,74,108,6,0,60,97,45,60,20,37,4,6,16,65,97
2012-02-13 00:00:00.000,Rotterdam The Netherlands ATP World Tour 500,HARD,2,Philipp Kohlschreiber,Marcel Granollers,Philipp Kohlschreiber,6-1; 1-6; 6-4,R32,116,4,2,41,77,26,41,23,36,6,9,12,49,77,6,2,43,77,31,43,14,34,1,5,12,45,77
2012-02-13 00:00:00.000,Rotterdam The Netherlands ATP World Tour 500,HARD,2,Andreas Seppi,Rik De Voest,Andreas Seppi,1-6; 7-6(5); 6-2,R32,119,4,2,45,75,35,45,14,30,3,7,13,49,75,4,0,57,92,34,57,19,35,6,10,14,53,92
2012-02-13 00:00:00.000,Rotterdam The Netherlands ATP World Tour 500,HARD,2,Marcos Baghdatis,Matthias Bachinger,Marcos Baghdatis,7-6(2); 6-2,R32,75,3,2,30,60,26,30,19,30,1,1,10,45,60,11,2,33,57,27,33,11,24,0,2,10,38,57
2012-02-13 00:00:00.000,Rotterdam The Netherlands ATP World Tour 500,HARD,2,Tomas Berdych,Lukas Rosol,Tomas Berdych,6-4; 6-2,R32,76,10,0,31,50,27,31,11,19,2,2,9,38,50,8,2,39,69,24,39,15,30,5,8,9,39,69
2012-02-13 00:00:00.000,Rotterdam The Netherlands ATP World Tour 500,HARD,2,Roger Federer,Mikhail Youzhny,Roger Federer,W/O,R16,0,0,0,0,0,0,0,0,0,0,0,0,0,0,0,0,0,0,0,0,0,0,0,0,0,0,0
2012-02-13 00:00:00.000,Rotterdam The Netherlands ATP World Tour 500,HARD,2,Jarkko Nieminen,Lukasz Kubot,Jarkko Nieminen,6-3; 5-7; 7-6(2),R16,142,2,2,70,102,51,70,15,32,2,5,17,66,102,7,4,59,98,39,59,22,39,3,6,16,61,98
2012-02-13 00:00:00.000,Rotterdam The Netherlands ATP World Tour 500,HARD,2,Nikolay Davydenko,Paul-Henri Mathieu,Nikolay Davydenko,6-4; 6-7(7); 6-1,R16,153,3,6,60,103,40,60,26,43,4,6,15,66,103,1,3,38,87,25,38,28,49,7,12,14,53,87
2012-02-13 00:00:00.000,Rotterdam The Netherlands ATP World Tour 500,HARD,2,Richard Gasquet,Alex Bogomolov Jr.,Richard Gasquet,6-3; 6-2,R16,78,4,3,28,53,19,28,17,25,4,5,9,36,53,1,2,33,50,17,33,9,17,2,6,8,26,50
2012-02-13 00:00:00.000,Rotterdam The Netherlands ATP World Tour 500,HARD,2,Viktor Troicki,Jesse Huta Galung,Viktor Troicki,7-6(2); 6-3,R16,122,10,0,46,69,35,46,12,23,3,4,10,47,69,6,8,50,108,35,50,27,58,11,14,11,62,108
2012-02-13 00:00:00.000,Rotterdam The Netherlands ATP World Tour 500,HARD,2,Juan Martin Del Potro,Karol Beck,Juan Martin Del Potro,6-4; 7-5,R16,109,9,1,36,58,30,36,10,22,0,2,11,40,58,5,4,39,69,28,39,12,30,2,6,11,40,69
2012-02-13 00:00:00.000,Rotterdam The Netherlands ATP World Tour 500,HARD,2,Andreas Seppi,Philipp Kohlschreiber,Andreas Seppi,6-4; 6-2,R16,71,1,1,34,52,28,34,8,18,1,2,9,36,52,2,1,25,51,16,25,11,26,2,6,9,27,51
2012-02-13 00:00:00.000,Rotterdam The Netherlands ATP World Tour 500,HARD,2,Tomas Berdych,Marcos Baghdatis,Tomas Berdych,3-0 RET,R16,19,2,0,4,8,4,4,4,4,0,0,2,8,8,0,1,5,14,2,5,3,9,3,4,1,5,14
2012-02-13 00:00:00.000,Rotterdam The Netherlands ATP World Tour 500,HARD,2,Roger Federer,Jarkko Nieminen,Roger Federer,7-5; 7-6(2),Q,91,8,1,42,68,36,42,18,26,0,0,12,54,68,4,4,58,88,41,58,15,30,5,6,12,56,88
2012-02-13 00:00:00.000,Rotterdam The Netherlands ATP World Tour 500,HARD,2,Nikolay Davydenko,Richard Gasquet,Nikolay Davydenko,7-5; 6-3,Q,98,2,2,44,61,30,44,8,17,6,8,10,38,61,1,4,41,70,25,41,12,29,2,7,11,37,70
2012-02-13 00:00:00.000,Rotterdam The Netherlands ATP World Tour 500,HARD,2,Juan Martin Del Potro,Viktor Troicki,Juan Martin Del Potro,6-0; 6-1,Q,61,4,1,20,32,16,20,8,12,0,0,6,24,32,0,4,21,43,11,21,5,22,2,8,7,16,43
2012-02-13 00:00:00.000,Rotterdam The Netherlands ATP World Tour 500,HARD,2,Tomas Berdych,Andreas Seppi,Tomas Berdych,6-3; 6-4,Q,68,5,0,32,47,25,32,12,15,0,1,10,37,47,3,1,31,49,23,31,6,18,3,6,9,29,49
2012-02-13 00:00:00.000,Rotterdam The Netherlands ATP World Tour 500,HARD,2,Roger Federer,Nikolay Davydenko,Roger Federer,4-6; 6-3; 6-4,S,136,7,1,57,92,40,57,20,35,5,7,15,60,92,2,4,56,102,37,56,23,46,10,13,14,60,102
2012-02-13 00:00:00.000,Rotterdam The Netherlands ATP World Tour 500,HARD,2,Juan Martin Del Potro,Tomas Berdych,Juan Martin Del Potro,6-3; 6-1,S,75,9,2,26,44,23,26,10,18,3,3,8,33,44,4,3,23,47,15,23,9,24,4,8,8,24,47
2012-02-13 00:00:00.000,Rotterdam The Netherlands ATP World Tour 500,HARD,2,Roger Federer,Juan Martin Del Potro,Roger Federer,6-1; 6-4,F,86,5,3,34,69,27,34,18,35,7,7,9,45,69,6,1,27,46,17,27,9,19,2,5,8,26,46
2012-02-13 00:00:00.000,San Jose CA; U.S.A. ATP World Tour 250,HARD,2,Blake Strode,N/A Bye,Blake Strode,,R32,0,0,0,0,0,0,0,0,0,0,0,0,0,0,0,0,0,0,0,0,0,0,0,0,0,0,0
2012-02-13 00:00:00.000,San Jose CA; U.S.A. ATP World Tour 250,HARD,2,Dimitar Kutrovsky,Dennis Lajola,Dimitar Kutrovsky,6-7(7); 6-3; 7-6(3),R32,126,5,6,72,112,49,72,21,40,2,6,17,70,112,15,4,66,108,44,66,20,42,2,7,16,64,108
2012-02-13 00:00:00.000,San Jose CA; U.S.A. ATP World Tour 250,HARD,2,Robby Ginepri,Xavier Malisse,Robby Ginepri,6-1; 6-2,R32,57,8,2,41,55,28,41,9,14,4,4,7,37,55,0,5,20,49,14,20,7,29,2,7,8,21,49
2012-02-13 00:00:00.000,San Jose CA; U.S.A. ATP World Tour 250,HARD,2,Ryan Harrison,Olivier Rochus,Ryan Harrison,4-6; 6-2; 6-3,R32,126,27,3,73,93,52,73,7,20,3,5,14,59,93,0,4,62,94,36,62,18,32,11,15,13,54,94
2012-02-13 00:00:00.000,San Jose CA; U.S.A. ATP World Tour 250,HARD,2,Milos Raonic,N/A Bye,Milos Raonic,,R32,0,0,0,0,0,0,0,0,0,0,0,0,0,0,0,0,0,0,0,0,0,0,0,0,0,0,0
2012-02-13 00:00:00.000,San Jose CA; U.S.A. ATP World Tour 250,HARD,2,Tobias Kamke,Izak Van der Merwe,Tobias Kamke,6-3; 6-3,R32,76,1,2,37,58,24,37,15,21,2,3,9,39,58,3,2,26,51,14,26,12,25,0,4,9,26,51
2012-02-13 00:00:00.000,San Jose CA; U.S.A. ATP World Tour 250,HARD,2,Matthew Ebden,Dudi Sela,Matthew Ebden,6-7(7); 6-2; 7-6(1),R32,150,7,2,73,109,52,73,16,36,3,6,16,68,109,4,6,81,127,52,81,17,46,7,12,16,69,127
2012-02-13 00:00:00.000,San Jose CA; U.S.A. ATP World Tour 250,HARD,2,Kevin Anderson,Grigor Dimitrov,Kevin Anderson,2-6; 7-6(5); 7-6(3),R32,148,15,3,76,110,63,76,15,34,7,9,16,78,110,7,5,64,99,55,64,21,35,1,1,16,76,99
2012-02-13 00:00:00.000,San Jose CA; U.S.A. ATP World Tour 250,HARD,2,Julien Benneteau,Ryan Sweeting,Julien Benneteau,7-6(3); 7-6(5),R32,110,11,3,58,76,44,58,10,18,0,2,12,54,76,4,7,65,108,40,65,23,43,14,16,12,63,108
2012-02-13 00:00:00.000,San Jose CA; U.S.A. ATP World Tour 250,HARD,2,Gilles Muller,Tim Smyczek,Gilles Muller,2-6; 7-6(5); 6-3,R32,108,10,1,46,81,33,46,23,35,3,5,14,56,81,6,0,57,82,43,57,14,25,2,4,15,57,82
2012-02-13 00:00:00.000,San Jose CA; U.S.A. ATP World Tour 250,HARD,2,Steve Darcis,Steve Johnson,Steve Darcis,7-6(4); 7-6(5),R32,108,4,3,59,93,46,59,17,34,4,5,12,63,93,8,4,62,83,46,62,8,21,4,5,12,54,83
2012-02-13 00:00:00.000,San Jose CA; U.S.A. ATP World Tour 250,HARD,2,Radek Stepanek,N/A Bye,Radek Stepanek,,R32,0,0,0,0,0,0,0,0,0,0,0,0,0,0,0,0,0,0,0,0,0,0,0,0,0,0,0
2012-02-13 00:00:00.000,San Jose CA; U.S.A. ATP World Tour 250,HARD,2,Michael Russell,Donald Young,Michael Russell,6-1; 7-6(6),R32,92,2,3,46,68,29,46,11,22,1,4,10,40,68,0,3,37,64,21,37,10,27,4,9,9,31,64
2012-02-13 00:00:00.000,San Jose CA; U.S.A. ATP World Tour 250,HARD,2,Denis Istomin,Sam Querrey,Denis Istomin,5-7; 6-3; 7-5,R32,125,6,0,76,109,54,76,21,33,10,12,17,75,109,15,8,53,101,43,53,23,48,8,11,16,66,101
2012-02-13 00:00:00.000,San Jose CA; U.S.A. ATP World Tour 250,HARD,2,Denis Kudla,Jack Sock,Denis Kudla,6-4; 6-7(6); 6-3,R32,136,9,3,49,96,35,49,33,47,3,4,16,68,96,13,5,73,109,53,73,16,36,9,12,15,69,109
2012-02-13 00:00:00.000,San Jose CA; U.S.A. ATP World Tour 250,HARD,2,Andy Roddick,N/A Bye,Andy Roddick,,R32,0,0,0,0,0,0,0,0,0,0,0,0,0,0,0,0,0,0,0,0,0,0,0,0,0,0,0
2012-02-13 00:00:00.000,San Jose CA; U.S.A. ATP World Tour 250,HARD,2,Dimitar Kutrovsky,Blake Strode,Dimitar Kutrovsky,7-5; 6-3,R16,79,2,2,41,71,29,41,16,30,3,5,11,45,71,8,3,32,54,24,32,8,22,2,6,10,32,54
2012-02-13 00:00:00.000,San Jose CA; U.S.A. ATP World Tour 250,HARD,2,Ryan Harrison,Robby Ginepri,Ryan Harrison,6-3; 2-6; 7-6(0),R16,128,5,3,62,94,45,62,16,32,3,6,15,61,94,3,2,54,93,36,54,23,39,3,5,14,59,93
2012-02-13 00:00:00.000,San Jose CA; U.S.A. ATP World Tour 250,HARD,2,Milos Raonic,Tobias Kamke,Milos Raonic,6-2; 7-6(7),R16,86,18,3,37,61,30,37,15,24,0,1,10,45,61,0,1,45,71,29,45,14,26,5,8,10,43,71
2012-02-13 00:00:00.000,San Jose CA; U.S.A. ATP World Tour 250,HARD,2,Kevin Anderson,Matthew Ebden,Kevin Anderson,6-1; 6-2,R16,66,6,1,42,57,29,42,10,15,3,3,8,39,57,3,1,37,46,20,37,2,9,1,5,7,22,46
2012-02-13 00:00:00.000,San Jose CA; U.S.A. ATP World Tour 250,HARD,2,Julien Benneteau,Gilles Muller,Julien Benneteau,6-2; 6-4,R16,78,3,2,38,54,26,38,9,16,4,6,9,35,54,6,3,30,56,19,30,9,26,2,7,9,28,56
2012-02-13 00:00:00.000,San Jose CA; U.S.A. ATP World Tour 250,HARD,2,Steve Darcis,Radek Stepanek,Steve Darcis,7-6(4); 7-6(2),R16,117,4,1,54,84,37,54,21,30,5,6,12,58,84,4,4,54,84,38,54,15,30,5,6,12,53,84
2012-02-13 00:00:00.000,San Jose CA; U.S.A. ATP World Tour 250,HARD,2,Denis Istomin,Michael Russell,Denis Istomin,6-2; 6-2,R16,59,4,1,28,43,21,28,8,15,0,1,8,29,43,1,7,31,47,19,31,2,16,4,9,8,21,47
2012-02-13 00:00:00.000,San Jose CA; U.S.A. ATP World Tour 250,HARD,2,Andy Roddick,Denis Kudla,Andy Roddick,6-7(5); 7-6(5); 6-4,R16,162,14,3,89,131,66,89,23,42,12,13,17,89,131,7,2,75,126,60,75,26,51,8,10,17,86,126
2012-02-13 00:00:00.000,San Jose CA; U.S.A. ATP World Tour 250,HARD,2,Ryan Harrison,Dimitar Kutrovsky,Ryan Harrison,6-1; 6-4,Q,63,3,3,33,45,25,33,7,12,0,1,9,32,45,0,2,29,50,16,29,8,21,4,8,8,24,50
2012-02-13 00:00:00.000,San Jose CA; U.S.A. ATP World Tour 250,HARD,2,Milos Raonic,Kevin Anderson,Milos Raonic,7-5; 7-6(3),Q,102,16,0,44,67,39,44,14,23,0,0,12,53,67,14,2,49,74,38,49,15,25,3,4,12,53,74
2012-02-13 00:00:00.000,San Jose CA; U.S.A. ATP World Tour 250,HARD,2,Julien Benneteau,Steve Darcis,Julien Benneteau,3-6; 6-1; 6-2,Q,90,11,1,41,58,36,41,10,17,1,2,12,46,58,3,2,45,70,29,45,10,25,6,10,12,39,70
2012-02-13 00:00:00.000,San Jose CA; U.S.A. ATP World Tour 250,HARD,2,Denis Istomin,Andy Roddick,Denis Istomin,6-2; 6-4,Q,77,6,0,32,48,25,32,13,16,1,1,9,38,48,5,0,42,68,28,42,10,26,6,9,9,38,68
2012-02-13 00:00:00.000,San Jose CA; U.S.A. ATP World Tour 250,HARD,2,Milos Raonic,Ryan Harrison,Milos Raonic,7-6(4); 6-2,S,78,20,2,44,57,37,44,9,13,1,1,10,46,57,9,1,41,61,30,41,11,20,3,5,10,41,61
2012-02-13 00:00:00.000,San Jose CA; U.S.A. ATP World Tour 250,HARD,2,Denis Istomin,Julien Benneteau,Denis Istomin,6-3; 6-7(4); 6-3,S,140,7,0,69,105,51,69,21,36,4,5,16,72,105,10,5,61,88,45,61,11,27,2,5,14,56,88
2012-02-13 00:00:00.000,San Jose CA; U.S.A. ATP World Tour 250,HARD,2,Milos Raonic,Denis Istomin,Milos Raonic,7-6(3); 6-2,F,79,7,0,30,48,27,30,17,18,0,0,10,44,48,1,0,39,66,24,39,16,27,0,2,10,40,66
2012-02-13 00:00:00.000,Sao Paulo Brazil ATP World Tour 250,CLAY,2,Nicolas Almagro,N/A Bye,Nicolas Almagro,,R32,0,0,0,0,0,0,0,0,0,0,0,0,0,0,0,0,0,0,0,0,0,0,0,0,0,0,0
2012-02-13 00:00:00.000,Sao Paulo Brazil ATP World Tour 250,CLAY,2,Victor Hanescu,Joao Souza,Victor Hanescu,6-3; 6-3,R32,86,6,1,38,58,26,38,15,20,3,3,9,41,58,6,5,36,54,25,36,8,18,3,6,9,33,54
2012-02-13 00:00:00.000,Sao Paulo Brazil ATP World Tour 250,CLAY,2,Potito Starace,Paul Capdeville,Potito Starace,5-7; 7-6(7); 6-2,R32,144,8,3,75,107,54,75,18,32,7,9,16,72,107,3,3,64,91,45,64,15,27,0,3,16,60,91
2012-02-13 00:00:00.000,Sao Paulo Brazil ATP World Tour 250,CLAY,2,Carlos Berlocq,Eric Prodon,Carlos Berlocq,6-4; 6-0,R32,81,3,0,28,44,19,28,13,16,5,6,8,32,44,2,4,37,65,15,37,13,28,7,12,8,28,65
2012-02-13 00:00:00.000,Sao Paulo Brazil ATP World Tour 250,CLAY,2,Fernando Verdasco,N/A Bye,Fernando Verdasco,,R32,0,0,0,0,0,0,0,0,0,0,0,0,0,0,0,0,0,0,0,0,0,0,0,0,0,0,0
2012-02-13 00:00:00.000,Sao Paulo Brazil ATP World Tour 250,CLAY,2,Javier Marti,Frederico Gil,Javier Marti,6-2; 6-4,R32,86,2,2,26,53,23,26,13,27,3,4,9,36,53,1,3,31,66,14,31,20,35,7,11,9,34,66
2012-02-13 00:00:00.000,Sao Paulo Brazil ATP World Tour 250,CLAY,2,Igor Andreev,Fernando Gonzalez,Igor Andreev,6-2; 6-3,R32,64,5,2,32,42,29,32,7,10,0,0,9,36,42,2,0,41,62,23,41,9,21,5,8,8,32,62
2012-02-13 00:00:00.000,Sao Paulo Brazil ATP World Tour 250,CLAY,2,Albert Ramos-Vinolas,Santiago Giraldo,Albert Ramos-Vinolas,6-3; 6-4,R32,84,7,6,43,73,32,43,14,30,6,8,10,46,73,5,1,32,53,21,32,6,21,2,6,9,27,53
2012-02-13 00:00:00.000,Sao Paulo Brazil ATP World Tour 250,CLAY,2,Leonardo Mayer,Juan Carlos Ferrero,Leonardo Mayer,7-6(6); 6-2,R32,112,11,2,43,74,33,43,18,31,5,5,10,51,74,1,3,46,66,29,46,11,20,4,6,10,40,66
2012-02-13 00:00:00.000,Sao Paulo Brazil ATP World Tour 250,CLAY,2,Jeremy Chardy,Blaz Kavcic,Jeremy Chardy,6-4; 6-4,R32,81,8,2,39,60,30,39,13,21,2,2,10,43,60,6,4,35,60,25,35,13,25,4,6,10,38,60
2012-02-13 00:00:00.000,Sao Paulo Brazil ATP World Tour 250,CLAY,2,Ricardo Mello,Pere Riba,Ricardo Mello,6-4; 6-2,R32,73,4,1,28,49,25,28,12,21,0,0,9,37,49,4,3,32,58,21,32,12,26,1,4,9,33,58
2012-02-13 00:00:00.000,Sao Paulo Brazil ATP World Tour 250,CLAY,2,Thomaz Bellucci,N/A Bye,Thomaz Bellucci,,R32,0,0,0,0,0,0,0,0,0,0,0,0,0,0,0,0,0,0,0,0,0,0,0,0,0,0,0
2012-02-13 00:00:00.000,Sao Paulo Brazil ATP World Tour 250,CLAY,2,Filippo Volandri,Albert Montanes,Filippo Volandri,6-2; 6-3,R32,65,0,1,35,46,27,35,8,11,3,4,9,35,46,1,2,24,44,17,24,6,20,3,7,8,23,44
2012-02-13 00:00:00.000,Sao Paulo Brazil ATP World Tour 250,CLAY,2,Ruben Ramirez Hidalgo,Rui Machado,Ruben Ramirez Hidalgo,6-3; 1-6; 6-2,R32,121,1,4,33,74,24,33,19,41,2,6,12,43,74,3,5,44,74,27,44,12,30,3,8,12,39,74
2012-02-13 00:00:00.000,Sao Paulo Brazil ATP World Tour 250,CLAY,2,David Nalbandian,Benoit Paire,David Nalbandian,7-6(3); 6-3,R32,99,3,4,50,85,37,50,15,35,5,8,11,52,85,9,5,33,69,24,33,13,36,7,11,10,37,69
2012-02-13 00:00:00.000,Sao Paulo Brazil ATP World Tour 250,CLAY,2,Gilles Simon,N/A Bye,Gilles Simon,,R32,0,0,0,0,0,0,0,0,0,0,0,0,0,0,0,0,0,0,0,0,0,0,0,0,0,0,0
2012-02-13 00:00:00.000,Sao Paulo Brazil ATP World Tour 250,CLAY,2,Nicolas Almagro,Victor Hanescu,Nicolas Almagro,6-3; 6-7(4); 6-3,R16,127,12,1,48,91,43,48,26,43,0,0,16,69,91,9,2,72,94,55,72,10,22,6,8,14,65,94
2012-02-13 00:00:00.000,Sao Paulo Brazil ATP World Tour 250,CLAY,2,Carlos Berlocq,Potito Starace,Carlos Berlocq,3-6; 6-2; 6-3,R16,117,2,3,46,68,30,46,13,22,2,5,13,43,68,0,3,65,85,35,65,10,20,8,13,13,45,85
2012-02-13 00:00:00.000,Sao Paulo Brazil ATP World Tour 250,CLAY,2,Fernando Verdasco,Javier Marti,Fernando Verdasco,6-4; 6-7(2); 7-5,R16,162,6,6,72,100,50,72,15,28,7,10,17,65,100,5,2,64,110,45,64,22,46,4,9,17,67,110
2012-02-13 00:00:00.000,Sao Paulo Brazil ATP World Tour 250,CLAY,2,Albert Ramos-Vinolas,Igor Andreev,Albert Ramos-Vinolas,7-6(4); 7-6(4),R16,133,7,1,54,87,45,54,20,33,4,4,12,65,87,10,2,53,87,44,53,18,34,3,3,12,62,87
2012-02-13 00:00:00.000,Sao Paulo Brazil ATP World Tour 250,CLAY,2,Leonardo Mayer,Jeremy Chardy,Leonardo Mayer,4-6; 7-5; 6-2,R16,153,7,6,54,88,45,54,17,34,2,3,15,62,88,14,7,57,112,44,57,24,55,9,12,15,68,112
2012-02-13 00:00:00.000,Sao Paulo Brazil ATP World Tour 250,CLAY,2,Thomaz Bellucci,Ricardo Mello,Thomaz Bellucci,6-0; 1-6; 6-3,R16,93,4,3,31,63,24,31,15,32,2,5,11,39,63,3,2,40,63,24,40,11,23,4,9,11,35,63
2012-02-13 00:00:00.000,Sao Paulo Brazil ATP World Tour 250,CLAY,2,Filippo Volandri,Ruben Ramirez Hidalgo,Filippo Volandri,6-4; 1-6; 6-3,R16,129,1,2,57,83,34,57,16,26,3,6,13,50,83,5,8,50,97,37,50,20,47,8,11,13,57,97
2012-02-13 00:00:00.000,Sao Paulo Brazil ATP World Tour 250,CLAY,2,David Nalbandian,Gilles Simon,David Nalbandian,6-3; 6-2,R16,68,1,1,29,52,19,29,17,23,5,5,8,36,52,3,3,25,50,17,25,10,25,3,7,9,27,50
2012-02-13 00:00:00.000,Sao Paulo Brazil ATP World Tour 250,CLAY,2,Nicolas Almagro,Carlos Berlocq,Nicolas Almagro,6-3; 6-2,Q,91,6,0,28,54,21,28,17,26,1,1,9,38,54,5,5,29,61,21,29,12,32,8,11,8,33,61
2012-02-13 00:00:00.000,Sao Paulo Brazil ATP World Tour 250,CLAY,2,Albert Ramos-Vinolas,Fernando Verdasco,Albert Ramos-Vinolas,7-6(5); 6-3,Q,116,5,3,48,75,38,48,12,27,3,4,11,50,75,6,1,51,73,31,51,12,22,4,6,10,43,73
2012-02-13 00:00:00.000,Sao Paulo Brazil ATP World Tour 250,CLAY,2,Thomaz Bellucci,Leonardo Mayer,Thomaz Bellucci,3-6; 6-2; 7-5,Q,157,8,3,43,79,32,43,23,36,2,4,14,55,79,6,7,56,104,40,56,19,48,9,13,15,59,104
2012-02-13 00:00:00.000,Sao Paulo Brazil ATP World Tour 250,CLAY,2,Filippo Volandri,David Nalbandian,Filippo Volandri,3-6; 6-3; 7-5,Q,143,0,3,72,105,49,72,17,33,8,10,15,66,105,2,4,66,100,44,66,16,34,7,10,15,60,100
2012-02-13 00:00:00.000,Sao Paulo Brazil ATP World Tour 250,CLAY,2,Nicolas Almagro,Albert Ramos-Vinolas,Nicolas Almagro,6-4; 7-6(4),S,109,6,1,40,66,31,40,20,26,1,2,11,51,66,6,4,46,76,32,46,17,30,6,8,11,49,76
2012-02-13 00:00:00.000,Sao Paulo Brazil ATP World Tour 250,CLAY,2,Filippo Volandri,Thomaz Bellucci,Filippo Volandri,5-7; 6-0; 6-2,S,153,3,2,56,80,39,56,14,24,3,5,13,53,80,2,4,63,110,39,63,19,47,12,18,13,58,110
2012-02-13 00:00:00.000,Sao Paulo Brazil ATP World Tour 250,CLAY,2,Nicolas Almagro,Filippo Volandri,Nicolas Almagro,6-3; 4-6; 6-4,F,122,18,2,42,73,37,42,16,31,1,3,14,53,73,0,2,77,107,45,77,16,30,7,11,15,61,107
2012-02-20 00:00:00.000,Buenos Aires Argentina ATP World Tour 250,CLAY,2,David Ferrer,Andres Molteni,David Ferrer,6-1; 6-0,R32,50,2,0,23,36,21,23,8,13,0,0,7,29,36,0,2,15,28,4,15,3,13,1,6,6,7,28
2012-02-20 00:00:00.000,Buenos Aires Argentina ATP World Tour 250,CLAY,2,Facundo Bagnis,Leonardo Mayer,Facundo Bagnis,5-7; 6-4; 6-2,R32,165,2,2,62,97,42,62,22,35,6,8,15,64,97,5,7,61,105,45,61,18,44,10,14,15,63,105
2012-02-20 00:00:00.000,Buenos Aires Argentina ATP World Tour 250,CLAY,2,Fernando Gonzalez,Albert Montanes,Fernando Gonzalez,7-5; 1-0 RET,R32,52,5,0,27,41,19,27,10,14,0,1,7,29,41,1,3,25,32,16,25,2,7,1,3,6,18,32
2012-02-20 00:00:00.000,Buenos Aires Argentina ATP World Tour 250,CLAY,2,Albert Ramos-Vinolas,Juan Ignacio Chela,Albert Ramos-Vinolas,4-6; 6-3; 6-4,R32,163,5,3,58,111,34,58,30,53,14,18,15,64,111,2,1,69,96,44,69,11,27,7,12,14,55,96
2012-02-20 00:00:00.000,Buenos Aires Argentina ATP World Tour 250,CLAY,2,Gilles Simon,Rui Machado,Gilles Simon,6-3; 7-5,R32,125,2,2,52,91,35,52,17,39,6,8,11,52,91,2,4,46,65,31,46,6,19,5,9,10,37,65
2012-02-20 00:00:00.000,Buenos Aires Argentina ATP World Tour 250,CLAY,2,Carlos Berlocq,Pere Riba,Carlos Berlocq,6-7(5); 6-0; 6-0,R32,147,1,1,73,98,49,73,12,25,9,11,12,61,98,6,3,53,80,25,53,13,27,4,12,12,38,80
2012-02-20 00:00:00.000,Buenos Aires Argentina ATP World Tour 250,CLAY,2,David Nalbandian,Wayne Odesnik,David Nalbandian,6-2; 6-3,R32,81,2,1,24,42,17,24,13,18,0,1,8,30,42,1,3,34,61,20,34,9,27,2,7,9,29,61
2012-02-20 00:00:00.000,Buenos Aires Argentina ATP World Tour 250,CLAY,2,Juan Monaco,Filippo Volandri,Juan Monaco,6-1; 3-1 RET,R32,50,0,2,20,35,14,20,9,15,1,2,6,23,35,0,1,29,41,14,29,2,12,2,6,5,16,41
2012-02-20 00:00:00.000,Buenos Aires Argentina ATP World Tour 250,CLAY,2,Stan Wawrinka,Horacio Zeballos,Stan Wawrinka,6-3; 6-4,R32,88,4,1,42,61,31,42,11,19,6,7,10,42,61,4,1,43,60,26,43,11,17,1,4,9,37,60
2012-02-20 00:00:00.000,Buenos Aires Argentina ATP World Tour 250,CLAY,2,Benoit Paire,Javier Marti,Benoit Paire,2-6; 7-6(0); 6-2,R32,122,3,4,48,96,31,48,24,48,5,10,14,55,96,3,1,66,96,37,66,17,30,2,7,14,54,96
2012-02-20 00:00:00.000,Buenos Aires Argentina ATP World Tour 250,CLAY,2,Victor Hanescu,Pablo Andujar,Victor Hanescu,6-3; 4-6; 7-6(4),R32,158,2,1,79,117,53,79,21,38,4,6,16,74,117,1,3,57,90,42,57,18,33,2,4,15,60,90
2012-02-20 00:00:00.000,Buenos Aires Argentina ATP World Tour 250,CLAY,2,Kei Nishikori,Juan Carlos Ferrero,Kei Nishikori,7-5; 3-6; 6-2,R32,127,4,5,65,95,44,65,12,30,9,14,15,56,95,0,2,63,91,34,63,14,28,8,14,14,48,91
2012-02-20 00:00:00.000,Buenos Aires Argentina ATP World Tour 250,CLAY,2,Fernando Verdasco,Eric Prodon,Fernando Verdasco,6-4; 6-1,R32,70,3,1,44,52,33,44,3,8,2,3,9,36,52,4,0,32,50,19,32,6,18,4,8,8,25,50
2012-02-20 00:00:00.000,Buenos Aires Argentina ATP World Tour 250,CLAY,2,Igor Andreev,Blaz Kavcic,Igor Andreev,6-2; 6-2,R32,65,1,1,27,49,17,27,15,22,1,2,8,32,49,0,7,30,48,15,30,7,18,0,5,8,22,48
2012-02-20 00:00:00.000,Buenos Aires Argentina ATP World Tour 250,CLAY,2,Federico Delbonis,Frederico Gil,Federico Delbonis,6-2; 6-2,R32,54,3,1,27,42,24,27,9,15,1,1,8,33,42,2,1,33,42,19,33,3,9,1,5,8,22,42
2012-02-20 00:00:00.000,Buenos Aires Argentina ATP World Tour 250,CLAY,2,Nicolas Almagro,Potito Starace,Nicolas Almagro,4-6; 6-3; 7-6(4),R32,128,7,0,68,95,57,68,10,27,2,4,16,67,95,3,1,71,93,53,71,9,22,5,7,15,62,93
2012-02-20 00:00:00.000,Buenos Aires Argentina ATP World Tour 250,CLAY,2,David Ferrer,Facundo Bagnis,David Ferrer,6-3; 6-4,R16,77,3,1,32,54,26,32,11,22,3,5,10,37,54,6,3,37,56,23,37,10,19,7,11,9,33,56
2012-02-20 00:00:00.000,Buenos Aires Argentina ATP World Tour 250,CLAY,2,Fernando Gonzalez,Albert Ramos-Vinolas,Fernando Gonzalez,7-6(6); 7-6(5),R16,111,13,1,57,87,44,57,17,30,3,3,12,61,87,2,3,53,79,40,53,18,26,3,3,12,58,79
2012-02-20 00:00:00.000,Buenos Aires Argentina ATP World Tour 250,CLAY,2,Carlos Berlocq,Gilles Simon,Carlos Berlocq,6-2; 6-1,R16,66,1,1,29,37,24,29,5,8,0,0,7,29,37,0,1,23,45,13,23,5,22,1,6,8,18,45
2012-02-20 00:00:00.000,Buenos Aires Argentina ATP World Tour 250,CLAY,2,David Nalbandian,Juan Monaco,David Nalbandian,6-3; 6-1,R16,89,1,1,36,64,24,36,17,28,3,3,8,41,64,3,1,42,55,22,42,7,13,8,12,8,29,55
2012-02-20 00:00:00.000,Buenos Aires Argentina ATP World Tour 250,CLAY,2,Stan Wawrinka,Benoit Paire,Stan Wawrinka,6-3; 5-7; 6-2,R16,105,4,2,64,90,45,64,13,26,4,7,15,58,90,5,5,57,97,41,57,12,40,4,9,14,53,97
2012-02-20 00:00:00.000,Buenos Aires Argentina ATP World Tour 250,CLAY,2,Kei Nishikori,Victor Hanescu,Kei Nishikori,3-6; 7-5; 6-1,R16,134,4,2,79,106,52,79,14,27,7,9,14,66,106,3,3,60,91,40,60,13,31,6,10,14,53,91
2012-02-20 00:00:00.000,Buenos Aires Argentina ATP World Tour 250,CLAY,2,Igor Andreev,Fernando Verdasco,Igor Andreev,7-6(3); 6-3,R16,100,1,1,32,60,29,32,17,28,0,1,11,46,60,4,6,53,73,37,53,6,20,5,7,10,43,73
2012-02-20 00:00:00.000,Buenos Aires Argentina ATP World Tour 250,CLAY,2,Nicolas Almagro,Federico Delbonis,Nicolas Almagro,6-3; 6-2,R16,74,6,1,22,48,19,22,17,26,0,0,9,36,48,0,0,36,62,22,36,12,26,3,6,8,34,62
2012-02-20 00:00:00.000,Buenos Aires Argentina ATP World Tour 250,CLAY,2,David Ferrer,Fernando Gonzalez,David Ferrer,6-2; 6-4,Q,75,3,2,37,51,29,37,9,14,1,1,9,38,51,3,0,34,61,25,34,9,27,2,5,9,34,61
2012-02-20 00:00:00.000,Buenos Aires Argentina ATP World Tour 250,CLAY,2,David Nalbandian,Carlos Berlocq,David Nalbandian,6-0; 6-3,Q,62,1,2,32,46,24,32,9,14,3,4,8,33,46,1,0,23,42,10,23,7,19,3,8,7,17,42
2012-02-20 00:00:00.000,Buenos Aires Argentina ATP World Tour 250,CLAY,2,Stan Wawrinka,Kei Nishikori,Stan Wawrinka,6-4; 6-2,Q,96,4,1,40,61,28,40,15,21,3,3,9,43,61,1,1,43,62,26,43,10,19,4,7,9,36,62
2012-02-20 00:00:00.000,Buenos Aires Argentina ATP World Tour 250,CLAY,2,Nicolas Almagro,Igor Andreev,Nicolas Almagro,6-3; 7-5,Q,88,8,0,38,62,24,38,16,24,1,3,11,40,62,1,0,33,57,23,33,8,24,2,6,10,31,57
2012-02-20 00:00:00.000,Buenos Aires Argentina ATP World Tour 250,CLAY,2,David Ferrer,David Nalbandian,David Ferrer,6-1; 6-4,S,64,2,2,31,43,29,31,7,12,0,0,9,36,43,0,2,29,45,19,29,6,16,3,6,8,25,45
2012-02-20 00:00:00.000,Buenos Aires Argentina ATP World Tour 250,CLAY,2,Nicolas Almagro,Stan Wawrinka,Nicolas Almagro,6-4; 3-6; 7-5,S,142,8,0,47,90,38,47,24,43,2,4,15,62,90,8,1,57,97,40,57,23,40,4,7,16,63,97
2012-02-20 00:00:00.000,Buenos Aires Argentina ATP World Tour 250,CLAY,2,David Ferrer,Nicolas Almagro,David Ferrer,4-6; 6-3; 6-2,F,114,5,3,57,85,45,57,15,28,1,2,14,60,85,7,1,50,84,36,50,14,34,8,11,13,50,84
2012-02-20 00:00:00.000,Marseille France ATP World Tour 250,HARD,2,Jo-Wilfried Tsonga,N/A Bye,Jo-Wilfried Tsonga,,R32,0,0,0,0,0,0,0,0,0,0,0,0,0,0,0,0,0,0,0,0,0,0,0,0,0,0,0
2012-02-20 00:00:00.000,Marseille France ATP World Tour 250,HARD,2,Nicolas Mahut,Arnaud Clement,Nicolas Mahut,6-3; 6-4,R32,82,12,2,42,62,33,42,9,20,3,4,10,42,62,4,2,30,50,20,30,10,20,2,5,9,30,50
2012-02-20 00:00:00.000,Marseille France ATP World Tour 250,HARD,2,Edouard Roger-Vasselin,Jarkko Nieminen,Edouard Roger-Vasselin,6-2; 7-6(4),R32,80,7,2,42,62,35,42,12,20,2,2,10,47,62,4,1,49,71,28,49,15,22,4,6,10,43,71
2012-02-20 00:00:00.000,Marseille France ATP World Tour 250,HARD,2,Flavio Cipolla,Andreas Seppi,Flavio Cipolla,6-4; 7-6(4),R32,108,2,2,55,82,38,55,18,27,7,7,11,56,82,7,1,44,71,31,44,16,27,2,3,11,47,71
2012-02-20 00:00:00.000,Marseille France ATP World Tour 250,HARD,2,Juan Martin Del Potro,N/A Bye,Juan Martin Del Potro,,R32,0,0,0,0,0,0,0,0,0,0,0,0,0,0,0,0,0,0,0,0,0,0,0,0,0,0,0
2012-02-20 00:00:00.000,Marseille France ATP World Tour 250,HARD,2,Nikolay Davydenko,Andreas Beck,Nikolay Davydenko,6-1; 7-5,R32,81,9,3,38,59,29,38,13,21,0,0,10,42,59,5,2,36,57,24,36,7,21,4,7,9,31,57
2012-02-20 00:00:00.000,Marseille France ATP World Tour 250,HARD,2,Igor Kunitsyn,Roberto Bautista Agut,Igor Kunitsyn,6-4; 6-4,R32,92,2,4,35,65,27,35,18,30,7,8,10,45,65,3,1,44,64,27,44,11,20,7,10,10,38,64
2012-02-20 00:00:00.000,Marseille France ATP World Tour 250,HARD,2,Richard Gasquet,Go Soeda,Richard Gasquet,6-0; 6-2,R32,63,2,1,34,46,22,34,10,12,7,7,7,32,46,2,1,15,39,6,15,9,24,1,6,7,15,39
2012-02-20 00:00:00.000,Marseille France ATP World Tour 250,HARD,2,Ivan Ljubicic,Florent Serra,Ivan Ljubicic,6-4; 6-7(3); 6-3,R32,129,27,3,66,105,53,66,19,39,3,3,16,72,105,6,1,49,87,39,49,19,38,0,2,15,58,87
2012-02-20 00:00:00.000,Marseille France ATP World Tour 250,HARD,2,Karol Beck,Paul-Henri Mathieu,Karol Beck,7-6(2); 2-6; 6-3,R32,145,11,4,49,97,39,49,24,48,5,7,15,63,97,5,3,49,89,39,49,20,40,4,5,14,59,89
2012-02-20 00:00:00.000,Marseille France ATP World Tour 250,HARD,2,David Goffin,Adrian Mannarino,David Goffin,6-2; 1-0 RET,R32,37,2,1,19,24,15,19,3,5,3,3,4,18,24,0,3,10,28,6,10,7,18,1,4,5,13,28
2012-02-20 00:00:00.000,Marseille France ATP World Tour 250,HARD,2,Janko Tipsarevic,N/A Bye,Janko Tipsarevic,,R32,0,0,0,0,0,0,0,0,0,0,0,0,0,0,0,0,0,0,0,0,0,0,0,0,0,0,0
2012-02-20 00:00:00.000,Marseille France ATP World Tour 250,HARD,2,Alexandr Dolgopolov,Lukas Rosol,Alexandr Dolgopolov,2-6; 7-6(1); 6-3,R32,99,14,2,45,83,39,45,23,38,2,4,15,62,83,15,1,57,93,41,57,22,36,5,6,14,63,93
2012-02-20 00:00:00.000,Marseille France ATP World Tour 250,HARD,2,Michael Llodra,Marco Chiudinelli,Michael Llodra,7-6(2); 7-6(3),R32,118,12,1,48,81,38,48,24,33,7,7,12,62,81,5,0,60,89,43,60,16,29,4,4,12,59,89
2012-02-20 00:00:00.000,Marseille France ATP World Tour 250,HARD,2,Albano Olivetti,Matthias Bachinger,Albano Olivetti,6-4; 6-3,R32,68,9,1,36,56,30,36,12,20,0,0,10,42,56,6,2,30,53,26,30,10,23,3,5,9,36,53
2012-02-20 00:00:00.000,Marseille France ATP World Tour 250,HARD,2,Mardy Fish,N/A Bye,Mardy Fish,,R32,0,0,0,0,0,0,0,0,0,0,0,0,0,0,0,0,0,0,0,0,0,0,0,0,0,0,0
2012-02-20 00:00:00.000,Marseille France ATP World Tour 250,HARD,2,Jo-Wilfried Tsonga,Nicolas Mahut,Jo-Wilfried Tsonga,6-3; 6-2,R16,55,10,0,27,41,26,27,10,14,0,0,9,36,41,1,1,26,44,15,26,10,18,0,3,8,25,44
2012-02-20 00:00:00.000,Marseille France ATP World Tour 250,HARD,2,Edouard Roger-Vasselin,Flavio Cipolla,Edouard Roger-Vasselin,6-3; 6-0,R16,77,5,1,21,34,17,21,7,13,0,1,7,24,34,2,5,47,78,24,47,10,31,12,18,8,34,78
2012-02-20 00:00:00.000,Marseille France ATP World Tour 250,HARD,2,Juan Martin Del Potro,Nikolay Davydenko,Juan Martin Del Potro,6-7(6); 6-4 RET,R16,118,16,1,46,72,39,46,11,26,2,2,11,50,72,2,3,51,79,35,51,16,28,8,9,11,51,79
2012-02-20 00:00:00.000,Marseille France ATP World Tour 250,HARD,2,Richard Gasquet,Igor Kunitsyn,Richard Gasquet,6-3; 6-2,R16,70,10,1,42,63,31,42,11,21,6,6,9,42,63,3,0,26,39,18,26,7,13,1,4,8,25,39
2012-02-20 00:00:00.000,Marseille France ATP World Tour 250,HARD,2,Ivan Ljubicic,Karol Beck,Ivan Ljubicic,6-4; 7-6(1),R16,94,15,5,44,70,38,44,14,26,1,1,11,52,70,5,1,37,60,31,37,11,23,0,1,11,42,60
2012-02-20 00:00:00.000,Marseille France ATP World Tour 250,HARD,2,Janko Tipsarevic,David Goffin,Janko Tipsarevic,6-4; 6-2,R16,89,8,2,31,63,25,31,17,32,6,6,9,42,63,3,4,25,54,18,25,14,29,2,5,9,32,54
2012-02-20 00:00:00.000,Marseille France ATP World Tour 250,HARD,2,Michael Llodra,Alexandr Dolgopolov,Michael Llodra,6-4; 5-7; 7-6(5),R16,139,19,7,68,105,51,68,19,37,6,9,17,70,105,11,4,58,120,43,58,31,62,7,10,17,74,120
2012-02-20 00:00:00.000,Marseille France ATP World Tour 250,HARD,2,Albano Olivetti,Mardy Fish,Albano Olivetti,6-3; 3-6; 6-3,R16,109,23,9,44,89,36,44,20,45,4,6,14,56,89,6,2,52,81,38,52,13,29,8,11,13,51,81
2012-02-20 00:00:00.000,Marseille France ATP World Tour 250,HARD,2,Jo-Wilfried Tsonga,Edouard Roger-Vasselin,Jo-Wilfried Tsonga,6-4; 7-5,Q,92,14,2,49,69,39,49,9,20,10,11,11,48,69,2,6,42,67,30,42,10,25,4,7,11,40,67
2012-02-20 00:00:00.000,Marseille France ATP World Tour 250,HARD,2,Juan Martin Del Potro,Richard Gasquet,Juan Martin Del Potro,7-5; 7-6(5),Q,118,15,3,54,84,42,54,13,30,7,9,12,55,84,6,1,42,71,29,42,19,29,7,10,12,48,71
2012-02-20 00:00:00.000,Marseille France ATP World Tour 250,HARD,2,Janko Tipsarevic,Ivan Ljubicic,Janko Tipsarevic,6-4; 6-4,Q,89,9,0,43,58,30,43,11,15,0,0,10,41,58,15,5,41,68,30,41,13,27,6,8,10,43,68
2012-02-20 00:00:00.000,Marseille France ATP World Tour 250,HARD,2,Michael Llodra,Albano Olivetti,Michael Llodra,7-6(5); 7-5,Q,88,14,0,46,58,44,46,9,12,0,0,12,53,58,13,6,49,79,38,49,16,30,3,4,12,54,79
2012-02-20 00:00:00.000,Marseille France ATP World Tour 250,HARD,2,Juan Martin Del Potro,Jo-Wilfried Tsonga,Juan Martin Del Potro,6-4; 6-7(9); 6-3,S,169,15,0,66,113,52,66,27,47,6,7,16,79,113,26,2,69,104,48,69,18,35,2,5,15,66,104
2012-02-20 00:00:00.000,Marseille France ATP World Tour 250,HARD,2,Michael Llodra,Janko Tipsarevic,Michael Llodra,6-4; 7-6(10),S,100,14,3,45,83,39,45,18,38,4,4,11,57,83,10,0,44,70,36,44,13,26,2,3,11,49,70
2012-02-20 00:00:00.000,Marseille France ATP World Tour 250,HARD,2,Juan Martin Del Potro,Michael Llodra,Juan Martin Del Potro,6-4; 6-4,F,83,11,1,40,55,36,40,6,15,0,0,10,42,55,10,2,44,66,28,44,13,22,6,8,10,41,66
2012-02-20 00:00:00.000,Memphis TN; U.S.A. ATP World Tour 500,HARD,2,John Isner,Gilles Muller,John Isner,7-6(1); 7-6(4),R32,100,26,2,50,71,48,50,12,21,1,1,12,60,71,5,9,47,83,39,47,21,36,5,5,12,60,83
2012-02-20 00:00:00.000,Memphis TN; U.S.A. ATP World Tour 500,HARD,2,Donald Young,Grigor Dimitrov,Donald Young,7-6(4); 4-6; 7-6(6),R32,143,1,7,76,114,52,76,16,38,5,10,17,68,114,6,6,72,114,48,72,24,42,10,14,17,72,114
2012-02-20 00:00:00.000,Memphis TN; U.S.A. ATP World Tour 500,HARD,2,Jurgen Melzer,Denis Istomin,Jurgen Melzer,6-7(2); 6-3; 7-6(4),R32,136,6,5,62,117,45,62,31,55,6,8,17,76,117,9,3,80,104,53,80,14,24,5,8,16,67,104
2012-02-20 00:00:00.000,Memphis TN; U.S.A. ATP World Tour 500,HARD,2,Ivan Dodig,Bernard Tomic,Ivan Dodig,5-7; 6-4; 7-6(8),R32,174,19,7,64,127,48,64,30,63,6,10,17,78,127,7,4,92,135,57,92,22,43,7,11,17,79,135
2012-02-20 00:00:00.000,Memphis TN; U.S.A. ATP World Tour 500,HARD,2,Radek Stepanek,Bobby Reynolds,Radek Stepanek,6-3; 6-2,R32,77,5,3,36,53,29,36,10,17,4,4,9,39,53,5,2,29,57,21,29,10,28,3,6,8,31,57
2012-02-20 00:00:00.000,Memphis TN; U.S.A. ATP World Tour 500,HARD,2,Ryan Sweeting,James Blake,Ryan Sweeting,6-0; 6-2,R32,45,4,3,16,33,12,16,14,17,1,2,7,26,33,0,0,26,47,14,26,5,21,4,10,7,19,47
2012-02-20 00:00:00.000,Memphis TN; U.S.A. ATP World Tour 500,HARD,2,Sam Querrey,Alejandro Falla,Sam Querrey,2-6; 6-3; 6-4,R32,103,12,6,48,89,36,48,20,41,3,6,14,56,89,2,4,41,77,27,41,23,36,2,5,13,50,77
2012-02-20 00:00:00.000,Memphis TN; U.S.A. ATP World Tour 500,HARD,2,Kevin Anderson,Robby Ginepri,Kevin Anderson,7-5; 6-3,R32,75,19,4,30,53,29,30,15,23,0,0,11,44,53,5,0,38,57,25,38,12,19,2,4,10,37,57
2012-02-20 00:00:00.000,Memphis TN; U.S.A. ATP World Tour 500,HARD,2,Olivier Rochus,Alex Bogomolov Jr.,Olivier Rochus,1-6; 6-4; 7-6(5),R32,138,3,5,50,88,31,50,20,38,3,9,14,51,88,11,3,68,104,45,68,15,36,6,11,15,60,104
2012-02-20 00:00:00.000,Memphis TN; U.S.A. ATP World Tour 500,HARD,2,Ryan Harrison,Jack Sock,Ryan Harrison,6-3; 2-6; 6-4,R32,117,9,5,59,98,45,59,17,39,7,9,14,62,98,5,4,51,79,36,51,16,28,4,6,13,52,79
2012-02-20 00:00:00.000,Memphis TN; U.S.A. ATP World Tour 500,HARD,2,Sergiy Stakhovsky,Robert Kendrick,Sergiy Stakhovsky,6-3; 7-6(6),R32,71,10,2,27,59,25,27,23,32,0,0,11,48,59,6,1,39,64,32,39,10,25,1,2,10,42,64
2012-02-20 00:00:00.000,Memphis TN; U.S.A. ATP World Tour 500,HARD,2,Milos Raonic,Ernests Gulbis,Milos Raonic,6-2; 7-6(3),R32,90,15,5,37,68,31,37,18,31,4,4,10,49,68,7,7,34,66,24,34,17,32,1,3,10,41,66
2012-02-20 00:00:00.000,Memphis TN; U.S.A. ATP World Tour 500,HARD,2,Philipp Petzschner,Julien Benneteau,Philipp Petzschner,7-6(5); 7-6(6),R32,119,7,4,65,105,51,65,14,40,7,9,12,65,105,7,6,43,83,33,43,21,40,2,4,12,54,83
2012-02-20 00:00:00.000,Memphis TN; U.S.A. ATP World Tour 500,HARD,2,Lukasz Kubot,Jesse Levine,Lukasz Kubot,7-6(2); 6-4,R32,98,10,3,41,75,35,41,16,34,3,4,11,51,75,4,2,41,61,34,41,8,20,1,3,11,42,61
2012-02-20 00:00:00.000,Memphis TN; U.S.A. ATP World Tour 500,HARD,2,Benjamin Becker,Dudi Sela,Benjamin Becker,6-4; 6-1,R32,62,5,3,30,56,23,30,19,26,5,5,9,42,56,1,2,27,42,17,27,7,15,1,4,8,24,42
2012-02-20 00:00:00.000,Memphis TN; U.S.A. ATP World Tour 500,HARD,2,Xavier Malisse,Andy Roddick,Xavier Malisse,7-6(8); 7-5,R32,108,12,4,40,83,34,40,24,43,6,7,12,58,83,6,1,51,77,38,51,12,26,3,5,12,50,77
2012-02-20 00:00:00.000,Memphis TN; U.S.A. ATP World Tour 500,HARD,2,John Isner,Donald Young,John Isner,7-6(3); 6-4,R16,103,22,3,65,84,47,65,10,19,4,5,11,57,84,0,1,49,74,34,49,12,25,4,6,11,46,74
2012-02-20 00:00:00.000,Memphis TN; U.S.A. ATP World Tour 500,HARD,2,Jurgen Melzer,Ivan Dodig,Jurgen Melzer,2-6; 6-3; 7-6(5),R16,129,3,8,58,100,43,58,21,42,4,7,15,64,100,9,5,47,101,35,47,28,54,6,8,14,63,101
2012-02-20 00:00:00.000,Memphis TN; U.S.A. ATP World Tour 500,HARD,2,Radek Stepanek,Ryan Sweeting,Radek Stepanek,4-6; 6-3; 7-6(4),R16,141,7,7,60,110,49,60,22,50,3,5,16,71,110,6,11,48,102,35,48,30,54,5,7,15,65,102
2012-02-20 00:00:00.000,Memphis TN; U.S.A. ATP World Tour 500,HARD,2,Sam Querrey,Kevin Anderson,Sam Querrey,7-6(4); 6-4,R16,93,3,4,27,57,23,27,22,30,1,2,11,45,57,7,8,31,71,23,31,21,40,4,6,11,44,71
2012-02-20 00:00:00.000,Memphis TN; U.S.A. ATP World Tour 500,HARD,2,Olivier Rochus,Ryan Harrison,Olivier Rochus,6-4; 7-5,R16,109,0,3,45,75,34,45,13,30,4,6,11,47,75,9,2,44,73,28,44,12,29,8,12,11,40,73
2012-02-20 00:00:00.000,Memphis TN; U.S.A. ATP World Tour 500,HARD,2,Milos Raonic,Sergiy Stakhovsky,Milos Raonic,6-4; 6-4,R16,73,11,2,32,57,30,32,13,25,2,2,10,43,57,3,2,41,59,26,41,11,18,4,6,10,37,59
2012-02-20 00:00:00.000,Memphis TN; U.S.A. ATP World Tour 500,HARD,2,Lukasz Kubot,Philipp Petzschner,Lukasz Kubot,7-6(5); 6-2,R16,97,6,6,38,74,27,38,20,36,0,1,10,47,74,6,4,38,68,27,38,14,30,2,5,10,41,68
2012-02-20 00:00:00.000,Memphis TN; U.S.A. ATP World Tour 500,HARD,2,Benjamin Becker,Xavier Malisse,Benjamin Becker,7-6(4); 6-4,R16,95,11,5,36,71,27,36,19,35,0,2,11,46,71,6,2,55,91,39,55,13,36,9,12,11,52,91
2012-02-20 00:00:00.000,Memphis TN; U.S.A. ATP World Tour 500,HARD,2,Jurgen Melzer,John Isner,Jurgen Melzer,6-3; 7-6(6),Q,81,7,1,41,67,33,41,17,26,2,2,10,50,67,11,2,54,70,36,54,9,16,2,4,11,45,70
2012-02-20 00:00:00.000,Memphis TN; U.S.A. ATP World Tour 500,HARD,2,Radek Stepanek,Sam Querrey,Radek Stepanek,7-6(5); 6-0,Q,80,1,3,31,53,24,31,15,22,0,1,9,39,53,8,5,32,72,21,32,16,40,1,5,9,37,72
2012-02-20 00:00:00.000,Memphis TN; U.S.A. ATP World Tour 500,HARD,2,Milos Raonic,Olivier Rochus,Milos Raonic,6-3; 7-6(3),Q,83,26,2,43,64,32,43,14,21,1,2,11,46,64,3,2,35,61,25,35,14,26,1,3,10,39,61
2012-02-20 00:00:00.000,Memphis TN; U.S.A. ATP World Tour 500,HARD,2,Benjamin Becker,Lukasz Kubot,Benjamin Becker,7-5; 7-6(5),Q,127,5,2,49,83,35,49,20,34,5,7,12,55,83,3,5,46,84,28,46,23,38,8,11,12,51,84
2012-02-20 00:00:00.000,Memphis TN; U.S.A. ATP World Tour 500,HARD,2,Jurgen Melzer,Radek Stepanek,Jurgen Melzer,6-4; 3-6; 6-3,S,122,8,3,52,83,40,52,16,31,6,8,14,56,83,8,6,59,97,43,59,18,38,7,10,14,61,97
2012-02-20 00:00:00.000,Memphis TN; U.S.A. ATP World Tour 500,HARD,2,Milos Raonic,Benjamin Becker,Milos Raonic,6-4; 6-4,S,75,14,2,31,50,29,31,11,19,0,0,10,40,50,4,4,28,54,21,28,13,26,0,2,10,34,54
2012-02-20 00:00:00.000,Memphis TN; U.S.A. ATP World Tour 500,HARD,2,Jurgen Melzer,Milos Raonic,Jurgen Melzer,7-5; 7-6(4),F,98,9,2,50,80,38,50,19,30,4,5,12,57,80,22,3,46,73,40,46,12,27,1,3,12,52,73
2012-02-27 00:00:00.000,Acapulco Mexico ATP World Tour 500,CLAY,2,David Ferrer,Santiago Gonzalez,David Ferrer,6-1; 6-2,R32,65,2,0,39,58,25,39,14,19,5,5,8,39,58,0,1,28,51,10,28,13,23,3,7,7,23,51
2012-02-27 00:00:00.000,Acapulco Mexico ATP World Tour 500,CLAY,2,Lukasz Kubot,Daniel Garza,Lukasz Kubot,6-1; 6-3,R32,70,1,3,37,59,27,37,11,22,2,3,8,38,59,3,7,22,43,13,22,5,21,3,8,8,18,43
2012-02-27 00:00:00.000,Acapulco Mexico ATP World Tour 500,CLAY,2,Pablo Andujar,Leonardo Mayer,Pablo Andujar,7-6(5); 6-3,R32,118,0,6,37,59,31,37,12,22,0,1,10,43,59,5,4,48,88,30,48,20,40,7,10,11,50,88
2012-02-27 00:00:00.000,Acapulco Mexico ATP World Tour 500,CLAY,2,Florian Mayer,Facundo Bagnis,Florian Mayer,6-2; 6-4,R32,73,7,0,35,59,27,35,15,24,5,5,9,42,59,4,1,32,50,25,32,7,18,1,4,9,32,50
2012-02-27 00:00:00.000,Acapulco Mexico ATP World Tour 500,CLAY,2,Carlos Berlocq,Gilles Simon,Carlos Berlocq,7-6(5); 6-3,R32,151,1,1,64,88,41,64,10,24,7,11,11,51,88,9,2,47,72,30,47,9,25,6,11,10,39,72
2012-02-27 00:00:00.000,Acapulco Mexico ATP World Tour 500,CLAY,2,Potito Starace,Alessandro Giannessi,Potito Starace,6-2; 7-5,R32,95,1,0,37,53,24,37,10,16,0,2,10,34,53,0,4,44,69,24,44,11,25,4,9,10,35,69
2012-02-27 00:00:00.000,Acapulco Mexico ATP World Tour 500,CLAY,2,Santiago Giraldo,David Nalbandian,Santiago Giraldo,6-2; 6-2,R32,80,7,0,41,56,30,41,7,15,3,4,8,37,56,1,0,30,62,16,30,13,32,5,10,8,29,62
2012-02-27 00:00:00.000,Acapulco Mexico ATP World Tour 500,CLAY,2,Marcel Granollers,Thomaz Bellucci,Marcel Granollers,6-4; 6-2,R32,90,3,1,33,55,23,33,13,22,0,1,9,36,55,1,0,30,50,17,30,10,20,1,5,9,27,50
2012-02-27 00:00:00.000,Acapulco Mexico ATP World Tour 500,CLAY,2,Albert Ramos-Vinolas,Juan Monaco,Albert Ramos-Vinolas,7-6(2); 5-3 RET,R32,131,1,3,45,77,27,45,16,32,8,12,10,43,77,2,6,55,83,31,55,9,28,5,10,10,40,83
2012-02-27 00:00:00.000,Acapulco Mexico ATP World Tour 500,CLAY,2,Stan Wawrinka,Juan Carlos Ferrero,Stan Wawrinka,2-6; 6-3; 6-4,R32,137,10,3,62,94,42,62,14,32,7,11,14,56,94,3,0,54,84,33,54,17,30,9,13,13,50,84
2012-02-27 00:00:00.000,Acapulco Mexico ATP World Tour 500,CLAY,2,Jeremy Chardy,Rui Machado,Jeremy Chardy,7-6(4); 6-3,R32,120,4,6,43,86,31,43,20,43,6,8,10,51,86,2,8,51,76,33,51,9,25,4,8,11,42,76
2012-02-27 00:00:00.000,Acapulco Mexico ATP World Tour 500,CLAY,2,Kei Nishikori,Albert Montanes,Kei Nishikori,6-2; 4-1 RET,R32,53,1,2,18,34,12,18,10,16,1,2,6,22,34,0,5,22,41,9,22,7,19,2,7,7,16,41
2012-02-27 00:00:00.000,Acapulco Mexico ATP World Tour 500,CLAY,2,Fernando Verdasco,Filippo Volandri,Fernando Verdasco,6-0; 6-2,R32,57,1,4,29,39,22,29,5,10,3,4,7,27,39,0,2,39,49,15,39,3,10,5,11,7,18,49
2012-02-27 00:00:00.000,Acapulco Mexico ATP World Tour 500,CLAY,2,Juan Ignacio Chela,Cesar Ramirez,Juan Ignacio Chela,6-0; 6-2,R32,70,3,0,28,38,21,28,7,10,0,0,7,28,38,1,1,36,47,20,36,0,11,1,6,7,20,47
2012-02-27 00:00:00.000,Acapulco Mexico ATP World Tour 500,CLAY,2,Benoit Paire,Juan Sebastian Cabal,Benoit Paire,7-6(3); 7-6(6),R32,98,10,8,46,89,39,46,17,43,5,9,12,56,89,1,3,51,74,29,51,12,23,1,5,12,41,74
2012-02-27 00:00:00.000,Acapulco Mexico ATP World Tour 500,CLAY,2,Nicolas Almagro,Pere Riba,Nicolas Almagro,6-2; 3-6; 6-2,R32,91,6,2,42,63,30,42,17,21,2,3,12,47,63,4,6,36,71,25,36,18,35,3,7,13,43,71
2012-02-27 00:00:00.000,Acapulco Mexico ATP World Tour 500,CLAY,2,David Ferrer,Lukasz Kubot,David Ferrer,6-3; 6-3,R16,75,2,1,34,48,28,34,9,14,0,0,9,37,48,3,6,34,58,19,34,13,24,3,6,9,32,58
2012-02-27 00:00:00.000,Acapulco Mexico ATP World Tour 500,CLAY,2,Pablo Andujar,Florian Mayer,Pablo Andujar,4-6; 7-5; 6-4,R16,174,3,4,62,97,44,62,13,35,9,15,16,57,97,3,3,53,114,35,53,26,61,8,15,16,61,114
2012-02-27 00:00:00.000,Acapulco Mexico ATP World Tour 500,CLAY,2,Carlos Berlocq,Potito Starace,Carlos Berlocq,6-1; 6-4,R16,98,1,0,34,51,23,34,14,17,1,1,9,37,51,0,0,39,63,22,39,12,24,4,7,8,34,63
2012-02-27 00:00:00.000,Acapulco Mexico ATP World Tour 500,CLAY,2,Santiago Giraldo,Marcel Granollers,Santiago Giraldo,6-4; 6-3,R16,95,4,1,42,64,27,42,13,22,6,8,10,40,64,5,2,33,54,22,33,8,21,1,5,9,30,54
2012-02-27 00:00:00.000,Acapulco Mexico ATP World Tour 500,CLAY,2,Stan Wawrinka,Albert Ramos-Vinolas,Stan Wawrinka,6-3; 3-6; 6-3,R16,130,6,4,66,111,46,66,21,45,11,13,14,67,111,1,3,42,76,32,42,15,34,0,3,13,47,76
2012-02-27 00:00:00.000,Acapulco Mexico ATP World Tour 500,CLAY,2,Jeremy Chardy,Kei Nishikori,Jeremy Chardy,1-6; 7-6(8); 6-0,R16,143,4,5,53,105,36,53,22,52,12,16,13,58,105,3,6,59,91,38,59,15,32,5,9,12,53,91
2012-02-27 00:00:00.000,Acapulco Mexico ATP World Tour 500,CLAY,2,Fernando Verdasco,Juan Ignacio Chela,Fernando Verdasco,6-4; 6-2,R16,84,3,4,38,50,31,38,7,12,1,1,9,38,50,0,2,39,63,21,39,15,24,9,12,9,36,63
2012-02-27 00:00:00.000,Acapulco Mexico ATP World Tour 500,CLAY,2,Nicolas Almagro,Benoit Paire,Nicolas Almagro,3-6; 6-3; 6-4,R16,136,7,7,50,107,36,50,29,57,5,8,14,65,107,9,8,55,123,38,55,30,68,10,14,14,68,123
2012-02-27 00:00:00.000,Acapulco Mexico ATP World Tour 500,CLAY,2,David Ferrer,Pablo Andujar,David Ferrer,6-2; 6-4,Q,75,3,0,28,46,25,28,9,18,3,4,9,34,46,3,3,33,55,19,33,9,22,2,6,9,28,55
2012-02-27 00:00:00.000,Acapulco Mexico ATP World Tour 500,CLAY,2,Santiago Giraldo,Carlos Berlocq,Santiago Giraldo,7-5; 3-6; 6-4,Q,181,1,0,70,108,43,70,18,38,5,11,16,61,108,1,2,72,94,38,72,12,22,6,12,15,50,94
2012-02-27 00:00:00.000,Acapulco Mexico ATP World Tour 500,CLAY,2,Stan Wawrinka,Jeremy Chardy,Stan Wawrinka,7-5; 6-1,Q,81,11,3,38,61,29,38,14,23,1,1,10,43,61,4,1,32,50,21,32,9,18,2,5,9,30,50
2012-02-27 00:00:00.000,Acapulco Mexico ATP World Tour 500,CLAY,2,Fernando Verdasco,Nicolas Almagro,Fernando Verdasco,6-4; 7-6(5),Q,112,5,2,57,71,43,57,8,14,6,7,11,51,71,5,3,60,84,39,60,12,24,5,7,11,51,84
2012-02-27 00:00:00.000,Acapulco Mexico ATP World Tour 500,CLAY,2,David Ferrer,Santiago Giraldo,David Ferrer,7-5; 6-4,S,111,3,4,45,80,34,45,21,35,6,6,11,55,80,1,0,52,76,33,52,14,24,5,7,11,47,76
2012-02-27 00:00:00.000,Acapulco Mexico ATP World Tour 500,CLAY,2,Fernando Verdasco,Stan Wawrinka,Fernando Verdasco,6-3; 6-3,S,85,3,2,42,53,30,42,8,11,0,0,9,38,53,5,0,35,59,23,35,9,24,4,7,9,32,59
2012-02-27 00:00:00.000,Acapulco Mexico ATP World Tour 500,CLAY,2,David Ferrer,Fernando Verdasco,David Ferrer,6-1; 6-2,F,70,2,1,25,39,22,25,10,14,0,0,8,32,39,1,4,38,50,19,38,4,12,6,10,7,23,50
2012-02-27 00:00:00.000,Delray Beach FL; U.S.A. ATP World Tour 250,HARD,2,John Isner,Jesse Levine,John Isner,6-4; 7-6(15),R32,106,13,2,58,85,46,58,16,27,1,1,11,62,85,2,6,44,83,33,44,24,39,2,3,11,57,83
2012-02-27 00:00:00.000,Delray Beach FL; U.S.A. ATP World Tour 250,HARD,2,Ryan Sweeting,Donald Young,Ryan Sweeting,6-1; 6-1,R32,53,3,5,23,39,21,23,8,16,0,0,7,29,39,1,3,22,43,13,22,4,21,4,9,7,17,43
2012-02-27 00:00:00.000,Delray Beach FL; U.S.A. ATP World Tour 250,HARD,2,Tim Smyczek,Jurgen Melzer,Tim Smyczek,6-4; 2-6; 7-5,R32,118,4,2,49,87,33,49,20,38,5,10,15,53,87,5,3,53,107,34,53,24,54,7,12,15,58,107
2012-02-27 00:00:00.000,Delray Beach FL; U.S.A. ATP World Tour 250,HARD,2,Bernard Tomic,Tommy Haas,Bernard Tomic,6-4; 6-3,R32,72,5,0,31,50,26,31,12,19,0,1,10,38,50,3,3,24,60,13,24,20,36,6,9,9,33,60
2012-02-27 00:00:00.000,Delray Beach FL; U.S.A. ATP World Tour 250,HARD,2,Andy Roddick,Philipp Petzschner,Andy Roddick,4-6; 6-4; 6-1,R32,99,9,4,44,76,35,44,18,32,5,7,14,53,76,5,7,51,83,36,51,11,32,7,11,13,47,83
2012-02-27 00:00:00.000,Delray Beach FL; U.S.A. ATP World Tour 250,HARD,2,Denis Istomin,Matthew Ebden,Denis Istomin,6-2; 6-3,R32,79,7,5,30,62,23,30,20,32,7,7,9,43,62,2,7,33,55,20,33,10,22,3,6,8,30,55
2012-02-27 00:00:00.000,Delray Beach FL; U.S.A. ATP World Tour 250,HARD,2,Xavier Malisse,Guillermo Garcia-Lopez,Xavier Malisse,7-6(3); 6-3,R32,98,6,3,36,67,28,36,19,31,4,6,11,47,67,3,7,40,75,29,40,14,35,7,10,10,43,75
2012-02-27 00:00:00.000,Delray Beach FL; U.S.A. ATP World Tour 250,HARD,2,Kevin Anderson,Austin Krajicek,Kevin Anderson,6-1; 6-4,R32,87,9,2,20,49,16,20,18,29,2,3,9,34,49,1,4,36,67,19,36,14,31,6,10,8,33,67
2012-02-27 00:00:00.000,Delray Beach FL; U.S.A. ATP World Tour 250,HARD,2,Alex Bogomolov Jr.,Michael Yani,Alex Bogomolov Jr.,6-3; 6-1,R32,69,1,1,32,50,22,32,10,18,0,2,8,32,50,0,4,27,52,13,27,8,25,3,9,8,21,52
2012-02-27 00:00:00.000,Delray Beach FL; U.S.A. ATP World Tour 250,HARD,2,Marinko Matosevic,Ivo Karlovic,Marinko Matosevic,6-3; 6-4,R32,77,4,2,48,71,34,48,15,23,4,4,10,49,71,6,1,24,47,19,24,11,23,1,3,9,30,47
2012-02-27 00:00:00.000,Delray Beach FL; U.S.A. ATP World Tour 250,HARD,2,Ernests Gulbis,Alejandro Falla,Ernests Gulbis,6-4; 6-1,R32,70,9,4,40,59,31,40,6,19,4,6,9,37,59,1,1,28,46,13,28,8,18,5,10,8,21,46
2012-02-27 00:00:00.000,Delray Beach FL; U.S.A. ATP World Tour 250,HARD,2,Steve Darcis,Viktor Troicki,Steve Darcis,6-4; 4-6; 6-4,R32,134,4,1,55,84,32,55,13,29,2,8,15,45,84,7,8,55,107,36,55,20,52,9,16,15,56,107
2012-02-27 00:00:00.000,Delray Beach FL; U.S.A. ATP World Tour 250,HARD,2,Philipp Kohlschreiber,Olivier Rochus,Philipp Kohlschreiber,6-1; 6-4,R32,77,13,3,34,59,33,34,9,25,3,3,9,42,59,1,0,28,49,18,28,10,21,3,6,8,28,49
2012-02-27 00:00:00.000,Delray Beach FL; U.S.A. ATP World Tour 250,HARD,2,Ivan Dodig,Matthias Bachinger,Ivan Dodig,4-6; 6-4; 6-4,R32,129,6,3,53,85,42,53,15,32,2,5,15,57,85,2,4,36,89,30,36,25,53,1,5,15,55,89
2012-02-27 00:00:00.000,Delray Beach FL; U.S.A. ATP World Tour 250,HARD,2,Dudi Sela,Denis Kudla,Dudi Sela,6-4; 6-3,R32,72,2,2,33,51,24,33,12,18,1,2,9,36,51,1,3,29,52,19,29,10,23,1,5,10,29,52
2012-02-27 00:00:00.000,Delray Beach FL; U.S.A. ATP World Tour 250,HARD,2,Jarkko Nieminen,Marin Cilic,Jarkko Nieminen,6-3; 3-6; 6-2,R32,101,8,6,49,85,35,49,16,36,4,7,13,51,85,9,5,38,78,25,38,19,40,4,9,13,44,78
2012-02-27 00:00:00.000,Delray Beach FL; U.S.A. ATP World Tour 250,HARD,2,John Isner,Ryan Sweeting,John Isner,6-3; 6-4,R16,68,10,1,41,62,32,41,12,21,5,5,10,44,62,6,1,20,51,14,20,21,31,2,4,9,35,51
2012-02-27 00:00:00.000,Delray Beach FL; U.S.A. ATP World Tour 250,HARD,2,Bernard Tomic,Tim Smyczek,Bernard Tomic,6-1; 7-5,R16,69,10,4,51,73,40,51,8,22,7,7,10,48,73,0,1,34,50,23,34,6,16,1,4,9,29,50
2012-02-27 00:00:00.000,Delray Beach FL; U.S.A. ATP World Tour 250,HARD,2,Andy Roddick,Denis Istomin,Andy Roddick,6-4; 7-5,R16,88,6,2,34,68,25,34,22,34,4,5,11,47,68,7,1,35,61,27,35,12,26,0,3,11,39,61
2012-02-27 00:00:00.000,Delray Beach FL; U.S.A. ATP World Tour 250,HARD,2,Kevin Anderson,Xavier Malisse,Kevin Anderson,6-3; 3-6; 6-3,R16,116,9,6,47,85,36,47,20,38,8,10,14,56,85,5,3,35,77,25,35,23,42,3,6,13,48,77
2012-02-27 00:00:00.000,Delray Beach FL; U.S.A. ATP World Tour 250,HARD,2,Marinko Matosevic,Alex Bogomolov Jr.,Marinko Matosevic,4-6; 6-1; 6-3,R16,121,11,6,42,87,32,42,22,45,3,5,13,54,87,1,6,50,77,27,50,15,27,3,8,13,42,77
2012-02-27 00:00:00.000,Delray Beach FL; U.S.A. ATP World Tour 250,HARD,2,Ernests Gulbis,Steve Darcis,Ernests Gulbis,6-7(6); 6-1; 6-3,R16,131,10,5,45,80,40,45,18,35,1,2,14,58,80,1,1,59,90,34,59,17,31,4,9,14,51,90
2012-02-27 00:00:00.000,Delray Beach FL; U.S.A. ATP World Tour 250,HARD,2,Philipp Kohlschreiber,Ivan Dodig,Philipp Kohlschreiber,6-2; 6-2,R16,78,6,1,31,48,23,31,11,17,2,2,8,34,48,4,5,37,60,23,37,6,23,6,10,8,29,60
2012-02-27 00:00:00.000,Delray Beach FL; U.S.A. ATP World Tour 250,HARD,2,Dudi Sela,Jarkko Nieminen,Dudi Sela,6-4; 6-4,R16,86,3,3,30,52,25,30,15,22,3,4,10,40,52,0,4,50,82,34,50,12,32,11,14,10,46,82
2012-02-27 00:00:00.000,Delray Beach FL; U.S.A. ATP World Tour 250,HARD,2,John Isner,Bernard Tomic,John Isner,6-3; 6-2,Q,56,9,3,26,51,18,26,19,25,1,2,9,37,51,4,1,28,46,17,28,8,18,1,5,8,25,46
2012-02-27 00:00:00.000,Delray Beach FL; U.S.A. ATP World Tour 250,HARD,2,Kevin Anderson,Andy Roddick,Kevin Anderson,2-6; 7-6(9); 6-4,Q,153,11,5,44,93,34,44,29,49,2,5,15,63,93,8,4,72,110,51,72,19,38,7,9,15,70,110
2012-02-27 00:00:00.000,Delray Beach FL; U.S.A. ATP World Tour 250,HARD,2,Marinko Matosevic,Ernests Gulbis,Marinko Matosevic,3-6; 6-1; 6-1,Q,92,4,3,38,55,33,38,9,17,0,1,11,42,55,6,8,44,76,29,44,13,32,5,10,12,42,76
2012-02-27 00:00:00.000,Delray Beach FL; U.S.A. ATP World Tour 250,HARD,2,Dudi Sela,Philipp Kohlschreiber,Dudi Sela,6-4; 6-7(4); 6-0,Q,122,3,1,60,91,42,60,19,31,3,5,14,61,91,5,3,56,93,33,56,19,37,8,14,14,52,93
2012-02-27 00:00:00.000,Delray Beach FL; U.S.A. ATP World Tour 250,HARD,2,Kevin Anderson,John Isner,Kevin Anderson,7-5; 7-6(4),S,96,16,0,45,69,39,45,16,24,1,1,12,55,69,16,3,47,68,41,47,9,21,2,3,12,50,68
2012-02-27 00:00:00.000,Delray Beach FL; U.S.A. ATP World Tour 250,HARD,2,Marinko Matosevic,Dudi Sela,Marinko Matosevic,5-7; 6-4; 7-6(7),S,174,7,12,68,136,48,68,31,68,13,17,17,79,136,3,3,76,107,49,76,16,31,5,9,17,65,107
2012-02-27 00:00:00.000,Delray Beach FL; U.S.A. ATP World Tour 250,HARD,2,Kevin Anderson,Marinko Matosevic,Kevin Anderson,6-4; 7-6(2),F,118,8,3,39,68,27,39,17,29,0,2,11,44,68,2,5,55,96,31,55,20,41,12,15,11,51,96
2012-02-27 00:00:00.000,Dubai U.A.E. ATP World Tour 500,HARD,2,Novak Djokovic,Cedrik-Marcel Stebe,Novak Djokovic,6-4; 6-2,R32,89,3,2,38,58,29,38,12,20,3,3,9,41,58,1,3,33,62,22,33,13,29,6,9,9,35,62
2012-02-27 00:00:00.000,Dubai U.A.E. ATP World Tour 500,HARD,2,Sergiy Stakhovsky,Omar Alawadhi,Sergiy Stakhovsky,6-1; 6-2,R32,37,2,0,19,33,16,19,12,14,0,0,7,28,33,0,1,31,46,16,31,3,15,3,8,8,19,46
2012-02-27 00:00:00.000,Dubai U.A.E. ATP World Tour 500,HARD,2,Flavio Cipolla,Ivan Ljubicic,Flavio Cipolla,6-2; 7-5,R32,93,1,1,52,65,36,52,7,13,3,4,10,43,65,9,3,26,62,20,26,14,36,2,6,10,34,62
2012-02-27 00:00:00.000,Dubai U.A.E. ATP World Tour 500,HARD,2,Janko Tipsarevic,Igor Kunitsyn,Janko Tipsarevic,6-2; 6-2,R32,67,4,1,20,42,19,20,15,22,2,2,8,34,42,2,1,33,58,19,33,11,25,6,10,8,30,58
2012-02-27 00:00:00.000,Dubai U.A.E. ATP World Tour 500,HARD,2,Andy Murray,Michael Berrer,Andy Murray,6-3; 4-6; 6-4,R32,126,7,3,60,91,38,60,16,31,8,13,15,54,91,5,1,62,86,39,62,8,24,6,12,14,47,86
2012-02-27 00:00:00.000,Dubai U.A.E. ATP World Tour 500,HARD,2,Marco Chiudinelli,Nikolay Davydenko,Marco Chiudinelli,6-4; 5-7; 6-4,R32,152,1,6,60,106,41,60,25,46,6,9,16,66,106,0,1,71,98,46,71,13,27,5,9,16,59,98
2012-02-27 00:00:00.000,Dubai U.A.E. ATP World Tour 500,HARD,2,Lukas Lacko,Sergei Bubka,Lukas Lacko,2-6; 6-2; 7-6(14),R32,124,11,2,67,106,53,67,17,39,5,8,14,70,106,15,1,50,93,41,50,20,43,3,6,14,61,93
2012-02-27 00:00:00.000,Dubai U.A.E. ATP World Tour 500,HARD,2,Tomas Berdych,Benjamin Becker,Tomas Berdych,6-2; 6-2,R32,63,9,2,29,50,25,29,10,21,1,1,8,35,50,3,3,24,48,12,24,11,24,1,5,8,23,48
2012-02-27 00:00:00.000,Dubai U.A.E. ATP World Tour 500,HARD,2,Juan Martin Del Potro,Alexandr Dolgopolov,Juan Martin Del Potro,6-3; 7-6(5),R32,94,5,0,43,62,30,43,13,19,2,4,11,43,62,8,3,41,82,30,41,16,41,4,7,10,46,82
2012-02-27 00:00:00.000,Dubai U.A.E. ATP World Tour 500,HARD,2,Andrey Golubev,Marko Djokovic,Andrey Golubev,6-3; 6-2,R32,71,4,4,26,48,22,26,13,22,1,2,9,35,48,0,7,25,61,13,25,17,36,4,8,8,30,61
2012-02-27 00:00:00.000,Dubai U.A.E. ATP World Tour 500,HARD,2,Lukas Rosol,Adrian Mannarino,Lukas Rosol,6-2; 6-2,R32,48,5,3,16,37,16,16,16,21,0,0,8,32,37,7,6,28,57,19,28,8,29,5,9,8,27,57
2012-02-27 00:00:00.000,Dubai U.A.E. ATP World Tour 500,HARD,2,Jo-Wilfried Tsonga,Marcos Baghdatis,Jo-Wilfried Tsonga,7-6(2); 6-4,R32,97,9,1,52,73,38,52,13,21,6,7,11,51,73,2,1,36,66,28,36,14,30,0,2,11,42,66
2012-02-27 00:00:00.000,Dubai U.A.E. ATP World Tour 500,HARD,2,Mardy Fish,Andreas Beck,Mardy Fish,6-1; 6-1,R32,58,6,1,18,46,16,18,16,28,1,1,7,32,46,0,0,22,36,7,22,4,14,0,5,7,11,36
2012-02-27 00:00:00.000,Dubai U.A.E. ATP World Tour 500,HARD,2,Mikhail Youzhny,Richard Gasquet,Mikhail Youzhny,6-3 RET,R32,31,8,2,15,27,14,15,8,12,1,1,5,22,27,0,1,19,22,12,19,2,3,1,2,4,14,22
2012-02-27 00:00:00.000,Dubai U.A.E. ATP World Tour 500,HARD,2,Feliciano Lopez,Nicolas Mahut,Feliciano Lopez,6-4; 6-4,R32,68,9,2,29,55,27,29,15,26,2,2,10,42,55,6,3,27,47,23,27,11,20,0,2,10,34,47
2012-02-27 00:00:00.000,Dubai U.A.E. ATP World Tour 500,HARD,2,Roger Federer,Michael Llodra,Roger Federer,6-0; 7-6(6),R32,67,7,1,26,57,21,26,22,31,2,2,9,43,57,4,5,25,56,17,25,15,31,2,5,9,32,56
2012-02-27 00:00:00.000,Dubai U.A.E. ATP World Tour 500,HARD,2,Novak Djokovic,Sergiy Stakhovsky,Novak Djokovic,7-6(5); 6-3,R16,89,8,4,45,65,36,45,9,20,1,2,11,45,65,9,4,39,72,28,39,15,33,2,4,10,43,72
2012-02-27 00:00:00.000,Dubai U.A.E. ATP World Tour 500,HARD,2,Janko Tipsarevic,Flavio Cipolla,Janko Tipsarevic,6-7(2); 6-1; 6-1,R16,135,9,5,37,76,29,37,22,39,3,5,13,51,76,1,4,69,102,37,69,15,33,10,17,13,52,102
2012-02-27 00:00:00.000,Dubai U.A.E. ATP World Tour 500,HARD,2,Andy Murray,Marco Chiudinelli,Andy Murray,6-3; 6-4,R16,83,6,0,34,53,25,34,16,19,0,0,10,41,53,1,3,38,60,24,38,11,22,4,6,9,35,60
2012-02-27 00:00:00.000,Dubai U.A.E. ATP World Tour 500,HARD,2,Tomas Berdych,Lukas Lacko,Tomas Berdych,6-1; 6-2,R16,70,8,2,33,54,23,33,12,21,11,12,8,35,54,2,2,24,48,14,24,8,24,5,10,7,22,48
2012-02-27 00:00:00.000,Dubai U.A.E. ATP World Tour 500,HARD,2,Juan Martin Del Potro,Andrey Golubev,Juan Martin Del Potro,6-4; 6-2,R16,75,8,1,34,63,26,34,16,29,3,3,9,42,63,4,1,28,46,20,28,8,18,1,4,9,28,46
2012-02-27 00:00:00.000,Dubai U.A.E. ATP World Tour 500,HARD,2,Jo-Wilfried Tsonga,Lukas Rosol,Jo-Wilfried Tsonga,6-3; 6-4,R16,68,10,2,38,59,32,38,8,21,1,2,10,40,59,7,3,33,55,23,33,8,22,4,7,9,31,55
2012-02-27 00:00:00.000,Dubai U.A.E. ATP World Tour 500,HARD,2,Mikhail Youzhny,Mardy Fish,Mikhail Youzhny,6-2; 7-6(0),R16,108,1,5,39,74,30,39,20,35,2,2,10,50,74,4,3,35,70,27,35,13,35,4,6,10,40,70
2012-02-27 00:00:00.000,Dubai U.A.E. ATP World Tour 500,HARD,2,Roger Federer,Feliciano Lopez,Roger Federer,7-5; 6-3,R16,76,12,1,37,53,34,37,10,16,0,0,11,44,53,8,3,33,66,26,33,17,33,3,5,10,43,66
2012-02-27 00:00:00.000,Dubai U.A.E. ATP World Tour 500,HARD,2,Novak Djokovic,Janko Tipsarevic,Novak Djokovic,6-1; 7-6(6),Q,97,7,1,40,60,30,40,15,20,0,0,10,45,60,10,5,34,65,22,34,16,31,3,5,9,38,65
2012-02-27 00:00:00.000,Dubai U.A.E. ATP World Tour 500,HARD,2,Andy Murray,Tomas Berdych,Andy Murray,6-3; 7-5,Q,111,7,5,52,81,36,52,14,29,6,8,11,50,81,3,3,32,63,20,32,15,31,5,9,10,35,63
2012-02-27 00:00:00.000,Dubai U.A.E. ATP World Tour 500,HARD,2,Juan Martin Del Potro,Jo-Wilfried Tsonga,Juan Martin Del Potro,7-6(1); 6-2,Q,92,4,2,43,60,35,43,11,17,0,0,10,46,60,11,2,38,65,29,38,9,27,2,4,10,38,65
2012-02-27 00:00:00.000,Dubai U.A.E. ATP World Tour 500,HARD,2,Roger Federer,Mikhail Youzhny,Roger Federer,6-3; 6-4,Q,70,5,0,29,54,20,29,20,25,0,0,10,40,54,6,2,39,66,22,39,17,27,9,11,9,39,66
2012-02-27 00:00:00.000,Dubai U.A.E. ATP World Tour 500,HARD,2,Andy Murray,Novak Djokovic,Andy Murray,6-2; 7-5,S,83,5,3,40,56,34,40,4,16,2,3,10,38,56,2,0,34,50,23,34,6,16,1,5,10,29,50
2012-02-27 00:00:00.000,Dubai U.A.E. ATP World Tour 500,HARD,2,Roger Federer,Juan Martin Del Potro,Roger Federer,7-6(5); 7-6(6),S,120,11,4,45,74,40,45,18,29,0,0,12,58,74,11,2,53,89,36,53,26,36,6,6,12,62,89
2012-02-27 00:00:00.000,Dubai U.A.E. ATP World Tour 500,HARD,2,Roger Federer,Andy Murray,Roger Federer,7-5; 6-4,F,97,4,2,32,64,24,32,21,32,2,3,11,45,64,7,3,32,66,21,32,19,34,6,9,11,40,66
2012-03-08 00:00:00.000,ATP World Tour Masters 1000 Indian Wells CA; U.S.A. ATP World Tour Masters 1000,HARD,2,Novak Djokovic,N/A Bye,Novak Djokovic,,R128,0,0,0,0,0,0,0,0,0,0,0,0,0,0,0,0,0,0,0,0,0,0,0,0,0,0,0
2012-03-08 00:00:00.000,ATP World Tour Masters 1000 Indian Wells CA; U.S.A. ATP World Tour Masters 1000,HARD,2,Andrey Golubev,Rik De Voest,Andrey Golubev,6-1; 6-4,R128,70,2,1,38,53,29,38,9,15,2,2,9,38,53,1,0,38,55,27,38,5,17,3,6,8,32,55
2012-03-08 00:00:00.000,ATP World Tour Masters 1000 Indian Wells CA; U.S.A. ATP World Tour Masters 1000,HARD,2,Philipp Kohlschreiber,Matthias Bachinger,Philipp Kohlschreiber,6-4; 6-2,R128,76,2,1,36,61,29,36,12,25,3,3,9,41,61,8,1,26,47,19,26,9,21,2,5,9,28,47
2012-03-08 00:00:00.000,ATP World Tour Masters 1000 Indian Wells CA; U.S.A. ATP World Tour Masters 1000,HARD,2,Kevin Anderson,N/A Bye,Kevin Anderson,,R128,0,0,0,0,0,0,0,0,0,0,0,0,0,0,0,0,0,0,0,0,0,0,0,0,0,0,0
2012-03-08 00:00:00.000,ATP World Tour Masters 1000 Indian Wells CA; U.S.A. ATP World Tour Masters 1000,HARD,2,Florian Mayer,N/A Bye,Florian Mayer,,R128,0,0,0,0,0,0,0,0,0,0,0,0,0,0,0,0,0,0,0,0,0,0,0,0,0,0,0
2012-03-08 00:00:00.000,ATP World Tour Masters 1000 Indian Wells CA; U.S.A. ATP World Tour Masters 1000,HARD,2,Pablo Andujar,Robin Haase,Pablo Andujar,6-2; 3-6; 7-6(2),R128,137,3,5,50,88,35,50,16,38,5,10,14,51,88,3,3,59,103,41,59,12,44,6,12,15,53,103
2012-03-08 00:00:00.000,ATP World Tour Masters 1000 Indian Wells CA; U.S.A. ATP World Tour Masters 1000,HARD,2,Albert Ramos-Vinolas,Jesse Levine,Albert Ramos-Vinolas,6-7(10); 7-6(4); 6-2,R128,171,6,8,76,117,54,76,18,41,7,10,16,72,117,8,7,71,121,49,71,20,50,7,12,16,69,121
2012-03-08 00:00:00.000,ATP World Tour Masters 1000 Indian Wells CA; U.S.A. ATP World Tour Masters 1000,HARD,2,Richard Gasquet,N/A Bye,Richard Gasquet,,R128,0,0,0,0,0,0,0,0,0,0,0,0,0,0,0,0,0,0,0,0,0,0,0,0,0,0,0
2012-03-08 00:00:00.000,ATP World Tour Masters 1000 Indian Wells CA; U.S.A. ATP World Tour Masters 1000,HARD,2,Nicolas Almagro,N/A Bye,Nicolas Almagro,,R128,0,0,0,0,0,0,0,0,0,0,0,0,0,0,0,0,0,0,0,0,0,0,0,0,0,0,0
2012-03-08 00:00:00.000,ATP World Tour Masters 1000 Indian Wells CA; U.S.A. ATP World Tour Masters 1000,HARD,2,Sam Querrey,Tim Smyczek,Sam Querrey,7-6(1); 6-4,R128,90,8,2,42,71,31,42,14,29,1,3,11,45,71,1,4,34,69,21,34,20,35,6,9,11,41,69
2012-03-08 00:00:00.000,ATP World Tour Masters 1000 Indian Wells CA; U.S.A. ATP World Tour Masters 1000,HARD,2,Santiago Giraldo,Jack Sock,Santiago Giraldo,5-7; 6-0; 6-1,R128,105,0,4,50,84,37,50,18,34,3,4,13,55,84,8,5,40,72,24,40,15,32,5,10,12,39,72
2012-03-08 00:00:00.000,ATP World Tour Masters 1000 Indian Wells CA; U.S.A. ATP World Tour Masters 1000,HARD,2,Kei Nishikori,N/A Bye,Kei Nishikori,,R128,0,0,0,0,0,0,0,0,0,0,0,0,0,0,0,0,0,0,0,0,0,0,0,0,0,0,0
2012-03-08 00:00:00.000,ATP World Tour Masters 1000 Indian Wells CA; U.S.A. ATP World Tour Masters 1000,HARD,2,Andy Roddick,N/A Bye,Andy Roddick,,R128,0,0,0,0,0,0,0,0,0,0,0,0,0,0,0,0,0,0,0,0,0,0,0,0,0,0,0
2012-03-08 00:00:00.000,ATP World Tour Masters 1000 Indian Wells CA; U.S.A. ATP World Tour Masters 1000,HARD,2,Lukasz Kubot,Ivo Karlovic,Lukasz Kubot,6-4; 6-2,R128,91,3,2,31,53,25,31,13,22,4,4,9,38,53,9,3,34,52,21,34,9,18,4,7,9,30,52
2012-03-08 00:00:00.000,ATP World Tour Masters 1000 Indian Wells CA; U.S.A. ATP World Tour Masters 1000,HARD,2,Sergiy Stakhovsky,Alex Bogomolov Jr.,Sergiy Stakhovsky,7-6(7); 4-6; 7-6(3),R128,171,15,8,66,128,50,66,31,62,10,13,17,81,128,0,5,92,128,65,92,14,36,10,12,17,79,128
2012-03-08 00:00:00.000,ATP World Tour Masters 1000 Indian Wells CA; U.S.A. ATP World Tour Masters 1000,HARD,2,Tomas Berdych,N/A Bye,Tomas Berdych,,R128,0,0,0,0,0,0,0,0,0,0,0,0,0,0,0,0,0,0,0,0,0,0,0,0,0,0,0
2012-03-08 00:00:00.000,ATP World Tour Masters 1000 Indian Wells CA; U.S.A. ATP World Tour Masters 1000,HARD,2,Andy Murray,N/A Bye,Andy Murray,,R128,0,0,0,0,0,0,0,0,0,0,0,0,0,0,0,0,0,0,0,0,0,0,0,0,0,0,0
2012-03-08 00:00:00.000,ATP World Tour Masters 1000 Indian Wells CA; U.S.A. ATP World Tour Masters 1000,HARD,2,Guillermo Garcia-Lopez,Rui Machado,Guillermo Garcia-Lopez,7-6(6); 4-6; 6-2,R128,156,5,4,52,97,35,52,23,45,1,5,15,58,97,1,6,78,109,47,78,14,31,5,10,15,61,109
2012-03-08 00:00:00.000,ATP World Tour Masters 1000 Indian Wells CA; U.S.A. ATP World Tour Masters 1000,HARD,2,Ryan Harrison,Flavio Cipolla,Ryan Harrison,6-1; 6-2,R128,58,5,0,22,38,20,22,13,16,0,0,8,33,38,0,1,31,47,16,31,7,16,2,6,7,23,47
2012-03-08 00:00:00.000,ATP World Tour Masters 1000 Indian Wells CA; U.S.A. ATP World Tour Masters 1000,HARD,2,Viktor Troicki,N/A Bye,Viktor Troicki,,R128,0,0,0,0,0,0,0,0,0,0,0,0,0,0,0,0,0,0,0,0,0,0,0,0,0,0,0
2012-03-08 00:00:00.000,ATP World Tour Masters 1000 Indian Wells CA; U.S.A. ATP World Tour Masters 1000,HARD,2,Stan Wawrinka,N/A Bye,Stan Wawrinka,,R128,0,0,0,0,0,0,0,0,0,0,0,0,0,0,0,0,0,0,0,0,0,0,0,0,0,0,0
2012-03-08 00:00:00.000,ATP World Tour Masters 1000 Indian Wells CA; U.S.A. ATP World Tour Masters 1000,HARD,2,Robby Ginepri,Paolo Lorenzi,Robby Ginepri,1-6; 6-3; 6-4,R128,129,2,3,41,80,28,41,18,39,4,8,13,46,80,2,2,64,102,38,64,18,38,12,16,13,56,102
2012-03-08 00:00:00.000,ATP World Tour Masters 1000 Indian Wells CA; U.S.A. ATP World Tour Masters 1000,HARD,2,Dudi Sela,Amer Delic,Dudi Sela,2-6; 6-0; 6-2,R128,112,2,2,35,62,24,35,15,27,1,4,11,39,62,10,4,60,93,38,60,9,33,12,18,11,47,93
2012-03-08 00:00:00.000,ATP World Tour Masters 1000 Indian Wells CA; U.S.A. ATP World Tour Masters 1000,HARD,2,Gilles Simon,N/A Bye,Gilles Simon,,R128,0,0,0,0,0,0,0,0,0,0,0,0,0,0,0,0,0,0,0,0,0,0,0,0,0,0,0
2012-03-08 00:00:00.000,ATP World Tour Masters 1000 Indian Wells CA; U.S.A. ATP World Tour Masters 1000,HARD,2,John Isner,N/A Bye,John Isner,,R128,0,0,0,0,0,0,0,0,0,0,0,0,0,0,0,0,0,0,0,0,0,0,0,0,0,0,0
2012-03-08 00:00:00.000,ATP World Tour Masters 1000 Indian Wells CA; U.S.A. ATP World Tour Masters 1000,HARD,2,Frederico Gil,Rhyne Williams,Frederico Gil,6-3; 6-7(6); 6-4,R128,146,5,0,72,110,54,72,19,38,5,6,16,73,110,8,2,56,98,43,56,21,42,4,7,15,64,98
2012-03-08 00:00:00.000,ATP World Tour Masters 1000 Indian Wells CA; U.S.A. ATP World Tour Masters 1000,HARD,2,Nicolas Mahut,Vasek Pospisil,Nicolas Mahut,6-3; 6-2,R128,88,1,0,35,57,26,35,15,22,0,0,9,41,57,2,3,41,68,25,41,13,27,6,9,8,38,68
2012-03-08 00:00:00.000,ATP World Tour Masters 1000 Indian Wells CA; U.S.A. ATP World Tour Masters 1000,HARD,2,Juan Monaco,N/A Bye,Juan Monaco,,R128,0,0,0,0,0,0,0,0,0,0,0,0,0,0,0,0,0,0,0,0,0,0,0,0,0,0,0
2012-03-08 00:00:00.000,ATP World Tour Masters 1000 Indian Wells CA; U.S.A. ATP World Tour Masters 1000,HARD,2,Julien Benneteau,N/A Bye,Julien Benneteau,,R128,0,0,0,0,0,0,0,0,0,0,0,0,0,0,0,0,0,0,0,0,0,0,0,0,0,0,0
2012-03-08 00:00:00.000,ATP World Tour Masters 1000 Indian Wells CA; U.S.A. ATP World Tour Masters 1000,HARD,2,Matthew Ebden,Igor Kunitsyn,Matthew Ebden,6-1; 4-6; 6-4,R128,154,3,3,66,110,44,66,20,44,13,16,14,64,110,2,2,58,94,35,58,15,36,8,13,13,50,94
2012-03-08 00:00:00.000,ATP World Tour Masters 1000 Indian Wells CA; U.S.A. ATP World Tour Masters 1000,HARD,2,Andreas Seppi,Olivier Rochus,Andreas Seppi,4-6; 6-3; 6-4,R128,126,17,2,50,91,43,50,18,41,3,5,15,61,91,0,3,44,83,35,44,18,39,4,7,14,53,83
2012-03-08 00:00:00.000,ATP World Tour Masters 1000 Indian Wells CA; U.S.A. ATP World Tour Masters 1000,HARD,2,Mardy Fish,N/A Bye,Mardy Fish,,R128,0,0,0,0,0,0,0,0,0,0,0,0,0,0,0,0,0,0,0,0,0,0,0,0,0,0,0
2012-03-08 00:00:00.000,ATP World Tour Masters 1000 Indian Wells CA; U.S.A. ATP World Tour Masters 1000,HARD,2,David Ferrer,N/A Bye,David Ferrer,,R128,0,0,0,0,0,0,0,0,0,0,0,0,0,0,0,0,0,0,0,0,0,0,0,0,0,0,0
2012-03-08 00:00:00.000,ATP World Tour Masters 1000 Indian Wells CA; U.S.A. ATP World Tour Masters 1000,HARD,2,Grigor Dimitrov,Ivan Dodig,Grigor Dimitrov,6-1; 6-4,R128,86,4,0,49,68,31,49,13,19,4,4,9,44,68,2,4,27,60,17,27,15,33,12,15,8,32,60
2012-03-08 00:00:00.000,ATP World Tour Masters 1000 Indian Wells CA; U.S.A. ATP World Tour Masters 1000,HARD,2,Denis Istomin,Yen-Hsun Lu,Denis Istomin,7-6(6); 6-3,R128,89,6,1,37,56,32,37,14,19,0,0,10,46,56,1,3,37,70,28,37,18,33,2,4,11,46,70
2012-03-08 00:00:00.000,ATP World Tour Masters 1000 Indian Wells CA; U.S.A. ATP World Tour Masters 1000,HARD,2,Juan Ignacio Chela,N/A Bye,Juan Ignacio Chela,,R128,0,0,0,0,0,0,0,0,0,0,0,0,0,0,0,0,0,0,0,0,0,0,0,0,0,0,0
2012-03-08 00:00:00.000,ATP World Tour Masters 1000 Indian Wells CA; U.S.A. ATP World Tour Masters 1000,HARD,2,Fernando Verdasco,N/A Bye,Fernando Verdasco,,R128,0,0,0,0,0,0,0,0,0,0,0,0,0,0,0,0,0,0,0,0,0,0,0,0,0,0,0
2012-03-08 00:00:00.000,ATP World Tour Masters 1000 Indian Wells CA; U.S.A. ATP World Tour Masters 1000,HARD,2,Ryan Sweeting,Cedrik-Marcel Stebe,Ryan Sweeting,6-2; 6-2,R128,71,2,3,25,45,20,25,13,20,0,0,8,33,45,4,2,37,60,22,37,9,23,8,12,8,31,60
2012-03-08 00:00:00.000,ATP World Tour Masters 1000 Indian Wells CA; U.S.A. ATP World Tour Masters 1000,HARD,2,Marinko Matosevic,Ruben Bemelmans,Marinko Matosevic,6-2; 6-3,R128,69,5,2,34,58,23,34,11,24,3,5,9,34,58,3,4,32,49,16,32,6,17,1,6,8,22,49
2012-03-08 00:00:00.000,ATP World Tour Masters 1000 Indian Wells CA; U.S.A. ATP World Tour Masters 1000,HARD,2,Juan Martin Del Potro,N/A Bye,Juan Martin Del Potro,,R128,0,0,0,0,0,0,0,0,0,0,0,0,0,0,0,0,0,0,0,0,0,0,0,0,0,0,0
2012-03-08 00:00:00.000,ATP World Tour Masters 1000 Indian Wells CA; U.S.A. ATP World Tour Masters 1000,HARD,2,Bjorn Phau,N/A Bye,Bjorn Phau,,R128,0,0,0,0,0,0,0,0,0,0,0,0,0,0,0,0,0,0,0,0,0,0,0,0,0,0,0
2012-03-08 00:00:00.000,ATP World Tour Masters 1000 Indian Wells CA; U.S.A. ATP World Tour Masters 1000,HARD,2,Nikolay Davydenko,Sergei Bubka,Nikolay Davydenko,7-5; 6-3,R128,93,2,2,55,70,34,55,9,15,5,7,10,43,70,6,1,44,70,29,44,10,26,2,7,11,39,70
2012-03-08 00:00:00.000,ATP World Tour Masters 1000 Indian Wells CA; U.S.A. ATP World Tour Masters 1000,HARD,2,Thomaz Bellucci,Lukas Rosol,Thomaz Bellucci,6-2; 7-6(4),R128,80,10,2,31,61,24,31,19,30,0,1,10,43,61,5,3,40,73,29,40,12,33,6,9,10,41,73
2012-03-08 00:00:00.000,ATP World Tour Masters 1000 Indian Wells CA; U.S.A. ATP World Tour Masters 1000,HARD,2,Jurgen Melzer,N/A Bye,Jurgen Melzer,,R128,0,0,0,0,0,0,0,0,0,0,0,0,0,0,0,0,0,0,0,0,0,0,0,0,0,0,0
2012-03-08 00:00:00.000,ATP World Tour Masters 1000 Indian Wells CA; U.S.A. ATP World Tour Masters 1000,HARD,2,Milos Raonic,N/A Bye,Milos Raonic,,R128,0,0,0,0,0,0,0,0,0,0,0,0,0,0,0,0,0,0,0,0,0,0,0,0,0,0,0
2012-03-08 00:00:00.000,ATP World Tour Masters 1000 Indian Wells CA; U.S.A. ATP World Tour Masters 1000,HARD,2,Carlos Berlocq,Benoit Paire,Carlos Berlocq,6-4; 6-2,R128,99,0,1,60,75,41,60,7,15,8,8,9,48,75,2,5,33,66,19,33,18,33,4,7,9,37,66
2012-03-08 00:00:00.000,ATP World Tour Masters 1000 Indian Wells CA; U.S.A. ATP World Tour Masters 1000,HARD,2,Denis Kudla,Tobias Kamke,Denis Kudla,2-6; 7-6(3); 6-4,R128,152,2,3,54,110,28,54,31,56,10,17,15,59,110,4,7,59,109,34,59,25,50,8,14,15,59,109
2012-03-08 00:00:00.000,ATP World Tour Masters 1000 Indian Wells CA; U.S.A. ATP World Tour Masters 1000,HARD,2,Roger Federer,N/A Bye,Roger Federer,,R128,0,0,0,0,0,0,0,0,0,0,0,0,0,0,0,0,0,0,0,0,0,0,0,0,0,0,0
2012-03-08 00:00:00.000,ATP World Tour Masters 1000 Indian Wells CA; U.S.A. ATP World Tour Masters 1000,HARD,2,Jo-Wilfried Tsonga,N/A Bye,Jo-Wilfried Tsonga,,R128,0,0,0,0,0,0,0,0,0,0,0,0,0,0,0,0,0,0,0,0,0,0,0,0,0,0,0
2012-03-08 00:00:00.000,ATP World Tour Masters 1000 Indian Wells CA; U.S.A. ATP World Tour Masters 1000,HARD,2,Michael Llodra,Ernests Gulbis,Michael Llodra,6-3; 5-7; 7-6(3),R128,123,4,3,51,98,39,51,28,47,1,3,17,67,98,6,5,59,91,49,59,14,32,1,3,16,63,91
2012-03-08 00:00:00.000,ATP World Tour Masters 1000 Indian Wells CA; U.S.A. ATP World Tour Masters 1000,HARD,2,Xavier Malisse,Bobby Reynolds,Xavier Malisse,6-2; 6-4,R128,73,10,2,36,54,29,36,11,18,6,6,9,40,54,5,1,31,50,19,31,11,19,1,4,9,30,50
2012-03-08 00:00:00.000,ATP World Tour Masters 1000 Indian Wells CA; U.S.A. ATP World Tour Masters 1000,HARD,2,Radek Stepanek,N/A Bye,Radek Stepanek,,R128,0,0,0,0,0,0,0,0,0,0,0,0,0,0,0,0,0,0,0,0,0,0,0,0,0,0,0
2012-03-08 00:00:00.000,ATP World Tour Masters 1000 Indian Wells CA; U.S.A. ATP World Tour Masters 1000,HARD,2,Marin Cilic,N/A Bye,Marin Cilic,,R128,0,0,0,0,0,0,0,0,0,0,0,0,0,0,0,0,0,0,0,0,0,0,0,0,0,0,0
2012-03-08 00:00:00.000,ATP World Tour Masters 1000 Indian Wells CA; U.S.A. ATP World Tour Masters 1000,HARD,2,David Nalbandian,Potito Starace,David Nalbandian,7-6(4); 6-0,R128,85,6,2,35,57,26,35,14,22,3,4,9,40,57,4,4,47,72,27,47,8,25,8,12,9,35,72
2012-03-08 00:00:00.000,ATP World Tour Masters 1000 Indian Wells CA; U.S.A. ATP World Tour Masters 1000,HARD,2,Gilles Muller,Bernard Tomic,Gilles Muller,4-6; 7-6(4); 6-0,R128,101,23,3,52,74,46,52,12,22,1,2,14,58,74,8,3,68,97,49,68,12,29,8,11,14,61,97
2012-03-08 00:00:00.000,ATP World Tour Masters 1000 Indian Wells CA; U.S.A. ATP World Tour Masters 1000,HARD,2,Janko Tipsarevic,N/A Bye,Janko Tipsarevic,,R128,0,0,0,0,0,0,0,0,0,0,0,0,0,0,0,0,0,0,0,0,0,0,0,0,0,0,0
2012-03-08 00:00:00.000,ATP World Tour Masters 1000 Indian Wells CA; U.S.A. ATP World Tour Masters 1000,HARD,2,Feliciano Lopez,N/A Bye,Feliciano Lopez,,R128,0,0,0,0,0,0,0,0,0,0,0,0,0,0,0,0,0,0,0,0,0,0,0,0,0,0,0
2012-03-08 00:00:00.000,ATP World Tour Masters 1000 Indian Wells CA; U.S.A. ATP World Tour Masters 1000,HARD,2,Marcos Baghdatis,Jeremy Chardy,Marcos Baghdatis,6-3; 6-4,R128,81,4,1,34,62,25,34,18,28,2,2,10,43,62,2,5,32,59,22,32,13,27,6,8,9,35,59
2012-03-08 00:00:00.000,ATP World Tour Masters 1000 Indian Wells CA; U.S.A. ATP World Tour Masters 1000,HARD,2,Steve Darcis,Donald Young,Steve Darcis,6-2; 3-6; 7-6(5),R128,142,0,1,66,105,37,66,25,39,6,10,14,62,105,2,5,60,100,35,60,22,40,7,12,15,57,100
2012-03-08 00:00:00.000,ATP World Tour Masters 1000 Indian Wells CA; U.S.A. ATP World Tour Masters 1000,HARD,2,Alexandr Dolgopolov,N/A Bye,Alexandr Dolgopolov,,R128,0,0,0,0,0,0,0,0,0,0,0,0,0,0,0,0,0,0,0,0,0,0,0,0,0,0,0
2012-03-08 00:00:00.000,ATP World Tour Masters 1000 Indian Wells CA; U.S.A. ATP World Tour Masters 1000,HARD,2,Marcel Granollers,N/A Bye,Marcel Granollers,,R128,0,0,0,0,0,0,0,0,0,0,0,0,0,0,0,0,0,0,0,0,0,0,0,0,0,0,0
2012-03-08 00:00:00.000,ATP World Tour Masters 1000 Indian Wells CA; U.S.A. ATP World Tour Masters 1000,HARD,2,Tommy Haas,Jarkko Nieminen,Tommy Haas,7-6(9); 6-4,R128,108,4,3,38,69,27,38,16,31,4,8,11,43,69,1,2,62,93,38,62,11,31,7,12,11,49,93
2012-03-08 00:00:00.000,ATP World Tour Masters 1000 Indian Wells CA; U.S.A. ATP World Tour Masters 1000,HARD,2,Leonardo Mayer,Alejandro Falla,Leonardo Mayer,2-6; 7-6(7); 6-4,R128,171,7,7,56,109,38,56,25,53,7,12,15,63,109,3,4,75,123,45,75,26,48,6,10,15,71,123
2012-03-08 00:00:00.000,ATP World Tour Masters 1000 Indian Wells CA; U.S.A. ATP World Tour Masters 1000,HARD,2,Rafael Nadal,N/A Bye,Rafael Nadal,,R128,0,0,0,0,0,0,0,0,0,0,0,0,0,0,0,0,0,0,0,0,0,0,0,0,0,0,0
2012-03-08 00:00:00.000,ATP World Tour Masters 1000 Indian Wells CA; U.S.A. ATP World Tour Masters 1000,HARD,2,Novak Djokovic,Andrey Golubev,Novak Djokovic,6-3; 6-2,R64,80,1,1,31,51,24,31,12,20,1,2,9,36,51,0,4,34,66,22,34,11,32,4,8,8,33,66
2012-03-08 00:00:00.000,ATP World Tour Masters 1000 Indian Wells CA; U.S.A. ATP World Tour Masters 1000,HARD,2,Kevin Anderson,Philipp Kohlschreiber,Kevin Anderson,W/O,R64,0,0,0,0,0,0,0,0,0,0,0,0,0,0,0,0,0,0,0,0,0,0,0,0,0,0,0
2012-03-08 00:00:00.000,ATP World Tour Masters 1000 Indian Wells CA; U.S.A. ATP World Tour Masters 1000,HARD,2,Pablo Andujar,Florian Mayer,Pablo Andujar,6-2; 6-4,R64,105,4,2,35,67,24,35,17,32,9,11,9,41,67,3,4,49,96,29,49,18,47,12,17,9,47,96
2012-03-08 00:00:00.000,ATP World Tour Masters 1000 Indian Wells CA; U.S.A. ATP World Tour Masters 1000,HARD,2,Albert Ramos-Vinolas,Richard Gasquet,Albert Ramos-Vinolas,3-6; 7-5; 6-1,R64,127,7,2,55,85,34,55,20,30,1,4,14,54,85,3,2,47,75,30,47,14,28,5,10,14,44,75
2012-03-08 00:00:00.000,ATP World Tour Masters 1000 Indian Wells CA; U.S.A. ATP World Tour Masters 1000,HARD,2,Nicolas Almagro,Sam Querrey,Nicolas Almagro,5-7; 6-4; 6-4,R64,118,6,1,51,88,36,51,26,37,4,7,16,62,88,12,4,40,89,33,40,24,49,1,5,16,57,89
2012-03-08 00:00:00.000,ATP World Tour Masters 1000 Indian Wells CA; U.S.A. ATP World Tour Masters 1000,HARD,2,Santiago Giraldo,Kei Nishikori,Santiago Giraldo,7-5; 6-2,R64,97,4,1,33,63,23,33,22,30,3,3,10,45,63,3,4,35,60,23,35,13,25,2,5,10,36,60
2012-03-08 00:00:00.000,ATP World Tour Masters 1000 Indian Wells CA; U.S.A. ATP World Tour Masters 1000,HARD,2,Andy Roddick,Lukasz Kubot,Andy Roddick,4-6; 7-6(5); 6-3,R64,160,7,3,63,100,43,63,20,37,5,8,15,63,100,7,8,72,122,51,72,20,50,12,16,16,71,122
2012-03-08 00:00:00.000,ATP World Tour Masters 1000 Indian Wells CA; U.S.A. ATP World Tour Masters 1000,HARD,2,Tomas Berdych,Sergiy Stakhovsky,Tomas Berdych,6-7(2); 6-3; 6-4,R64,151,6,8,65,112,46,65,29,47,7,7,16,75,112,15,4,59,98,52,59,15,39,2,4,15,67,98
2012-03-08 00:00:00.000,ATP World Tour Masters 1000 Indian Wells CA; U.S.A. ATP World Tour Masters 1000,HARD,2,Guillermo Garcia-Lopez,Andy Murray,Guillermo Garcia-Lopez,6-4; 6-2,R64,101,0,2,33,55,26,33,14,22,7,7,9,40,55,4,0,31,65,22,31,16,34,6,9,9,38,65
2012-03-08 00:00:00.000,ATP World Tour Masters 1000 Indian Wells CA; U.S.A. ATP World Tour Masters 1000,HARD,2,Ryan Harrison,Viktor Troicki,Ryan Harrison,7-6(5); 6-3,R64,97,5,4,38,60,29,38,13,22,1,3,10,42,60,2,0,34,74,24,34,18,40,4,8,11,42,74
2012-03-08 00:00:00.000,ATP World Tour Masters 1000 Indian Wells CA; U.S.A. ATP World Tour Masters 1000,HARD,2,Stan Wawrinka,Robby Ginepri,Stan Wawrinka,4-6; 6-4; 6-4,R64,111,8,3,46,86,35,46,26,40,2,4,15,61,86,0,3,49,86,34,49,21,37,6,9,15,55,86
2012-03-08 00:00:00.000,ATP World Tour Masters 1000 Indian Wells CA; U.S.A. ATP World Tour Masters 1000,HARD,2,Gilles Simon,Dudi Sela,Gilles Simon,7-5; 6-7(6); 6-4,R64,188,3,1,50,105,39,50,30,55,1,3,17,69,105,1,2,86,139,54,86,28,53,13,17,17,82,139
2012-03-08 00:00:00.000,ATP World Tour Masters 1000 Indian Wells CA; U.S.A. ATP World Tour Masters 1000,HARD,2,John Isner,Frederico Gil,John Isner,7-5; 6-3,R64,78,14,1,35,56,27,35,18,21,0,0,11,45,56,2,2,38,59,22,38,14,21,2,4,10,36,59
2012-03-08 00:00:00.000,ATP World Tour Masters 1000 Indian Wells CA; U.S.A. ATP World Tour Masters 1000,HARD,2,Juan Monaco,Nicolas Mahut,Juan Monaco,6-4; 5-7; 6-3,R64,149,0,2,61,92,43,61,18,31,3,5,15,61,92,5,4,73,118,54,73,15,45,15,19,16,69,118
2012-03-08 00:00:00.000,ATP World Tour Masters 1000 Indian Wells CA; U.S.A. ATP World Tour Masters 1000,HARD,2,Matthew Ebden,Julien Benneteau,Matthew Ebden,2-6; 6-3; 6-2,R64,91,3,1,42,65,29,42,15,23,1,4,13,44,65,4,5,46,74,33,46,11,28,2,6,12,44,74
2012-03-08 00:00:00.000,ATP World Tour Masters 1000 Indian Wells CA; U.S.A. ATP World Tour Masters 1000,HARD,2,Mardy Fish,Andreas Seppi,Mardy Fish,6-3; 3-2 RET,R64,50,9,1,18,36,16,18,12,18,0,0,7,28,36,0,0,21,40,13,21,12,19,1,3,7,25,40
2012-03-08 00:00:00.000,ATP World Tour Masters 1000 Indian Wells CA; U.S.A. ATP World Tour Masters 1000,HARD,2,David Ferrer,Grigor Dimitrov,David Ferrer,6-2; 6-2,R64,66,3,4,27,50,23,27,10,23,3,4,8,33,50,2,2,27,46,13,27,7,19,0,5,8,20,46
2012-03-08 00:00:00.000,ATP World Tour Masters 1000 Indian Wells CA; U.S.A. ATP World Tour Masters 1000,HARD,2,Denis Istomin,Juan Ignacio Chela,Denis Istomin,7-6(5); 6-7(7); 7-5,R64,202,9,4,65,127,42,65,33,62,6,11,18,75,127,2,7,101,159,55,101,34,58,13,19,18,89,159
2012-03-08 00:00:00.000,ATP World Tour Masters 1000 Indian Wells CA; U.S.A. ATP World Tour Masters 1000,HARD,2,Fernando Verdasco,Ryan Sweeting,Fernando Verdasco,6-2; 6-2,R64,67,3,2,31,46,24,31,10,15,3,3,8,34,46,3,3,28,49,16,28,9,21,4,8,8,25,49
2012-03-08 00:00:00.000,ATP World Tour Masters 1000 Indian Wells CA; U.S.A. ATP World Tour Masters 1000,HARD,2,Juan Martin Del Potro,Marinko Matosevic,Juan Martin Del Potro,7-5; 6-2,R64,101,3,0,33,65,26,33,19,32,1,1,10,45,65,3,3,37,65,28,37,11,28,5,8,10,39,65
2012-03-08 00:00:00.000,ATP World Tour Masters 1000 Indian Wells CA; U.S.A. ATP World Tour Masters 1000,HARD,2,Nikolay Davydenko,Bjorn Phau,Nikolay Davydenko,7-5; 6-2,R64,98,1,2,42,63,29,42,11,21,3,5,10,40,63,0,4,34,71,21,34,14,37,7,12,10,35,71
2012-03-08 00:00:00.000,ATP World Tour Masters 1000 Indian Wells CA; U.S.A. ATP World Tour Masters 1000,HARD,2,Thomaz Bellucci,Jurgen Melzer,Thomaz Bellucci,6-3; 6-3,R64,70,8,4,23,50,21,23,15,27,0,0,9,36,50,3,2,26,58,18,26,16,32,3,6,9,34,58
2012-03-08 00:00:00.000,ATP World Tour Masters 1000 Indian Wells CA; U.S.A. ATP World Tour Masters 1000,HARD,2,Milos Raonic,Carlos Berlocq,Milos Raonic,6-4; 6-2,R64,77,19,3,35,54,28,35,10,19,6,7,9,38,54,0,4,43,60,24,43,6,17,5,9,9,30,60
2012-03-08 00:00:00.000,ATP World Tour Masters 1000 Indian Wells CA; U.S.A. ATP World Tour Masters 1000,HARD,2,Roger Federer,Denis Kudla,Roger Federer,6-4; 6-1,R64,57,8,1,28,46,22,28,10,18,1,2,8,32,46,1,5,27,54,16,27,8,27,1,6,9,24,54
2012-03-08 00:00:00.000,ATP World Tour Masters 1000 Indian Wells CA; U.S.A. ATP World Tour Masters 1000,HARD,2,Jo-Wilfried Tsonga,Michael Llodra,Jo-Wilfried Tsonga,4-1 RET,R64,20,3,1,12,16,10,12,2,4,0,0,3,12,16,1,0,7,12,4,7,2,5,0,1,2,6,12
2012-03-08 00:00:00.000,ATP World Tour Masters 1000 Indian Wells CA; U.S.A. ATP World Tour Masters 1000,HARD,2,Radek Stepanek,Xavier Malisse,Radek Stepanek,6-2; 6-1,R64,65,4,1,30,44,24,30,8,14,2,2,7,32,44,2,0,32,52,17,32,6,20,3,8,8,23,52
2012-03-08 00:00:00.000,ATP World Tour Masters 1000 Indian Wells CA; U.S.A. ATP World Tour Masters 1000,HARD,2,David Nalbandian,Marin Cilic,David Nalbandian,7-6(3); 7-6(4),R64,128,4,5,57,88,43,57,12,31,4,7,12,55,88,2,5,50,90,33,50,19,40,9,12,12,52,90
2012-03-08 00:00:00.000,ATP World Tour Masters 1000 Indian Wells CA; U.S.A. ATP World Tour Masters 1000,HARD,2,Janko Tipsarevic,Gilles Muller,Janko Tipsarevic,6-4; 6-2,R64,73,7,2,31,49,29,31,8,18,2,2,9,37,49,5,1,29,53,24,29,7,24,2,5,9,31,53
2012-03-08 00:00:00.000,ATP World Tour Masters 1000 Indian Wells CA; U.S.A. ATP World Tour Masters 1000,HARD,2,Marcos Baghdatis,Feliciano Lopez,Marcos Baghdatis,6-3; 6-4,R64,71,5,1,32,53,26,32,13,21,0,1,10,39,53,4,2,30,50,24,30,5,20,1,4,9,29,50
2012-03-08 00:00:00.000,ATP World Tour Masters 1000 Indian Wells CA; U.S.A. ATP World Tour Masters 1000,HARD,2,Alexandr Dolgopolov,Steve Darcis,Alexandr Dolgopolov,6-7(13); 6-3; 7-5,R64,166,8,6,60,116,49,60,30,56,1,3,17,79,116,1,0,69,124,42,69,33,55,3,7,16,75,124
2012-03-08 00:00:00.000,ATP World Tour Masters 1000 Indian Wells CA; U.S.A. ATP World Tour Masters 1000,HARD,2,Marcel Granollers,Tommy Haas,Marcel Granollers,6-3; 2-6; 6-3,R64,125,3,3,36,70,25,36,20,34,3,6,13,45,70,1,2,50,89,32,50,18,39,8,12,13,50,89
2012-03-08 00:00:00.000,ATP World Tour Masters 1000 Indian Wells CA; U.S.A. ATP World Tour Masters 1000,HARD,2,Rafael Nadal,Leonardo Mayer,Rafael Nadal,6-1; 6-3,R64,76,1,2,27,36,26,27,6,9,0,0,8,32,36,0,3,27,49,15,27,7,22,2,6,8,22,49
2012-03-08 00:00:00.000,ATP World Tour Masters 1000 Indian Wells CA; U.S.A. ATP World Tour Masters 1000,HARD,2,Novak Djokovic,Kevin Anderson,Novak Djokovic,6-2; 6-3,R32,97,5,3,43,73,29,43,18,30,3,3,9,47,73,7,2,30,52,19,30,9,22,3,6,8,28,52
2012-03-08 00:00:00.000,ATP World Tour Masters 1000 Indian Wells CA; U.S.A. ATP World Tour Masters 1000,HARD,2,Pablo Andujar,Albert Ramos-Vinolas,Pablo Andujar,7-6(5); 6-4,R32,115,0,3,46,76,30,46,19,30,3,4,11,49,76,3,4,43,75,31,43,15,32,3,5,11,46,75
2012-03-08 00:00:00.000,ATP World Tour Masters 1000 Indian Wells CA; U.S.A. ATP World Tour Masters 1000,HARD,2,Nicolas Almagro,Santiago Giraldo,Nicolas Almagro,4-6; 6-2; 7-6(2),R32,126,5,1,42,82,34,42,25,40,1,4,15,59,82,0,1,58,94,40,58,17,36,8,12,15,57,94
2012-03-08 00:00:00.000,ATP World Tour Masters 1000 Indian Wells CA; U.S.A. ATP World Tour Masters 1000,HARD,2,Tomas Berdych,Andy Roddick,Tomas Berdych,6-3; 4-6; 6-2,R32,126,7,2,42,68,33,42,19,26,1,2,13,52,68,8,3,64,97,42,64,14,33,2,6,14,56,97
2012-03-08 00:00:00.000,ATP World Tour Masters 1000 Indian Wells CA; U.S.A. ATP World Tour Masters 1000,HARD,2,Ryan Harrison,Guillermo Garcia-Lopez,Ryan Harrison,6-4; 7-5,R32,110,3,3,45,70,32,45,12,25,5,8,11,44,70,0,2,37,72,20,37,18,35,2,7,11,38,72
2012-03-08 00:00:00.000,ATP World Tour Masters 1000 Indian Wells CA; U.S.A. ATP World Tour Masters 1000,HARD,2,Gilles Simon,Stan Wawrinka,Gilles Simon,6-4; 6-4,R32,97,5,1,34,52,26,34,11,18,1,2,10,37,52,4,2,59,91,39,59,12,32,10,13,10,51,91
2012-03-08 00:00:00.000,ATP World Tour Masters 1000 Indian Wells CA; U.S.A. ATP World Tour Masters 1000,HARD,2,John Isner,Juan Monaco,John Isner,7-5; 7-5,R32,124,10,3,46,65,38,46,12,19,4,4,12,50,65,0,4,76,100,50,76,10,24,5,7,12,60,100
2012-03-08 00:00:00.000,ATP World Tour Masters 1000 Indian Wells CA; U.S.A. ATP World Tour Masters 1000,HARD,2,Matthew Ebden,Mardy Fish,Matthew Ebden,6-3; 6-4,R32,85,2,2,36,56,27,36,11,20,1,3,10,38,56,2,5,29,55,19,29,12,26,1,5,9,31,55
2012-03-08 00:00:00.000,ATP World Tour Masters 1000 Indian Wells CA; U.S.A. ATP World Tour Masters 1000,HARD,2,Denis Istomin,David Ferrer,Denis Istomin,6-4; 6-3,R32,75,5,0,30,51,24,30,12,21,2,3,9,36,51,5,3,41,56,29,41,4,15,3,7,10,33,56
2012-03-08 00:00:00.000,ATP World Tour Masters 1000 Indian Wells CA; U.S.A. ATP World Tour Masters 1000,HARD,2,Juan Martin Del Potro,Fernando Verdasco,Juan Martin Del Potro,6-2; 7-6(6),R32,105,4,3,51,69,36,51,12,18,6,6,10,48,69,7,2,50,71,32,50,11,21,2,4,10,43,71
2012-03-08 00:00:00.000,ATP World Tour Masters 1000 Indian Wells CA; U.S.A. ATP World Tour Masters 1000,HARD,2,Thomaz Bellucci,Nikolay Davydenko,Thomaz Bellucci,W/O,R32,0,0,0,0,0,0,0,0,0,0,0,0,0,0,0,0,0,0,0,0,0,0,0,0,0,0,0
2012-03-08 00:00:00.000,ATP World Tour Masters 1000 Indian Wells CA; U.S.A. ATP World Tour Masters 1000,HARD,2,Roger Federer,Milos Raonic,Roger Federer,6-7(4); 6-2; 6-4,R32,128,10,6,51,88,45,51,23,37,3,3,15,68,88,10,6,54,96,41,54,24,42,1,4,15,65,96
2012-03-08 00:00:00.000,ATP World Tour Masters 1000 Indian Wells CA; U.S.A. ATP World Tour Masters 1000,HARD,2,Jo-Wilfried Tsonga,Radek Stepanek,Jo-Wilfried Tsonga,6-7(2); 6-3; 6-2,R32,138,11,7,53,86,43,53,20,33,1,1,15,63,86,2,3,56,93,32,56,25,37,7,10,14,57,93
2012-03-08 00:00:00.000,ATP World Tour Masters 1000 Indian Wells CA; U.S.A. ATP World Tour Masters 1000,HARD,2,David Nalbandian,Janko Tipsarevic,David Nalbandian,6-3; 3-6; 6-3,R32,116,2,3,39,81,31,39,27,42,2,3,14,58,81,5,1,43,68,32,43,14,25,0,2,13,46,68
2012-03-08 00:00:00.000,ATP World Tour Masters 1000 Indian Wells CA; U.S.A. ATP World Tour Masters 1000,HARD,2,Alexandr Dolgopolov,Marcos Baghdatis,Alexandr Dolgopolov,6-4; 5-7; 6-4,R32,140,8,1,61,103,48,61,15,42,4,8,16,63,103,4,8,59,110,41,59,23,51,8,13,16,64,110
2012-03-08 00:00:00.000,ATP World Tour Masters 1000 Indian Wells CA; U.S.A. ATP World Tour Masters 1000,HARD,2,Rafael Nadal,Marcel Granollers,Rafael Nadal,6-1; 6-4,R32,87,4,1,34,53,27,34,13,19,2,2,9,40,53,2,1,25,49,19,25,10,24,2,5,8,29,49
2012-03-08 00:00:00.000,ATP World Tour Masters 1000 Indian Wells CA; U.S.A. ATP World Tour Masters 1000,HARD,2,Novak Djokovic,Pablo Andujar,Novak Djokovic,6-0; 6-7(5); 6-2,R16,136,4,0,67,100,46,67,20,33,8,8,13,66,100,1,4,46,80,29,46,15,34,0,5,13,44,80
2012-03-08 00:00:00.000,ATP World Tour Masters 1000 Indian Wells CA; U.S.A. ATP World Tour Masters 1000,HARD,2,Nicolas Almagro,Tomas Berdych,Nicolas Almagro,6-4; 6-0,R16,75,8,1,26,45,23,26,10,19,2,2,8,33,45,3,1,27,59,16,27,14,32,9,13,8,30,59
2012-03-08 00:00:00.000,ATP World Tour Masters 1000 Indian Wells CA; U.S.A. ATP World Tour Masters 1000,HARD,2,Gilles Simon,Ryan Harrison,Gilles Simon,7-6(0); 5-7; 6-1,R16,175,0,2,69,118,48,69,25,49,7,11,16,73,118,5,1,59,97,38,59,18,38,6,11,15,56,97
2012-03-08 00:00:00.000,ATP World Tour Masters 1000 Indian Wells CA; U.S.A. ATP World Tour Masters 1000,HARD,2,John Isner,Matthew Ebden,John Isner,6-4; 7-5,R16,75,10,1,35,59,31,35,16,24,2,2,11,47,59,6,3,40,57,30,40,11,17,1,3,11,41,57
2012-03-08 00:00:00.000,ATP World Tour Masters 1000 Indian Wells CA; U.S.A. ATP World Tour Masters 1000,HARD,2,Juan Martin Del Potro,Denis Istomin,Juan Martin Del Potro,7-6(2); 6-7(6); 6-2,R16,165,10,3,54,100,44,54,27,46,5,7,16,71,100,3,4,67,114,44,67,23,47,6,10,16,67,114
2012-03-08 00:00:00.000,ATP World Tour Masters 1000 Indian Wells CA; U.S.A. ATP World Tour Masters 1000,HARD,2,Roger Federer,Thomaz Bellucci,Roger Federer,3-6; 6-3; 6-4,R16,101,8,1,49,73,40,49,13,24,1,3,14,53,73,6,4,45,83,34,45,19,38,4,7,14,53,83
2012-03-08 00:00:00.000,ATP World Tour Masters 1000 Indian Wells CA; U.S.A. ATP World Tour Masters 1000,HARD,2,David Nalbandian,Jo-Wilfried Tsonga,David Nalbandian,3-6; 7-5; 6-3,R16,139,0,7,44,82,31,44,19,38,2,6,15,50,82,13,3,43,97,31,43,25,54,5,10,15,56,97
2012-03-08 00:00:00.000,ATP World Tour Masters 1000 Indian Wells CA; U.S.A. ATP World Tour Masters 1000,HARD,2,Rafael Nadal,Alexandr Dolgopolov,Rafael Nadal,6-3; 6-2,R16,76,4,0,33,52,27,33,12,19,5,5,9,39,52,5,1,23,51,16,23,11,28,3,6,8,27,51
2012-03-08 00:00:00.000,ATP World Tour Masters 1000 Indian Wells CA; U.S.A. ATP World Tour Masters 1000,HARD,2,Novak Djokovic,Nicolas Almagro,Novak Djokovic,6-3; 6-4,Q,83,5,0,31,53,24,31,16,22,0,1,10,40,53,3,3,32,62,21,32,14,30,4,7,9,35,62
2012-03-08 00:00:00.000,ATP World Tour Masters 1000 Indian Wells CA; U.S.A. ATP World Tour Masters 1000,HARD,2,John Isner,Gilles Simon,John Isner,6-3; 1-6; 7-5,Q,119,11,3,48,86,33,48,22,38,3,6,14,55,86,7,4,52,96,40,52,20,44,6,9,14,60,96
2012-03-08 00:00:00.000,ATP World Tour Masters 1000 Indian Wells CA; U.S.A. ATP World Tour Masters 1000,HARD,2,Roger Federer,Juan Martin Del Potro,Roger Federer,6-3; 6-2,Q,70,13,0,35,62,28,35,16,27,3,3,9,44,62,0,1,23,37,15,23,8,14,3,6,8,23,37
2012-03-08 00:00:00.000,ATP World Tour Masters 1000 Indian Wells CA; U.S.A. ATP World Tour Masters 1000,HARD,2,Rafael Nadal,David Nalbandian,Rafael Nadal,4-6; 7-5; 6-4,Q,160,3,0,62,91,45,62,18,29,4,6,16,63,91,4,3,57,97,36,57,26,40,4,7,16,62,97
2012-03-08 00:00:00.000,ATP World Tour Masters 1000 Indian Wells CA; U.S.A. ATP World Tour Masters 1000,HARD,2,John Isner,Novak Djokovic,John Isner,7-6(7); 3-6; 7-6(5),S,166,20,0,83,112,60,83,15,29,4,6,16,75,112,8,2,72,111,56,72,24,39,1,2,17,80,111
2012-03-08 00:00:00.000,ATP World Tour Masters 1000 Indian Wells CA; U.S.A. ATP World Tour Masters 1000,HARD,2,Roger Federer,Rafael Nadal,Roger Federer,6-3; 6-4,S,92,6,2,36,56,23,36,13,20,2,4,10,36,56,0,2,40,56,23,40,7,16,2,6,9,30,56
2012-03-08 00:00:00.000,ATP World Tour Masters 1000 Indian Wells CA; U.S.A. ATP World Tour Masters 1000,HARD,2,Roger Federer,John Isner,Roger Federer,7-6(7); 6-3,F,82,7,2,35,56,33,35,14,21,3,3,10,47,56,4,1,52,71,37,52,9,19,1,3,11,46,71
2012-03-21 00:00:00.000,ATP World Tour Masters 1000 Miami FL; U.S.A. ATP World Tour Masters 1000,HARD,2,Novak Djokovic,N/A Bye,Novak Djokovic,,R128,0,0,0,0,0,0,0,0,0,0,0,0,0,0,0,0,0,0,0,0,0,0,0,0,0,0,0
2012-03-21 00:00:00.000,ATP World Tour Masters 1000 Miami FL; U.S.A. ATP World Tour Masters 1000,HARD,2,Marcos Baghdatis,Leonardo Mayer,Marcos Baghdatis,6-1; 6-4,R128,83,3,2,30,55,24,30,13,25,2,3,9,37,55,2,6,26,48,17,26,8,22,2,6,8,25,48
2012-03-21 00:00:00.000,ATP World Tour Masters 1000 Miami FL; U.S.A. ATP World Tour Masters 1000,HARD,2,Guillermo Garcia-Lopez,Rajeev Ram,Guillermo Garcia-Lopez,6-4; 7-6(7),R128,111,1,0,43,69,32,43,17,26,4,5,11,49,69,7,3,37,81,30,37,20,44,2,4,11,50,81
2012-03-21 00:00:00.000,ATP World Tour Masters 1000 Miami FL; U.S.A. ATP World Tour Masters 1000,HARD,2,Viktor Troicki,N/A Bye,Viktor Troicki,,R128,0,0,0,0,0,0,0,0,0,0,0,0,0,0,0,0,0,0,0,0,0,0,0,0,0,0,0
2012-03-21 00:00:00.000,ATP World Tour Masters 1000 Miami FL; U.S.A. ATP World Tour Masters 1000,HARD,2,Richard Gasquet,N/A Bye,Richard Gasquet,,R128,0,0,0,0,0,0,0,0,0,0,0,0,0,0,0,0,0,0,0,0,0,0,0,0,0,0,0
2012-03-21 00:00:00.000,ATP World Tour Masters 1000 Miami FL; U.S.A. ATP World Tour Masters 1000,HARD,2,Cedrik-Marcel Stebe,Flavio Cipolla,Cedrik-Marcel Stebe,6-3; 7-5,R128,102,4,6,41,74,28,41,14,33,7,11,11,42,74,0,6,46,66,22,46,8,20,4,10,10,30,66
2012-03-21 00:00:00.000,ATP World Tour Masters 1000 Miami FL; U.S.A. ATP World Tour Masters 1000,HARD,2,Albert Ramos-Vinolas,Simone Bolelli,Albert Ramos-Vinolas,6-3; 6-1,R128,90,1,1,21,42,19,21,13,21,0,0,8,32,42,3,2,45,75,24,45,13,30,7,11,8,37,75
2012-03-21 00:00:00.000,ATP World Tour Masters 1000 Miami FL; U.S.A. ATP World Tour Masters 1000,HARD,2,Feliciano Lopez,N/A Bye,Feliciano Lopez,,R128,0,0,0,0,0,0,0,0,0,0,0,0,0,0,0,0,0,0,0,0,0,0,0,0,0,0,0
2012-03-21 00:00:00.000,ATP World Tour Masters 1000 Miami FL; U.S.A. ATP World Tour Masters 1000,HARD,2,Juan Martin Del Potro,N/A Bye,Juan Martin Del Potro,,R128,0,0,0,0,0,0,0,0,0,0,0,0,0,0,0,0,0,0,0,0,0,0,0,0,0,0,0
2012-03-21 00:00:00.000,ATP World Tour Masters 1000 Miami FL; U.S.A. ATP World Tour Masters 1000,HARD,2,Ivo Karlovic,Lukasz Kubot,Ivo Karlovic,6-3; 6-7(2); 7-6(2),R128,183,27,4,67,117,54,67,28,50,5,6,17,82,117,4,8,73,111,55,73,19,38,9,11,16,74,111
2012-03-21 00:00:00.000,ATP World Tour Masters 1000 Miami FL; U.S.A. ATP World Tour Masters 1000,HARD,2,Igor Kunitsyn,Jesse Levine,Igor Kunitsyn,7-6(8); 7-6(3),R128,135,2,0,54,95,34,54,21,41,12,16,12,55,95,5,8,56,104,34,56,23,48,7,11,12,57,104
2012-03-21 00:00:00.000,ATP World Tour Masters 1000 Miami FL; U.S.A. ATP World Tour Masters 1000,HARD,2,Marin Cilic,N/A Bye,Marin Cilic,,R128,0,0,0,0,0,0,0,0,0,0,0,0,0,0,0,0,0,0,0,0,0,0,0,0,0,0,0
2012-03-21 00:00:00.000,ATP World Tour Masters 1000 Miami FL; U.S.A. ATP World Tour Masters 1000,HARD,2,Julien Benneteau,N/A Bye,Julien Benneteau,,R128,0,0,0,0,0,0,0,0,0,0,0,0,0,0,0,0,0,0,0,0,0,0,0,0,0,0,0
2012-03-21 00:00:00.000,ATP World Tour Masters 1000 Miami FL; U.S.A. ATP World Tour Masters 1000,HARD,2,Benjamin Becker,Olivier Rochus,Benjamin Becker,5-7; 6-3; 6-2,R128,131,24,2,50,95,39,50,24,45,1,2,15,63,95,3,7,50,98,33,50,26,48,6,9,14,59,98
2012-03-21 00:00:00.000,ATP World Tour Masters 1000 Miami FL; U.S.A. ATP World Tour Masters 1000,HARD,2,Bernard Tomic,Sergiy Stakhovsky,Bernard Tomic,7-6(4); 6-3,R128,89,5,4,59,86,40,59,14,27,8,9,11,54,86,7,6,33,61,27,33,13,28,2,4,10,40,61
2012-03-21 00:00:00.000,ATP World Tour Masters 1000 Miami FL; U.S.A. ATP World Tour Masters 1000,HARD,2,David Ferrer,N/A Bye,David Ferrer,,R128,0,0,0,0,0,0,0,0,0,0,0,0,0,0,0,0,0,0,0,0,0,0,0,0,0,0,0
2012-03-21 00:00:00.000,ATP World Tour Masters 1000 Miami FL; U.S.A. ATP World Tour Masters 1000,HARD,2,Roger Federer,N/A Bye,Roger Federer,,R128,0,0,0,0,0,0,0,0,0,0,0,0,0,0,0,0,0,0,0,0,0,0,0,0,0,0,0
2012-03-21 00:00:00.000,ATP World Tour Masters 1000 Miami FL; U.S.A. ATP World Tour Masters 1000,HARD,2,Ryan Harrison,Potito Starace,Ryan Harrison,6-7(6); 6-4; 6-4,R128,143,11,2,64,110,54,64,27,46,5,5,16,81,110,3,3,69,104,49,69,20,35,5,7,16,69,104
2012-03-21 00:00:00.000,ATP World Tour Masters 1000 Miami FL; U.S.A. ATP World Tour Masters 1000,HARD,2,Gilles Muller,Alex Bogomolov Jr.,Gilles Muller,5-7; 6-4; 7-6(5),R128,156,27,4,57,100,48,57,22,43,1,3,17,70,100,2,6,70,115,54,70,24,45,6,8,17,78,115
2012-03-21 00:00:00.000,ATP World Tour Masters 1000 Miami FL; U.S.A. ATP World Tour Masters 1000,HARD,2,Andy Roddick,N/A Bye,Andy Roddick,,R128,0,0,0,0,0,0,0,0,0,0,0,0,0,0,0,0,0,0,0,0,0,0,0,0,0,0,0
2012-03-21 00:00:00.000,ATP World Tour Masters 1000 Miami FL; U.S.A. ATP World Tour Masters 1000,HARD,2,Juan Monaco,N/A Bye,Juan Monaco,,R128,0,0,0,0,0,0,0,0,0,0,0,0,0,0,0,0,0,0,0,0,0,0,0,0,0,0,0
2012-03-21 00:00:00.000,ATP World Tour Masters 1000 Miami FL; U.S.A. ATP World Tour Masters 1000,HARD,2,Yen-Hsun Lu,Jarkko Nieminen,Yen-Hsun Lu,6-4; 6-3,R128,82,1,3,32,65,23,32,19,33,5,6,9,42,65,1,5,34,61,25,34,8,27,1,5,10,33,61
2012-03-21 00:00:00.000,ATP World Tour Masters 1000 Miami FL; U.S.A. ATP World Tour Masters 1000,HARD,2,Sergei Bubka,Ernests Gulbis,Sergei Bubka,6-4; 6-4,R128,68,5,2,35,55,30,35,7,20,1,3,10,37,55,4,4,21,55,18,21,12,34,1,5,10,30,55
2012-03-21 00:00:00.000,ATP World Tour Masters 1000 Miami FL; U.S.A. ATP World Tour Masters 1000,HARD,2,Gael Monfils,N/A Bye,Gael Monfils,,R128,0,0,0,0,0,0,0,0,0,0,0,0,0,0,0,0,0,0,0,0,0,0,0,0,0,0,0
2012-03-21 00:00:00.000,ATP World Tour Masters 1000 Miami FL; U.S.A. ATP World Tour Masters 1000,HARD,2,Nicolas Almagro,N/A Bye,Nicolas Almagro,,R128,0,0,0,0,0,0,0,0,0,0,0,0,0,0,0,0,0,0,0,0,0,0,0,0,0,0,0
2012-03-21 00:00:00.000,ATP World Tour Masters 1000 Miami FL; U.S.A. ATP World Tour Masters 1000,HARD,2,David Goffin,Donald Young,David Goffin,7-5; 6-4,R128,95,1,9,48,75,29,48,11,27,6,11,11,40,75,2,6,32,69,23,32,9,37,2,9,11,32,69
2012-03-21 00:00:00.000,ATP World Tour Masters 1000 Miami FL; U.S.A. ATP World Tour Masters 1000,HARD,2,Bjorn Phau,Carlos Berlocq,Bjorn Phau,6-4; 6-2,R128,92,2,6,41,72,30,41,14,31,10,11,9,44,72,3,3,36,66,23,36,11,30,7,11,9,34,66
2012-03-21 00:00:00.000,ATP World Tour Masters 1000 Miami FL; U.S.A. ATP World Tour Masters 1000,HARD,2,Fernando Verdasco,N/A Bye,Fernando Verdasco,,R128,0,0,0,0,0,0,0,0,0,0,0,0,0,0,0,0,0,0,0,0,0,0,0,0,0,0,0
2012-03-21 00:00:00.000,ATP World Tour Masters 1000 Miami FL; U.S.A. ATP World Tour Masters 1000,HARD,2,Kevin Anderson,N/A Bye,Kevin Anderson,,R128,0,0,0,0,0,0,0,0,0,0,0,0,0,0,0,0,0,0,0,0,0,0,0,0,0,0,0
2012-03-21 00:00:00.000,ATP World Tour Masters 1000 Miami FL; U.S.A. ATP World Tour Masters 1000,HARD,2,Sam Querrey,Matthew Ebden,Sam Querrey,6-1; 5-7; 7-5,R128,115,8,3,52,88,43,52,18,36,3,5,16,61,88,7,5,48,87,35,48,18,39,4,8,15,53,87
2012-03-21 00:00:00.000,ATP World Tour Masters 1000 Miami FL; U.S.A. ATP World Tour Masters 1000,HARD,2,Frank Dancevic,Jeremy Chardy,Frank Dancevic,7-5; 7-6(0),R128,88,12,1,28,68,24,28,26,40,6,8,12,50,68,10,11,37,78,29,37,16,41,5,8,12,45,78
2012-03-21 00:00:00.000,ATP World Tour Masters 1000 Miami FL; U.S.A. ATP World Tour Masters 1000,HARD,2,Mardy Fish,N/A Bye,Mardy Fish,,R128,0,0,0,0,0,0,0,0,0,0,0,0,0,0,0,0,0,0,0,0,0,0,0,0,0,0,0
2012-03-21 00:00:00.000,ATP World Tour Masters 1000 Miami FL; U.S.A. ATP World Tour Masters 1000,HARD,2,Tomas Berdych,N/A Bye,Tomas Berdych,,R128,0,0,0,0,0,0,0,0,0,0,0,0,0,0,0,0,0,0,0,0,0,0,0,0,0,0,0
2012-03-21 00:00:00.000,ATP World Tour Masters 1000 Miami FL; U.S.A. ATP World Tour Masters 1000,HARD,2,Nicolas Mahut,Fernando Gonzalez,Nicolas Mahut,7-5; 4-6; 7-6(3),R128,157,12,6,74,119,56,74,22,45,10,14,17,78,119,5,5,66,118,44,66,29,52,10,14,17,73,118
2012-03-21 00:00:00.000,ATP World Tour Masters 1000 Miami FL; U.S.A. ATP World Tour Masters 1000,HARD,2,Grigor Dimitrov,Mikhail Kukushkin,Grigor Dimitrov,6-2; 6-2,R128,54,5,0,26,42,21,26,12,16,1,1,8,33,42,0,3,30,54,18,30,10,24,6,10,8,28,54
2012-03-21 00:00:00.000,ATP World Tour Masters 1000 Miami FL; U.S.A. ATP World Tour Masters 1000,HARD,2,Juan Ignacio Chela,N/A Bye,Juan Ignacio Chela,,R128,0,0,0,0,0,0,0,0,0,0,0,0,0,0,0,0,0,0,0,0,0,0,0,0,0,0,0
2012-03-21 00:00:00.000,ATP World Tour Masters 1000 Miami FL; U.S.A. ATP World Tour Masters 1000,HARD,2,Alexandr Dolgopolov,N/A Bye,Alexandr Dolgopolov,,R128,0,0,0,0,0,0,0,0,0,0,0,0,0,0,0,0,0,0,0,0,0,0,0,0,0,0,0
2012-03-21 00:00:00.000,ATP World Tour Masters 1000 Miami FL; U.S.A. ATP World Tour Masters 1000,HARD,2,Antonio Veic,Denis Kudla,Antonio Veic,2-6; 6-2; 6-1,R128,94,1,0,37,62,25,37,14,25,0,3,11,39,62,2,4,46,81,27,46,15,35,9,15,12,42,81
2012-03-21 00:00:00.000,ATP World Tour Masters 1000 Miami FL; U.S.A. ATP World Tour Masters 1000,HARD,2,David Nalbandian,Steve Darcis,David Nalbandian,6-4; 7-6(0),R128,116,2,5,50,84,32,50,15,34,5,9,11,47,84,2,1,48,84,27,48,16,36,9,14,11,43,84
2012-03-21 00:00:00.000,ATP World Tour Masters 1000 Miami FL; U.S.A. ATP World Tour Masters 1000,HARD,2,Janko Tipsarevic,N/A Bye,Janko Tipsarevic,,R128,0,0,0,0,0,0,0,0,0,0,0,0,0,0,0,0,0,0,0,0,0,0,0,0,0,0,0
2012-03-21 00:00:00.000,ATP World Tour Masters 1000 Miami FL; U.S.A. ATP World Tour Masters 1000,HARD,2,Gilles Simon,N/A Bye,Gilles Simon,,R128,0,0,0,0,0,0,0,0,0,0,0,0,0,0,0,0,0,0,0,0,0,0,0,0,0,0,0
2012-03-21 00:00:00.000,ATP World Tour Masters 1000 Miami FL; U.S.A. ATP World Tour Masters 1000,HARD,2,Roberto Bautista Agut,Andreas Seppi,Roberto Bautista Agut,6-3; 1-6; 6-3,R128,123,4,2,41,72,31,41,15,31,2,5,13,46,72,5,5,47,93,30,47,24,46,9,12,12,54,93
2012-03-21 00:00:00.000,ATP World Tour Masters 1000 Miami FL; U.S.A. ATP World Tour Masters 1000,HARD,2,Robin Haase,Marinko Matosevic,Robin Haase,6-3; 6-4,R128,86,3,0,28,47,23,28,8,19,3,5,9,31,47,3,1,38,62,24,38,8,24,4,9,10,32,62
2012-03-21 00:00:00.000,ATP World Tour Masters 1000 Miami FL; U.S.A. ATP World Tour Masters 1000,HARD,2,Jurgen Melzer,N/A Bye,Jurgen Melzer,,R128,0,0,0,0,0,0,0,0,0,0,0,0,0,0,0,0,0,0,0,0,0,0,0,0,0,0,0
2012-03-21 00:00:00.000,ATP World Tour Masters 1000 Miami FL; U.S.A. ATP World Tour Masters 1000,HARD,2,Milos Raonic,N/A Bye,Milos Raonic,,R128,0,0,0,0,0,0,0,0,0,0,0,0,0,0,0,0,0,0,0,0,0,0,0,0,0,0,0
2012-03-21 00:00:00.000,ATP World Tour Masters 1000 Miami FL; U.S.A. ATP World Tour Masters 1000,HARD,2,Arnaud Clement,Dudi Sela,Arnaud Clement,6-3; 6-3,R128,96,4,2,38,70,25,38,21,32,6,6,9,46,70,5,5,44,71,30,44,10,27,6,9,9,40,71
2012-03-21 00:00:00.000,ATP World Tour Masters 1000 Miami FL; U.S.A. ATP World Tour Masters 1000,HARD,2,Alejandro Falla,Denis Istomin,Alejandro Falla,6-1; 2-1 RET,R128,45,2,1,24,34,15,24,6,10,2,3,5,21,34,1,1,11,24,5,11,2,13,0,4,5,7,24
2012-03-21 00:00:00.000,ATP World Tour Masters 1000 Miami FL; U.S.A. ATP World Tour Masters 1000,HARD,2,Andy Murray,N/A Bye,Andy Murray,,R128,0,0,0,0,0,0,0,0,0,0,0,0,0,0,0,0,0,0,0,0,0,0,0,0,0,0,0
2012-03-21 00:00:00.000,ATP World Tour Masters 1000 Miami FL; U.S.A. ATP World Tour Masters 1000,HARD,2,Jo-Wilfried Tsonga,N/A Bye,Jo-Wilfried Tsonga,,R128,0,0,0,0,0,0,0,0,0,0,0,0,0,0,0,0,0,0,0,0,0,0,0,0,0,0,0
2012-03-21 00:00:00.000,ATP World Tour Masters 1000 Miami FL; U.S.A. ATP World Tour Masters 1000,HARD,2,Xavier Malisse,Edouard Roger-Vasselin,Xavier Malisse,7-6(3); 6-3,R128,96,6,1,42,68,31,42,15,26,5,7,11,46,68,0,0,45,70,27,45,12,25,2,5,10,39,70
2012-03-21 00:00:00.000,ATP World Tour Masters 1000 Miami FL; U.S.A. ATP World Tour Masters 1000,HARD,2,Frederico Gil,Thomaz Bellucci,Frederico Gil,6-3; 6-4,R128,93,1,2,49,83,35,49,16,34,9,10,10,51,83,5,6,30,56,21,30,13,26,5,8,9,34,56
2012-03-21 00:00:00.000,ATP World Tour Masters 1000 Miami FL; U.S.A. ATP World Tour Masters 1000,HARD,2,Philipp Kohlschreiber,N/A Bye,Philipp Kohlschreiber,,R128,0,0,0,0,0,0,0,0,0,0,0,0,0,0,0,0,0,0,0,0,0,0,0,0,0,0,0
2012-03-21 00:00:00.000,ATP World Tour Masters 1000 Miami FL; U.S.A. ATP World Tour Masters 1000,HARD,2,Florian Mayer,N/A Bye,Florian Mayer,,R128,0,0,0,0,0,0,0,0,0,0,0,0,0,0,0,0,0,0,0,0,0,0,0,0,0,0,0
2012-03-21 00:00:00.000,ATP World Tour Masters 1000 Miami FL; U.S.A. ATP World Tour Masters 1000,HARD,2,Ivan Dodig,Tobias Kamke,Ivan Dodig,6-0; 2-6; 7-6(5),R128,162,12,6,50,103,35,50,27,53,8,11,13,62,103,1,4,66,106,39,66,22,40,6,10,13,61,106
2012-03-21 00:00:00.000,ATP World Tour Masters 1000 Miami FL; U.S.A. ATP World Tour Masters 1000,HARD,2,Nikolay Davydenko,James Blake,Nikolay Davydenko,4-6; 6-4; 6-4,R128,120,2,4,67,91,48,67,9,24,1,5,15,57,91,3,6,55,108,37,55,25,53,8,13,15,62,108
2012-03-21 00:00:00.000,ATP World Tour Masters 1000 Miami FL; U.S.A. ATP World Tour Masters 1000,HARD,2,John Isner,N/A Bye,John Isner,,R128,0,0,0,0,0,0,0,0,0,0,0,0,0,0,0,0,0,0,0,0,0,0,0,0,0,0,0
2012-03-21 00:00:00.000,ATP World Tour Masters 1000 Miami FL; U.S.A. ATP World Tour Masters 1000,HARD,2,Kei Nishikori,N/A Bye,Kei Nishikori,,R128,0,0,0,0,0,0,0,0,0,0,0,0,0,0,0,0,0,0,0,0,0,0,0,0,0,0,0
2012-03-21 00:00:00.000,ATP World Tour Masters 1000 Miami FL; U.S.A. ATP World Tour Masters 1000,HARD,2,Lukas Lacko,Ryan Sweeting,Lukas Lacko,6-4; 6-4,R128,83,6,3,42,69,29,42,16,27,8,9,10,45,69,2,7,41,61,30,41,7,20,9,12,10,37,61
2012-03-21 00:00:00.000,ATP World Tour Masters 1000 Miami FL; U.S.A. ATP World Tour Masters 1000,HARD,2,Lukas Rosol,Michael Llodra,Lukas Rosol,6-4; 7-6(6),R128,82,6,2,37,66,30,37,21,29,0,0,11,51,66,5,2,56,75,41,56,11,19,5,6,11,52,75
2012-03-21 00:00:00.000,ATP World Tour Masters 1000 Miami FL; U.S.A. ATP World Tour Masters 1000,HARD,2,Marcel Granollers,N/A Bye,Marcel Granollers,,R128,0,0,0,0,0,0,0,0,0,0,0,0,0,0,0,0,0,0,0,0,0,0,0,0,0,0,0
2012-03-21 00:00:00.000,ATP World Tour Masters 1000 Miami FL; U.S.A. ATP World Tour Masters 1000,HARD,2,Radek Stepanek,N/A Bye,Radek Stepanek,,R128,0,0,0,0,0,0,0,0,0,0,0,0,0,0,0,0,0,0,0,0,0,0,0,0,0,0,0
2012-03-21 00:00:00.000,ATP World Tour Masters 1000 Miami FL; U.S.A. ATP World Tour Masters 1000,HARD,2,Tommy Haas,Guillaume Rufin,Tommy Haas,6-4; 6-4,R128,95,8,2,38,62,31,38,14,24,3,3,10,45,62,8,0,48,76,29,48,17,28,8,10,10,46,76
2012-03-21 00:00:00.000,ATP World Tour Masters 1000 Miami FL; U.S.A. ATP World Tour Masters 1000,HARD,2,Santiago Giraldo,Pablo Andujar,Santiago Giraldo,6-3; 6-2,R128,89,2,0,40,67,27,40,17,27,1,1,9,44,67,1,5,32,63,21,32,14,31,7,10,8,35,63
2012-03-21 00:00:00.000,ATP World Tour Masters 1000 Miami FL; U.S.A. ATP World Tour Masters 1000,HARD,2,Rafael Nadal,N/A Bye,Rafael Nadal,,R128,0,0,0,0,0,0,0,0,0,0,0,0,0,0,0,0,0,0,0,0,0,0,0,0,0,0,0
2012-03-21 00:00:00.000,ATP World Tour Masters 1000 Miami FL; U.S.A. ATP World Tour Masters 1000,HARD,2,Novak Djokovic,Marcos Baghdatis,Novak Djokovic,6-4; 6-4,R64,92,2,1,40,64,32,40,15,24,2,2,10,47,64,6,2,34,50,26,34,9,16,1,3,10,35,50
2012-03-21 00:00:00.000,ATP World Tour Masters 1000 Miami FL; U.S.A. ATP World Tour Masters 1000,HARD,2,Viktor Troicki,Guillermo Garcia-Lopez,Viktor Troicki,4-6; 6-1; 6-4,R64,121,5,1,39,81,28,39,22,42,4,7,14,50,81,1,3,53,82,31,53,12,29,6,11,13,43,82
2012-03-21 00:00:00.000,ATP World Tour Masters 1000 Miami FL; U.S.A. ATP World Tour Masters 1000,HARD,2,Richard Gasquet,Cedrik-Marcel Stebe,Richard Gasquet,6-3; 6-7(6); 6-2,R64,158,1,4,67,102,42,67,21,35,7,10,14,63,102,2,2,68,97,41,68,12,29,7,14,15,53,97
2012-03-21 00:00:00.000,ATP World Tour Masters 1000 Miami FL; U.S.A. ATP World Tour Masters 1000,HARD,2,Albert Ramos-Vinolas,Feliciano Lopez,Albert Ramos-Vinolas,6-4; 7-6(5),R64,99,1,2,48,75,32,48,16,27,1,3,11,48,75,14,7,34,67,29,34,12,33,1,4,11,41,67
2012-03-21 00:00:00.000,ATP World Tour Masters 1000 Miami FL; U.S.A. ATP World Tour Masters 1000,HARD,2,Juan Martin Del Potro,Ivo Karlovic,Juan Martin Del Potro,7-5; 6-4,R64,105,6,3,36,59,32,36,14,23,0,0,11,46,59,8,2,41,72,32,41,15,31,5,7,11,47,72
2012-03-21 00:00:00.000,ATP World Tour Masters 1000 Miami FL; U.S.A. ATP World Tour Masters 1000,HARD,2,Marin Cilic,Igor Kunitsyn,Marin Cilic,6-3; 7-6(1),R64,82,9,3,28,62,24,28,18,34,0,2,11,42,62,1,0,41,58,25,41,8,17,2,5,10,33,58
2012-03-21 00:00:00.000,ATP World Tour Masters 1000 Miami FL; U.S.A. ATP World Tour Masters 1000,HARD,2,Julien Benneteau,Benjamin Becker,Julien Benneteau,3-6; 6-3; 7-6(4),R64,128,10,3,58,94,46,58,17,36,4,7,15,63,94,8,2,49,83,39,49,18,34,3,6,15,57,83
2012-03-21 00:00:00.000,ATP World Tour Masters 1000 Miami FL; U.S.A. ATP World Tour Masters 1000,HARD,2,David Ferrer,Bernard Tomic,David Ferrer,6-4; 6-4,R64,102,3,3,40,72,25,40,18,32,5,7,10,43,72,1,1,44,71,26,44,12,27,6,10,10,38,71
2012-03-21 00:00:00.000,ATP World Tour Masters 1000 Miami FL; U.S.A. ATP World Tour Masters 1000,HARD,2,Roger Federer,Ryan Harrison,Roger Federer,6-2; 7-6(3),R64,84,5,1,34,53,29,34,13,19,0,1,10,42,53,4,1,35,69,26,35,17,34,5,8,10,43,69
2012-03-21 00:00:00.000,ATP World Tour Masters 1000 Miami FL; U.S.A. ATP World Tour Masters 1000,HARD,2,Andy Roddick,Gilles Muller,Andy Roddick,6-3; 6-2,R64,74,10,1,31,45,26,31,10,14,0,0,9,36,45,4,6,39,63,27,39,6,24,7,10,8,33,63
2012-03-21 00:00:00.000,ATP World Tour Masters 1000 Miami FL; U.S.A. ATP World Tour Masters 1000,HARD,2,Juan Monaco,Yen-Hsun Lu,Juan Monaco,5-0 RET,R64,31,0,1,5,18,5,5,8,13,2,2,3,13,18,0,1,8,14,3,8,2,6,2,4,2,5,14
2012-03-21 00:00:00.000,ATP World Tour Masters 1000 Miami FL; U.S.A. ATP World Tour Masters 1000,HARD,2,Gael Monfils,Sergei Bubka,Gael Monfils,6-4; 6-4,R64,78,5,5,34,62,28,34,17,28,2,2,10,45,62,7,2,33,63,24,33,16,30,4,6,10,40,63
2012-03-21 00:00:00.000,ATP World Tour Masters 1000 Miami FL; U.S.A. ATP World Tour Masters 1000,HARD,2,Nicolas Almagro,David Goffin,Nicolas Almagro,6-4; 6-2,R64,83,5,1,23,50,19,23,17,27,4,5,9,36,50,3,7,45,77,31,45,10,32,6,10,9,41,77
2012-03-21 00:00:00.000,ATP World Tour Masters 1000 Miami FL; U.S.A. ATP World Tour Masters 1000,HARD,2,Fernando Verdasco,Bjorn Phau,Fernando Verdasco,6-3; 6-0,R64,61,6,1,34,46,24,34,7,12,2,3,8,31,46,2,3,22,46,11,22,8,24,6,11,7,19,46
2012-03-21 00:00:00.000,ATP World Tour Masters 1000 Miami FL; U.S.A. ATP World Tour Masters 1000,HARD,2,Kevin Anderson,Sam Querrey,Kevin Anderson,6-3; 6-7(3); 6-3,R64,123,13,1,62,100,45,62,27,38,3,3,16,72,100,15,3,51,80,46,51,12,29,1,3,14,58,80
2012-03-21 00:00:00.000,ATP World Tour Masters 1000 Miami FL; U.S.A. ATP World Tour Masters 1000,HARD,2,Mardy Fish,Frank Dancevic,Mardy Fish,6-3; 7-6(1),R64,82,11,2,27,55,25,27,21,28,0,1,11,46,55,8,5,33,59,28,33,9,26,1,3,10,37,59
2012-03-21 00:00:00.000,ATP World Tour Masters 1000 Miami FL; U.S.A. ATP World Tour Masters 1000,HARD,2,Tomas Berdych,Nicolas Mahut,Tomas Berdych,7-5; 6-1,R64,85,3,3,23,48,19,23,13,25,3,5,9,32,48,4,1,40,67,22,40,10,27,10,16,10,32,67
2012-03-21 00:00:00.000,ATP World Tour Masters 1000 Miami FL; U.S.A. ATP World Tour Masters 1000,HARD,2,Grigor Dimitrov,Juan Ignacio Chela,Grigor Dimitrov,6-2; 4-6; 6-4,R64,118,3,3,47,88,35,47,21,41,5,8,14,56,88,3,4,54,77,37,54,11,23,6,11,14,48,77
2012-03-21 00:00:00.000,ATP World Tour Masters 1000 Miami FL; U.S.A. ATP World Tour Masters 1000,HARD,2,Alexandr Dolgopolov,Antonio Veic,Alexandr Dolgopolov,6-4; 7-5,R64,86,3,2,35,64,30,35,16,29,2,3,11,46,64,1,3,58,80,40,58,6,22,4,7,11,46,80
2012-03-21 00:00:00.000,ATP World Tour Masters 1000 Miami FL; U.S.A. ATP World Tour Masters 1000,HARD,2,Janko Tipsarevic,David Nalbandian,Janko Tipsarevic,7-5; 6-3,R64,105,8,5,29,70,20,29,25,41,4,6,11,45,70,2,3,34,63,23,34,10,29,3,7,10,33,63
2012-03-21 00:00:00.000,ATP World Tour Masters 1000 Miami FL; U.S.A. ATP World Tour Masters 1000,HARD,2,Gilles Simon,Roberto Bautista Agut,Gilles Simon,6-4; 6-2,R64,85,4,0,22,47,17,22,16,25,4,6,9,33,47,0,1,35,54,21,35,6,19,5,10,9,27,54
2012-03-21 00:00:00.000,ATP World Tour Masters 1000 Miami FL; U.S.A. ATP World Tour Masters 1000,HARD,2,Jurgen Melzer,Robin Haase,Jurgen Melzer,7-6(2); 3-6; 6-4,R64,123,9,3,70,98,49,70,15,28,5,8,15,64,98,7,3,52,99,38,52,25,47,5,8,16,63,99
2012-03-21 00:00:00.000,ATP World Tour Masters 1000 Miami FL; U.S.A. ATP World Tour Masters 1000,HARD,2,Milos Raonic,Arnaud Clement,Milos Raonic,7-6(7); 6-2,R64,104,17,2,35,59,28,35,14,24,0,1,10,42,59,1,1,42,85,26,42,22,43,6,9,10,48,85
2012-03-21 00:00:00.000,ATP World Tour Masters 1000 Miami FL; U.S.A. ATP World Tour Masters 1000,HARD,2,Andy Murray,Alejandro Falla,Andy Murray,6-2; 6-3,R64,76,4,2,27,51,18,27,16,24,2,4,9,34,51,0,1,22,49,13,22,8,27,3,8,8,21,49
2012-03-21 00:00:00.000,ATP World Tour Masters 1000 Miami FL; U.S.A. ATP World Tour Masters 1000,HARD,2,Jo-Wilfried Tsonga,Xavier Malisse,Jo-Wilfried Tsonga,7-5; 7-5,R64,97,11,1,36,69,29,36,18,33,4,6,12,47,69,3,2,38,72,25,38,16,34,2,6,12,41,72
2012-03-21 00:00:00.000,ATP World Tour Masters 1000 Miami FL; U.S.A. ATP World Tour Masters 1000,HARD,2,Philipp Kohlschreiber,Frederico Gil,Philipp Kohlschreiber,6-2; 7-5,R64,71,5,0,35,54,31,35,11,19,1,1,10,42,54,2,1,27,53,20,27,12,26,0,3,10,32,53
2012-03-21 00:00:00.000,ATP World Tour Masters 1000 Miami FL; U.S.A. ATP World Tour Masters 1000,HARD,2,Florian Mayer,Ivan Dodig,Florian Mayer,6-4; 7-5,R64,98,4,2,36,61,29,36,14,25,1,2,11,43,61,7,2,42,82,26,42,22,40,5,8,11,48,82
2012-03-21 00:00:00.000,ATP World Tour Masters 1000 Miami FL; U.S.A. ATP World Tour Masters 1000,HARD,2,John Isner,Nikolay Davydenko,John Isner,2-6; 6-3; 6-4,R64,105,12,1,62,87,44,62,13,25,3,5,14,57,87,3,3,55,79,41,55,11,24,1,3,13,52,79
2012-03-21 00:00:00.000,ATP World Tour Masters 1000 Miami FL; U.S.A. ATP World Tour Masters 1000,HARD,2,Kei Nishikori,Lukas Lacko,Kei Nishikori,6-3; 6-3,R64,82,7,1,27,50,23,27,14,23,1,1,9,37,50,2,4,30,62,18,30,16,32,8,11,9,34,62
2012-03-21 00:00:00.000,ATP World Tour Masters 1000 Miami FL; U.S.A. ATP World Tour Masters 1000,HARD,2,Lukas Rosol,Marcel Granollers,Lukas Rosol,2-6; 6-3; 6-1,R64,115,5,4,51,86,38,51,17,35,6,8,12,55,86,3,4,45,88,27,45,20,43,5,9,12,47,88
2012-03-21 00:00:00.000,ATP World Tour Masters 1000 Miami FL; U.S.A. ATP World Tour Masters 1000,HARD,2,Radek Stepanek,Tommy Haas,Radek Stepanek,7-6(4); 6-1,R64,102,5,3,46,70,37,46,10,24,3,4,10,47,70,3,3,34,62,24,34,10,28,2,5,9,34,62
2012-03-21 00:00:00.000,ATP World Tour Masters 1000 Miami FL; U.S.A. ATP World Tour Masters 1000,HARD,2,Rafael Nadal,Santiago Giraldo,Rafael Nadal,6-2; 6-0,R64,69,1,0,26,40,21,26,8,14,1,1,7,29,40,2,0,26,44,10,26,8,18,1,6,7,18,44
2012-03-21 00:00:00.000,ATP World Tour Masters 1000 Miami FL; U.S.A. ATP World Tour Masters 1000,HARD,2,Novak Djokovic,Viktor Troicki,Novak Djokovic,6-3; 6-4,R32,86,2,1,44,67,32,44,14,23,7,8,10,46,67,2,3,36,52,25,36,4,16,5,8,9,29,52
2012-03-21 00:00:00.000,ATP World Tour Masters 1000 Miami FL; U.S.A. ATP World Tour Masters 1000,HARD,2,Richard Gasquet,Albert Ramos-Vinolas,Richard Gasquet,6-2; 5-7; 6-3,R32,154,4,4,55,90,43,55,17,35,3,5,15,60,90,6,4,52,101,34,52,24,49,9,13,14,58,101
2012-03-21 00:00:00.000,ATP World Tour Masters 1000 Miami FL; U.S.A. ATP World Tour Masters 1000,HARD,2,Juan Martin Del Potro,Marin Cilic,Juan Martin Del Potro,6-3; 7-6(3),R32,108,4,0,38,55,30,38,12,17,1,2,10,42,55,6,5,41,79,29,41,15,38,2,5,11,44,79
2012-03-21 00:00:00.000,ATP World Tour Masters 1000 Miami FL; U.S.A. ATP World Tour Masters 1000,HARD,2,David Ferrer,Julien Benneteau,David Ferrer,7-6(5); 6-4,R32,98,3,1,38,64,26,38,17,26,3,6,11,43,64,3,5,51,70,35,51,6,19,1,5,11,41,70
2012-03-21 00:00:00.000,ATP World Tour Masters 1000 Miami FL; U.S.A. ATP World Tour Masters 1000,HARD,2,Andy Roddick,Roger Federer,Andy Roddick,7-6(4); 1-6; 6-4,R32,121,12,2,65,94,48,65,15,29,7,10,15,63,94,11,1,44,75,37,44,19,31,1,2,14,56,75
2012-03-21 00:00:00.000,ATP World Tour Masters 1000 Miami FL; U.S.A. ATP World Tour Masters 1000,HARD,2,Juan Monaco,Gael Monfils,Juan Monaco,4-6; 6-3; 6-4,R32,139,2,2,62,95,43,62,17,33,8,12,15,60,95,8,12,49,96,37,49,16,47,7,12,14,53,96
2012-03-21 00:00:00.000,ATP World Tour Masters 1000 Miami FL; U.S.A. ATP World Tour Masters 1000,HARD,2,Nicolas Almagro,Fernando Verdasco,Nicolas Almagro,6-3; 6-4,R32,77,3,0,31,53,26,31,16,22,2,2,10,42,53,4,4,29,52,21,29,12,23,1,3,9,33,52
2012-03-21 00:00:00.000,ATP World Tour Masters 1000 Miami FL; U.S.A. ATP World Tour Masters 1000,HARD,2,Mardy Fish,Kevin Anderson,Mardy Fish,6-4; 6-3,R32,94,3,0,26,57,18,26,22,31,3,4,9,40,57,4,7,28,57,19,28,12,29,1,5,10,31,57
2012-03-21 00:00:00.000,ATP World Tour Masters 1000 Miami FL; U.S.A. ATP World Tour Masters 1000,HARD,2,Grigor Dimitrov,Tomas Berdych,Grigor Dimitrov,6-3; 2-6; 6-4,R32,136,6,9,50,100,36,50,25,50,5,7,14,61,100,6,2,50,80,39,50,14,30,3,5,13,53,80
2012-03-21 00:00:00.000,ATP World Tour Masters 1000 Miami FL; U.S.A. ATP World Tour Masters 1000,HARD,2,Janko Tipsarevic,Alexandr Dolgopolov,Janko Tipsarevic,6-4; 5-7; 6-2,R32,125,10,3,47,84,33,47,25,37,2,4,15,58,84,8,1,50,93,36,50,19,43,5,9,15,55,93
2012-03-21 00:00:00.000,ATP World Tour Masters 1000 Miami FL; U.S.A. ATP World Tour Masters 1000,HARD,2,Gilles Simon,Jurgen Melzer,Gilles Simon,7-6(5); 6-4,R32,99,3,0,30,59,22,30,23,29,0,1,11,45,59,3,1,50,69,38,50,7,19,5,7,11,45,69
2012-03-21 00:00:00.000,ATP World Tour Masters 1000 Miami FL; U.S.A. ATP World Tour Masters 1000,HARD,2,Andy Murray,Milos Raonic,Andy Murray,W/O,R32,0,0,0,0,0,0,0,0,0,0,0,0,0,0,0,0,0,0,0,0,0,0,0,0,0,0,0
2012-03-21 00:00:00.000,ATP World Tour Masters 1000 Miami FL; U.S.A. ATP World Tour Masters 1000,HARD,2,Jo-Wilfried Tsonga,Philipp Kohlschreiber,Jo-Wilfried Tsonga,6-4; 7-6(2),R32,102,12,2,33,79,27,33,27,46,4,5,11,54,79,1,2,35,66,27,35,15,31,0,2,11,42,66
2012-03-21 00:00:00.000,ATP World Tour Masters 1000 Miami FL; U.S.A. ATP World Tour Masters 1000,HARD,2,Florian Mayer,John Isner,Florian Mayer,6-4; 6-2,R32,68,1,0,26,46,23,26,13,20,0,0,9,36,46,6,1,37,59,24,37,12,22,7,10,9,36,59
2012-03-21 00:00:00.000,ATP World Tour Masters 1000 Miami FL; U.S.A. ATP World Tour Masters 1000,HARD,2,Kei Nishikori,Lukas Rosol,Kei Nishikori,6-4; 6-2,R32,69,3,2,28,46,22,28,14,18,0,0,9,36,46,3,0,32,53,21,32,11,21,3,6,9,32,53
2012-03-21 00:00:00.000,ATP World Tour Masters 1000 Miami FL; U.S.A. ATP World Tour Masters 1000,HARD,2,Rafael Nadal,Radek Stepanek,Rafael Nadal,6-2; 6-2,R32,87,3,0,38,54,28,38,8,16,2,2,8,36,54,1,3,28,45,14,28,8,17,3,7,8,22,45
2012-03-21 00:00:00.000,ATP World Tour Masters 1000 Miami FL; U.S.A. ATP World Tour Masters 1000,HARD,2,Novak Djokovic,Richard Gasquet,Novak Djokovic,7-5; 6-3,R16,100,6,0,38,65,30,38,15,27,6,7,11,45,65,2,0,44,71,30,44,11,27,7,10,10,41,71
2012-03-21 00:00:00.000,ATP World Tour Masters 1000 Miami FL; U.S.A. ATP World Tour Masters 1000,HARD,2,David Ferrer,Juan Martin Del Potro,David Ferrer,6-3; 6-3,R16,96,4,1,44,65,34,44,10,21,2,2,9,44,65,3,3,42,59,26,42,7,17,4,7,9,33,59
2012-03-21 00:00:00.000,ATP World Tour Masters 1000 Miami FL; U.S.A. ATP World Tour Masters 1000,HARD,2,Juan Monaco,Andy Roddick,Juan Monaco,7-5; 6-0,R16,101,2,2,46,63,31,46,9,17,3,4,9,40,63,2,2,36,59,21,36,9,23,4,9,9,30,59
2012-03-21 00:00:00.000,ATP World Tour Masters 1000 Miami FL; U.S.A. ATP World Tour Masters 1000,HARD,2,Mardy Fish,Nicolas Almagro,Mardy Fish,6-3; 6-7(2); 6-3,R16,155,16,3,53,99,51,53,21,46,7,8,16,72,99,14,1,48,102,35,48,28,54,6,9,14,63,102
2012-03-21 00:00:00.000,ATP World Tour Masters 1000 Miami FL; U.S.A. ATP World Tour Masters 1000,HARD,2,Janko Tipsarevic,Grigor Dimitrov,Janko Tipsarevic,7-6(3); 6-2,R16,81,6,1,27,52,25,27,19,25,0,0,10,44,52,10,3,36,59,30,36,8,23,0,2,10,38,59
2012-03-21 00:00:00.000,ATP World Tour Masters 1000 Miami FL; U.S.A. ATP World Tour Masters 1000,HARD,2,Andy Murray,Gilles Simon,Andy Murray,6-3; 6-4,R16,106,4,0,36,64,25,36,22,28,3,3,10,47,64,1,0,22,54,13,22,20,32,4,6,9,33,54
2012-03-21 00:00:00.000,ATP World Tour Masters 1000 Miami FL; U.S.A. ATP World Tour Masters 1000,HARD,2,Jo-Wilfried Tsonga,Florian Mayer,Jo-Wilfried Tsonga,6-3; 6-2,R16,54,8,2,22,42,21,22,15,20,0,0,9,36,42,1,0,34,51,18,34,10,17,4,7,8,28,51
2012-03-21 00:00:00.000,ATP World Tour Masters 1000 Miami FL; U.S.A. ATP World Tour Masters 1000,HARD,2,Rafael Nadal,Kei Nishikori,Rafael Nadal,6-4; 6-4,R16,130,3,3,40,65,31,40,11,25,6,8,10,42,65,1,3,45,74,26,45,14,29,6,10,10,40,74
2012-03-21 00:00:00.000,ATP World Tour Masters 1000 Miami FL; U.S.A. ATP World Tour Masters 1000,HARD,2,Novak Djokovic,David Ferrer,Novak Djokovic,6-2; 7-6(1),Q,113,5,1,39,70,29,39,17,31,2,4,10,46,70,2,2,40,64,25,40,8,24,3,7,10,33,64
2012-03-21 00:00:00.000,ATP World Tour Masters 1000 Miami FL; U.S.A. ATP World Tour Masters 1000,HARD,2,Juan Monaco,Mardy Fish,Juan Monaco,6-1; 6-3,Q,83,0,0,38,46,27,38,5,8,0,1,8,32,46,1,1,27,57,14,27,12,30,4,9,8,26,57
2012-03-21 00:00:00.000,ATP World Tour Masters 1000 Miami FL; U.S.A. ATP World Tour Masters 1000,HARD,2,Andy Murray,Janko Tipsarevic,Andy Murray,4-6; 6-3; 6-4,Q,159,6,2,50,95,33,50,24,45,5,10,15,57,95,7,1,52,86,36,52,11,34,2,8,14,47,86
2012-03-21 00:00:00.000,ATP World Tour Masters 1000 Miami FL; U.S.A. ATP World Tour Masters 1000,HARD,2,Rafael Nadal,Jo-Wilfried Tsonga,Rafael Nadal,6-2; 5-7; 6-4,Q,170,0,2,67,104,43,67,23,37,8,10,15,66,104,7,4,57,101,44,57,18,44,8,12,15,62,101
2012-03-21 00:00:00.000,ATP World Tour Masters 1000 Miami FL; U.S.A. ATP World Tour Masters 1000,HARD,2,Novak Djokovic,Juan Monaco,Novak Djokovic,6-0; 7-6(5),S,123,2,4,32,65,22,32,22,33,7,8,9,44,65,2,1,47,70,29,47,9,23,7,11,9,38,70
2012-03-21 00:00:00.000,ATP World Tour Masters 1000 Miami FL; U.S.A. ATP World Tour Masters 1000,HARD,2,Andy Murray,Rafael Nadal,Andy Murray,W/O,S,0,0,0,0,0,0,0,0,0,0,0,0,0,0,0,0,0,0,0,0,0,0,0,0,0,0,0
2012-03-21 00:00:00.000,ATP World Tour Masters 1000 Miami FL; U.S.A. ATP World Tour Masters 1000,HARD,2,Novak Djokovic,Andy Murray,Novak Djokovic,6-1; 7-6(4),F,138,5,2,47,71,35,47,15,24,1,1,10,50,71,6,3,47,85,29,47,20,38,6,8,9,49,85
2012-04-09 00:00:00.000,Casablanca Morocco ATP World Tour 250,CLAY,2,Florian Mayer,N/A Bye,Florian Mayer,,R32,0,0,0,0,0,0,0,0,0,0,0,0,0,0,0,0,0,0,0,0,0,0,0,0,0,0,0
2012-04-09 00:00:00.000,Casablanca Morocco ATP World Tour 250,CLAY,2,Jeremy Chardy,Federico Delbonis,Jeremy Chardy,6-4; 7-5,R32,100,3,5,42,79,29,42,22,37,8,9,11,51,79,2,8,41,66,29,41,10,25,1,4,11,39,66
2012-04-09 00:00:00.000,Casablanca Morocco ATP World Tour 250,CLAY,2,Victor Hanescu,Malek Jaziri,Victor Hanescu,6-2; 3-0 RET,R32,52,2,0,26,31,19,26,2,5,0,1,5,21,31,4,2,24,45,9,24,9,21,6,11,6,18,45
2012-04-09 00:00:00.000,Casablanca Morocco ATP World Tour 250,CLAY,2,Albert Ramos-Vinolas,Pere Riba,Albert Ramos-Vinolas,6-2; 6-3,R32,74,1,6,31,51,26,31,7,20,2,3,8,33,51,3,6,27,57,15,27,12,30,3,8,9,27,57
2012-04-09 00:00:00.000,Casablanca Morocco ATP World Tour 250,CLAY,2,Denis Istomin,N/A Bye,Denis Istomin,,R32,0,0,0,0,0,0,0,0,0,0,0,0,0,0,0,0,0,0,0,0,0,0,0,0,0,0,0
2012-04-09 00:00:00.000,Casablanca Morocco ATP World Tour 250,CLAY,2,Igor Andreev,Albert Montanes,Igor Andreev,6-3; 6-3,R32,76,0,5,31,57,26,31,14,26,4,4,9,40,57,3,7,31,64,20,31,15,33,2,5,9,35,64
2012-04-09 00:00:00.000,Casablanca Morocco ATP World Tour 250,CLAY,2,Paul-Henri Mathieu,Mehdi Ziadi,Paul-Henri Mathieu,6-3; 6-1,R32,67,1,2,26,48,20,26,12,22,0,1,8,32,48,4,4,21,44,13,21,6,23,1,6,8,19,44
2012-04-09 00:00:00.000,Casablanca Morocco ATP World Tour 250,CLAY,2,Guillermo Garcia-Lopez,Fabio Fognini,Guillermo Garcia-Lopez,6-4; 3-6; 7-5,R32,129,1,3,66,98,42,66,18,32,6,9,15,60,98,0,2,50,84,32,50,22,34,3,7,16,54,84
2012-04-09 00:00:00.000,Casablanca Morocco ATP World Tour 250,CLAY,2,Lamine Ouahab,Robin Haase,Lamine Ouahab,6-3; 6-2,R32,60,1,0,27,50,19,27,15,23,1,2,9,34,50,3,2,24,40,18,24,3,16,0,4,8,21,40
2012-04-09 00:00:00.000,Casablanca Morocco ATP World Tour 250,CLAY,2,Sergio Gutierrez-Ferrol,Rui Machado,Sergio Gutierrez-Ferrol,6-2; 6-1,R32,71,5,2,28,62,19,28,19,34,5,6,8,38,62,0,4,28,40,12,28,4,12,1,6,7,16,40
2012-04-09 00:00:00.000,Casablanca Morocco ATP World Tour 250,CLAY,2,Potito Starace,Roberto Bautista Agut,Potito Starace,6-4; 7-5,R32,114,2,2,61,85,39,61,11,24,6,8,11,50,85,1,1,44,73,26,44,15,29,7,11,11,41,73
2012-04-09 00:00:00.000,Casablanca Morocco ATP World Tour 250,CLAY,2,Pablo Andujar,N/A Bye,Pablo Andujar,,R32,0,0,0,0,0,0,0,0,0,0,0,0,0,0,0,0,0,0,0,0,0,0,0,0,0,0,0
2012-04-09 00:00:00.000,Casablanca Morocco ATP World Tour 250,CLAY,2,Benoit Paire,Donald Young,Benoit Paire,4-6; 7-6(5); 6-2,R32,120,3,9,57,115,39,57,27,58,8,13,15,66,115,2,7,58,105,37,58,21,47,8,14,15,58,105
2012-04-09 00:00:00.000,Casablanca Morocco ATP World Tour 250,CLAY,2,Matthias Bachinger,Filippo Volandri,Matthias Bachinger,6-3; 3-6; 6-3,R32,115,5,7,48,98,36,48,22,50,7,10,14,58,98,0,5,63,84,40,63,9,21,5,9,13,49,84
2012-04-09 00:00:00.000,Casablanca Morocco ATP World Tour 250,CLAY,2,Flavio Cipolla,Yassine Idmbarek,Flavio Cipolla,6-1; 2-6; 6-1,R32,102,0,1,39,62,23,39,12,23,0,4,11,35,62,0,6,76,97,37,76,7,21,6,13,11,44,97
2012-04-09 00:00:00.000,Casablanca Morocco ATP World Tour 250,CLAY,2,Alexandr Dolgopolov,N/A Bye,Alexandr Dolgopolov,,R32,0,0,0,0,0,0,0,0,0,0,0,0,0,0,0,0,0,0,0,0,0,0,0,0,0,0,0
2012-04-09 00:00:00.000,Casablanca Morocco ATP World Tour 250,CLAY,2,Jeremy Chardy,Florian Mayer,Jeremy Chardy,6-3; 6-1,R16,58,6,3,22,42,18,22,8,20,0,2,8,26,42,1,2,35,54,17,35,4,19,5,11,8,21,54
2012-04-09 00:00:00.000,Casablanca Morocco ATP World Tour 250,CLAY,2,Albert Ramos-Vinolas,Victor Hanescu,Albert Ramos-Vinolas,6-2; 6-4,R16,83,4,1,25,56,18,25,23,31,1,1,9,41,56,2,0,41,56,23,41,8,15,1,4,9,31,56
2012-04-09 00:00:00.000,Casablanca Morocco ATP World Tour 250,CLAY,2,Igor Andreev,Denis Istomin,Igor Andreev,6-7(3); 6-3; 6-2,R16,137,4,5,62,103,44,62,26,41,8,9,15,70,103,6,2,54,88,37,54,18,34,6,10,14,55,88
2012-04-09 00:00:00.000,Casablanca Morocco ATP World Tour 250,CLAY,2,Guillermo Garcia-Lopez,Paul-Henri Mathieu,Guillermo Garcia-Lopez,6-4; 6-2,R16,98,2,2,39,62,27,39,12,23,3,4,9,39,62,0,4,26,54,16,26,12,28,2,6,9,28,54
2012-04-09 00:00:00.000,Casablanca Morocco ATP World Tour 250,CLAY,2,Sergio Gutierrez-Ferrol,Lamine Ouahab,Sergio Gutierrez-Ferrol,6-4; 6-1,R16,60,8,5,26,48,23,26,9,22,3,4,8,32,48,0,3,33,54,19,33,8,21,2,7,9,27,54
2012-04-09 00:00:00.000,Casablanca Morocco ATP World Tour 250,CLAY,2,Pablo Andujar,Potito Starace,Pablo Andujar,6-3; 6-0,R16,69,1,3,26,43,17,26,11,17,3,4,7,28,43,1,2,30,56,16,30,7,26,6,12,8,23,56
2012-04-09 00:00:00.000,Casablanca Morocco ATP World Tour 250,CLAY,2,Benoit Paire,Matthias Bachinger,Benoit Paire,6-7(3); 6-3; 6-2,R16,155,8,4,59,128,43,59,32,69,12,14,15,75,128,7,3,50,107,38,50,23,57,12,17,14,61,107
2012-04-09 00:00:00.000,Casablanca Morocco ATP World Tour 250,CLAY,2,Flavio Cipolla,Alexandr Dolgopolov,Flavio Cipolla,6-4; 6-1,R16,63,1,3,35,47,27,35,7,12,0,0,8,34,47,3,2,22,46,14,22,11,24,1,5,9,25,46
2012-04-09 00:00:00.000,Casablanca Morocco ATP World Tour 250,CLAY,2,Albert Ramos-Vinolas,Jeremy Chardy,Albert Ramos-Vinolas,6-3; 6-4,Q,99,1,2,41,64,25,41,14,23,2,4,10,39,64,5,2,42,85,25,42,18,43,7,11,9,43,85
2012-04-09 00:00:00.000,Casablanca Morocco ATP World Tour 250,CLAY,2,Igor Andreev,Guillermo Garcia-Lopez,Igor Andreev,6-4; 6-2,Q,87,3,1,28,45,23,28,11,17,1,2,9,34,45,0,8,40,70,24,40,13,30,9,13,9,37,70
2012-04-09 00:00:00.000,Casablanca Morocco ATP World Tour 250,CLAY,2,Pablo Andujar,Sergio Gutierrez-Ferrol,Pablo Andujar,6-4; 1-6; 6-3,Q,93,0,4,39,71,28,39,18,32,1,5,13,46,71,9,2,41,74,31,41,13,33,2,6,13,44,74
2012-04-09 00:00:00.000,Casablanca Morocco ATP World Tour 250,CLAY,2,Flavio Cipolla,Benoit Paire,Flavio Cipolla,6-3; 6-4,Q,93,1,2,55,72,38,55,5,17,10,12,9,43,72,3,6,27,66,18,27,14,39,4,9,10,32,66
2012-04-09 00:00:00.000,Casablanca Morocco ATP World Tour 250,CLAY,2,Albert Ramos-Vinolas,Igor Andreev,Albert Ramos-Vinolas,6-3; 7-6(7),S,113,1,3,52,89,37,52,20,37,8,9,11,57,89,5,1,42,64,30,42,12,22,0,2,10,42,64
2012-04-09 00:00:00.000,Casablanca Morocco ATP World Tour 250,CLAY,2,Pablo Andujar,Flavio Cipolla,Pablo Andujar,6-3; 7-5,S,115,0,5,56,90,35,56,16,34,7,10,11,51,90,0,3,48,64,27,48,6,16,6,11,10,33,64
2012-04-09 00:00:00.000,Casablanca Morocco ATP World Tour 250,CLAY,2,Pablo Andujar,Albert Ramos-Vinolas,Pablo Andujar,6-1; 7-6(5),F,106,1,6,57,82,40,57,11,25,3,4,9,51,82,0,0,29,55,15,29,14,26,0,4,10,29,55
2012-04-09 00:00:00.000,Houston TX; U.S.A. ATP World Tour 250,CLAY,2,Mardy Fish,N/A Bye,Mardy Fish,,R32,0,0,0,0,0,0,0,0,0,0,0,0,0,0,0,0,0,0,0,0,0,0,0,0,0,0,0
2012-04-09 00:00:00.000,Houston TX; U.S.A. ATP World Tour 250,CLAY,2,Michael Russell,Daniel Gimeno-Traver,Michael Russell,2-6; 7-5; 6-1,R32,113,0,2,49,74,37,49,12,25,1,4,14,49,74,6,5,47,82,35,47,15,35,2,6,13,50,82
2012-04-09 00:00:00.000,Houston TX; U.S.A. ATP World Tour 250,CLAY,2,Igor Kunitsyn,Xavier Malisse,Igor Kunitsyn,6-4; 6-2,R32,72,7,2,30,48,24,30,11,18,2,3,9,35,48,8,6,32,61,21,32,11,29,3,7,9,32,61
2012-04-09 00:00:00.000,Houston TX; U.S.A. ATP World Tour 250,CLAY,2,Ryan Harrison,Alex Bogomolov Jr.,Ryan Harrison,4-6; 6-3; 6-4,R32,138,13,2,67,107,47,67,22,40,9,11,15,69,107,0,2,65,85,43,65,12,20,5,8,14,55,85
2012-04-09 00:00:00.000,Houston TX; U.S.A. ATP World Tour 250,CLAY,2,Juan Monaco,N/A Bye,Juan Monaco,,R32,0,0,0,0,0,0,0,0,0,0,0,0,0,0,0,0,0,0,0,0,0,0,0,0,0,0,0
2012-04-09 00:00:00.000,Houston TX; U.S.A. ATP World Tour 250,CLAY,2,Tatsuma Ito,Go Soeda,Tatsuma Ito,6-4; 7-5,R32,112,4,3,49,80,34,49,13,31,6,10,11,47,80,2,1,36,69,18,36,14,33,4,10,11,32,69
2012-04-09 00:00:00.000,Houston TX; U.S.A. ATP World Tour 250,CLAY,2,Sam Querrey,Eric Prodon,Sam Querrey,6-1; 6-4,R32,58,6,0,26,44,22,26,15,18,0,0,9,37,44,3,2,40,58,24,40,8,18,5,8,8,32,58
2012-04-09 00:00:00.000,Houston TX; U.S.A. ATP World Tour 250,CLAY,2,Kevin Anderson,Joao Souza,Kevin Anderson,6-3; 6-4,R32,114,5,5,33,61,24,33,13,28,3,6,10,37,61,4,3,37,62,19,37,11,25,2,7,9,30,62
2012-04-09 00:00:00.000,Houston TX; U.S.A. ATP World Tour 250,CLAY,2,Carlos Berlocq,James Blake,Carlos Berlocq,6-4; 2-6; 6-1,R32,124,3,8,58,79,39,58,9,21,7,10,12,48,79,0,3,42,85,22,42,23,43,3,8,13,45,85
2012-04-09 00:00:00.000,Houston TX; U.S.A. ATP World Tour 250,CLAY,2,Bjorn Phau,Diego Junqueira,Bjorn Phau,6-1; 3-0 RET,R32,48,1,3,18,33,13,18,10,15,3,3,5,23,33,0,1,15,27,4,15,5,12,3,7,5,9,27
2012-04-09 00:00:00.000,Houston TX; U.S.A. ATP World Tour 250,CLAY,2,Paolo Lorenzi,Wayne Odesnik,Paolo Lorenzi,6-7(3); 6-2; 6-3,R32,165,5,1,73,96,51,73,12,23,3,5,15,63,96,5,1,57,88,34,57,17,31,9,14,14,51,88
2012-04-09 00:00:00.000,Houston TX; U.S.A. ATP World Tour 250,CLAY,2,Feliciano Lopez,N/A Bye,Feliciano Lopez,,R32,0,0,0,0,0,0,0,0,0,0,0,0,0,0,0,0,0,0,0,0,0,0,0,0,0,0,0
2012-04-09 00:00:00.000,Houston TX; U.S.A. ATP World Tour 250,CLAY,2,Bobby Reynolds,Ivo Karlovic,Bobby Reynolds,7-6(5); 2-6; 6-3,R32,137,5,4,63,97,44,63,20,34,2,5,15,64,97,19,4,53,89,38,53,21,36,4,6,14,59,89
2012-04-09 00:00:00.000,Houston TX; U.S.A. ATP World Tour 250,CLAY,2,Ryan Sweeting,Ricardo Mello,Ryan Sweeting,6-3; 7-6(6),R32,109,6,6,43,84,34,43,18,41,7,9,11,52,84,1,4,48,77,30,48,14,29,5,8,10,44,77
2012-04-09 00:00:00.000,Houston TX; U.S.A. ATP World Tour 250,CLAY,2,Horacio Zeballos,Adrian Ungur,Horacio Zeballos,6-3; 6-3,R32,90,5,0,31,54,23,31,16,23,1,1,9,39,54,0,3,35,66,23,35,15,31,7,10,9,38,66
2012-04-09 00:00:00.000,Houston TX; U.S.A. ATP World Tour 250,CLAY,2,John Isner,N/A Bye,John Isner,,R32,0,0,0,0,0,0,0,0,0,0,0,0,0,0,0,0,0,0,0,0,0,0,0,0,0,0,0
2012-04-09 00:00:00.000,Houston TX; U.S.A. ATP World Tour 250,CLAY,2,Michael Russell,Mardy Fish,Michael Russell,6-3; 6-1,R16,74,1,1,37,53,26,37,9,16,1,2,8,35,53,3,5,27,52,15,27,7,25,3,8,8,22,52
2012-04-09 00:00:00.000,Houston TX; U.S.A. ATP World Tour 250,CLAY,2,Ryan Harrison,Igor Kunitsyn,Ryan Harrison,6-2; 6-4,R16,71,5,1,32,51,26,32,13,19,1,1,9,39,51,0,3,37,60,24,37,10,23,4,7,9,34,60
2012-04-09 00:00:00.000,Houston TX; U.S.A. ATP World Tour 250,CLAY,2,Juan Monaco,Tatsuma Ito,Juan Monaco,6-3; 6-3,R16,98,1,2,31,60,23,31,16,29,6,7,9,39,60,2,1,32,64,18,32,16,32,6,10,9,34,64
2012-04-09 00:00:00.000,Houston TX; U.S.A. ATP World Tour 250,CLAY,2,Kevin Anderson,Sam Querrey,Kevin Anderson,7-6(3); 3-6; 7-6(2),R16,162,13,7,70,116,56,70,20,46,8,10,16,76,116,11,4,64,121,52,64,30,57,8,9,17,82,121
2012-04-09 00:00:00.000,Houston TX; U.S.A. ATP World Tour 250,CLAY,2,Carlos Berlocq,Bjorn Phau,Carlos Berlocq,6-1; 6-0,R16,60,2,0,25,33,20,25,4,8,0,1,7,24,33,0,3,21,42,10,21,4,21,3,9,6,14,42
2012-04-09 00:00:00.000,Houston TX; U.S.A. ATP World Tour 250,CLAY,2,Feliciano Lopez,Paolo Lorenzi,Feliciano Lopez,6-4; 7-6(4),R16,117,13,4,38,75,28,38,19,37,3,6,11,47,75,2,5,43,77,27,43,16,34,4,8,11,43,77
2012-04-09 00:00:00.000,Houston TX; U.S.A. ATP World Tour 250,CLAY,2,Ryan Sweeting,Bobby Reynolds,Ryan Sweeting,6-3; 6-2,R16,71,2,1,34,45,32,34,4,11,0,0,9,36,45,1,0,45,58,27,45,5,13,8,11,8,32,58
2012-04-09 00:00:00.000,Houston TX; U.S.A. ATP World Tour 250,CLAY,2,John Isner,Horacio Zeballos,John Isner,6-7(3); 6-4; 6-2,R16,133,16,4,55,88,42,55,22,33,1,1,15,64,88,4,4,58,98,39,58,24,40,7,10,15,63,98
2012-04-09 00:00:00.000,Houston TX; U.S.A. ATP World Tour 250,CLAY,2,Michael Russell,Ryan Harrison,Michael Russell,6-1; 5-7; 6-3,Q,135,0,6,55,83,39,55,14,28,2,4,14,53,83,4,4,49,87,28,49,22,38,5,10,14,50,87
2012-04-09 00:00:00.000,Houston TX; U.S.A. ATP World Tour 250,CLAY,2,Juan Monaco,Kevin Anderson,Juan Monaco,7-6(4); 7-5,Q,128,3,2,47,71,39,47,12,24,0,1,12,51,71,6,3,44,77,31,44,19,33,3,5,12,50,77
2012-04-09 00:00:00.000,Houston TX; U.S.A. ATP World Tour 250,CLAY,2,Feliciano Lopez,Carlos Berlocq,Feliciano Lopez,6-4; 2-2 RET,Q,78,7,1,19,41,16,19,14,22,3,3,7,30,41,0,3,30,42,19,30,6,12,0,1,7,25,42
2012-04-09 00:00:00.000,Houston TX; U.S.A. ATP World Tour 250,CLAY,2,John Isner,Ryan Sweeting,John Isner,7-6(1); 7-6(4),Q,105,11,0,56,78,50,56,12,22,6,6,12,62,78,5,5,42,77,34,42,21,35,3,3,12,55,77
2012-04-09 00:00:00.000,Houston TX; U.S.A. ATP World Tour 250,CLAY,2,Juan Monaco,Michael Russell,Juan Monaco,5-7; 6-1; 6-4,S,145,3,3,49,78,33,49,17,29,1,4,14,50,78,0,3,59,90,31,59,19,31,5,11,15,50,90
2012-04-09 00:00:00.000,Houston TX; U.S.A. ATP World Tour 250,CLAY,2,John Isner,Feliciano Lopez,John Isner,6-7(5); 7-6(4); 6-3,S,157,13,1,94,129,69,94,20,35,8,8,17,89,129,9,4,53,105,44,53,31,52,4,5,16,75,105
2012-04-09 00:00:00.000,Houston TX; U.S.A. ATP World Tour 250,CLAY,2,Juan Monaco,John Isner,Juan Monaco,6-2; 3-6; 6-3,F,148,0,4,56,84,41,56,16,28,8,9,13,57,84,8,5,70,103,46,70,15,33,12,15,13,61,103
2012-04-15 00:00:00.000,ATP World Tour Masters 1000 Monte Carlo Monaco ATP World Tour Masters 1000,CLAY,2,Novak Djokovic,N/A Bye,Novak Djokovic,,R64,0,0,0,0,0,0,0,0,0,0,0,0,0,0,0,0,0,0,0,0,0,0,0,0,0,0,0
2012-04-15 00:00:00.000,ATP World Tour Masters 1000 Monte Carlo Monaco ATP World Tour Masters 1000,CLAY,2,Andreas Seppi,Victor Hanescu,Andreas Seppi,6-3; 6-1,R64,61,5,2,38,56,28,38,7,18,3,4,8,35,56,1,2,31,41,16,31,1,10,2,7,8,17,41
2012-04-15 00:00:00.000,ATP World Tour Masters 1000 Monte Carlo Monaco ATP World Tour Masters 1000,CLAY,2,Bernard Tomic,Denis Istomin,Bernard Tomic,6-4; 6-3,R64,62,1,0,32,45,27,32,9,13,0,0,9,36,45,4,2,49,64,32,49,6,15,3,6,10,38,64
2012-04-15 00:00:00.000,ATP World Tour Masters 1000 Monte Carlo Monaco ATP World Tour Masters 1000,CLAY,2,Alexandr Dolgopolov,Juan Ignacio Chela,Alexandr Dolgopolov,6-2; 6-2,R64,58,4,0,27,43,21,27,11,16,0,0,8,32,43,0,2,25,49,16,25,8,24,1,5,8,24,49
2012-04-15 00:00:00.000,ATP World Tour Masters 1000 Monte Carlo Monaco ATP World Tour Masters 1000,CLAY,2,Robin Haase,Juan Monaco,Robin Haase,7-5; 0-6; 2-3 RET,R64,120,4,2,52,87,32,52,15,35,7,12,12,47,87,0,1,43,60,28,43,11,17,0,2,11,39,60
2012-04-15 00:00:00.000,ATP World Tour Masters 1000 Monte Carlo Monaco ATP World Tour Masters 1000,CLAY,2,Fabio Fognini,Michael Llodra,Fabio Fognini,7-5; 6-3,R64,76,0,1,39,54,28,39,9,15,0,1,10,37,54,2,3,31,61,20,31,15,30,4,8,11,35,61
2012-04-15 00:00:00.000,ATP World Tour Masters 1000 Monte Carlo Monaco ATP World Tour Masters 1000,CLAY,2,Thomaz Bellucci,Kevin Anderson,Thomaz Bellucci,6-4; 6-4,R64,87,5,1,37,60,29,37,14,23,2,2,10,43,60,7,6,38,69,25,38,16,31,3,5,10,41,69
2012-04-15 00:00:00.000,ATP World Tour Masters 1000 Monte Carlo Monaco ATP World Tour Masters 1000,CLAY,2,David Ferrer,N/A Bye,David Ferrer,,R64,0,0,0,0,0,0,0,0,0,0,0,0,0,0,0,0,0,0,0,0,0,0,0,0,0,0,0
2012-04-15 00:00:00.000,ATP World Tour Masters 1000 Monte Carlo Monaco ATP World Tour Masters 1000,CLAY,2,Andy Murray,N/A Bye,Andy Murray,,R64,0,0,0,0,0,0,0,0,0,0,0,0,0,0,0,0,0,0,0,0,0,0,0,0,0,0,0
2012-04-15 00:00:00.000,ATP World Tour Masters 1000 Monte Carlo Monaco ATP World Tour Masters 1000,CLAY,2,Viktor Troicki,Jean-Rene Lisnard,Viktor Troicki,6-3; 6-1,R64,58,3,1,23,42,17,23,11,19,0,1,8,28,42,0,0,23,42,10,23,8,19,2,7,8,18,42
2012-04-15 00:00:00.000,ATP World Tour Masters 1000 Monte Carlo Monaco ATP World Tour Masters 1000,CLAY,2,Julien Benneteau,Marcel Granollers,Julien Benneteau,6-3; 3-6; 6-2,R64,130,0,3,57,77,37,57,8,20,3,7,13,45,77,1,0,47,77,26,47,14,30,4,10,13,40,77
2012-04-15 00:00:00.000,ATP World Tour Masters 1000 Monte Carlo Monaco ATP World Tour Masters 1000,CLAY,2,Jurgen Melzer,Lukasz Kubot,Jurgen Melzer,6-2; 7-5,R64,98,3,2,38,58,29,38,9,20,3,5,10,38,58,2,3,52,75,31,52,6,23,6,11,10,37,75
2012-04-15 00:00:00.000,ATP World Tour Masters 1000 Monte Carlo Monaco ATP World Tour Masters 1000,CLAY,2,Kei Nishikori,Albert Ramos-Vinolas,Kei Nishikori,6-2; 7-5,R64,109,0,1,34,55,26,34,11,21,2,4,10,37,55,1,5,57,84,30,57,11,27,12,17,10,41,84
2012-04-15 00:00:00.000,ATP World Tour Masters 1000 Monte Carlo Monaco ATP World Tour Masters 1000,CLAY,2,Paul-Henri Mathieu,Donald Young,Paul-Henri Mathieu,6-0; 6-1,R64,68,0,4,27,52,20,27,13,25,4,4,6,33,52,1,2,26,42,9,26,6,16,3,9,7,15,42
2012-04-15 00:00:00.000,ATP World Tour Masters 1000 Monte Carlo Monaco ATP World Tour Masters 1000,CLAY,2,Marin Cilic,Simone Bolelli,Marin Cilic,6-3; 6-4,R64,90,9,0,42,61,33,42,11,19,3,3,10,44,61,1,1,47,60,32,47,4,13,3,5,9,36,60
2012-04-15 00:00:00.000,ATP World Tour Masters 1000 Monte Carlo Monaco ATP World Tour Masters 1000,CLAY,2,Tomas Berdych,N/A Bye,Tomas Berdych,,R64,0,0,0,0,0,0,0,0,0,0,0,0,0,0,0,0,0,0,0,0,0,0,0,0,0,0,0
2012-04-15 00:00:00.000,ATP World Tour Masters 1000 Monte Carlo Monaco ATP World Tour Masters 1000,CLAY,2,Janko Tipsarevic,N/A Bye,Janko Tipsarevic,,R64,0,0,0,0,0,0,0,0,0,0,0,0,0,0,0,0,0,0,0,0,0,0,0,0,0,0,0
2012-04-15 00:00:00.000,ATP World Tour Masters 1000 Monte Carlo Monaco ATP World Tour Masters 1000,CLAY,2,Albert Montanes,Milos Raonic,Albert Montanes,6-2; 3-6; 6-3,R64,108,0,3,53,73,38,53,11,20,3,5,13,49,73,9,5,45,78,27,45,19,33,2,6,13,46,78
2012-04-15 00:00:00.000,ATP World Tour Masters 1000 Monte Carlo Monaco ATP World Tour Masters 1000,CLAY,2,Frederico Gil,Mikhail Youzhny,Frederico Gil,6-1; 6-3,R64,65,1,0,31,45,24,31,10,14,2,2,8,34,45,2,0,30,51,16,30,8,21,1,5,8,24,51
2012-04-15 00:00:00.000,ATP World Tour Masters 1000 Monte Carlo Monaco ATP World Tour Masters 1000,CLAY,2,Gilles Simon,Benjamin Balleret,Gilles Simon,6-3; 6-2,R64,79,2,2,22,52,14,22,23,30,1,2,9,37,52,3,1,41,70,23,41,12,29,6,10,8,35,70
2012-04-15 00:00:00.000,ATP World Tour Masters 1000 Monte Carlo Monaco ATP World Tour Masters 1000,CLAY,2,Fernando Verdasco,Olivier Rochus,Fernando Verdasco,4-6; 6-2; 7-5,R64,130,3,1,65,82,47,65,11,17,2,4,15,58,82,2,2,65,106,38,65,24,41,5,9,15,62,106
2012-04-15 00:00:00.000,ATP World Tour Masters 1000 Monte Carlo Monaco ATP World Tour Masters 1000,CLAY,2,Ivan Dodig,Ivan Ljubicic,Ivan Dodig,6-0; 6-3,R64,72,1,2,21,41,17,21,10,20,3,4,7,27,41,3,3,23,58,14,23,11,35,4,10,8,25,58
2012-04-15 00:00:00.000,ATP World Tour Masters 1000 Monte Carlo Monaco ATP World Tour Masters 1000,CLAY,2,Philipp Kohlschreiber,Guillaume Rufin,Philipp Kohlschreiber,6-4; 6-4,R64,89,1,1,30,60,15,30,27,30,3,4,10,42,60,2,1,34,65,22,34,17,31,7,10,10,39,65
2012-04-15 00:00:00.000,ATP World Tour Masters 1000 Monte Carlo Monaco ATP World Tour Masters 1000,CLAY,2,Jo-Wilfried Tsonga,N/A Bye,Jo-Wilfried Tsonga,,R64,0,0,0,0,0,0,0,0,0,0,0,0,0,0,0,0,0,0,0,0,0,0,0,0,0,0,0
2012-04-15 00:00:00.000,ATP World Tour Masters 1000 Monte Carlo Monaco ATP World Tour Masters 1000,CLAY,2,Nicolas Almagro,N/A Bye,Nicolas Almagro,,R64,0,0,0,0,0,0,0,0,0,0,0,0,0,0,0,0,0,0,0,0,0,0,0,0,0,0,0
2012-04-15 00:00:00.000,ATP World Tour Masters 1000 Monte Carlo Monaco ATP World Tour Masters 1000,CLAY,2,Potito Starace,Carlos Berlocq,Potito Starace,4-2 RET,R64,23,1,0,9,12,9,9,3,3,0,0,3,12,12,0,0,20,25,9,20,4,5,1,2,3,13,25
2012-04-15 00:00:00.000,ATP World Tour Masters 1000 Monte Carlo Monaco ATP World Tour Masters 1000,CLAY,2,Pablo Andujar,Federico Delbonis,Pablo Andujar,3-6; 6-4; 6-2,R64,150,1,5,54,87,30,54,16,33,6,12,14,46,87,1,7,46,95,26,46,21,49,12,19,13,47,95
2012-04-15 00:00:00.000,ATP World Tour Masters 1000 Monte Carlo Monaco ATP World Tour Masters 1000,CLAY,2,Stan Wawrinka,Feliciano Lopez,Stan Wawrinka,6-1; 6-4,R64,69,14,3,30,48,26,30,11,18,1,1,9,37,48,1,3,34,62,22,34,11,28,5,8,8,33,62
2012-04-15 00:00:00.000,ATP World Tour Masters 1000 Monte Carlo Monaco ATP World Tour Masters 1000,CLAY,2,Mikhail Kukushkin,Florian Mayer,Mikhail Kukushkin,3-6; 6-1; 6-3,R64,114,3,1,40,85,23,40,24,45,4,8,13,47,85,6,4,35,76,23,35,18,41,7,13,12,41,76
2012-04-15 00:00:00.000,ATP World Tour Masters 1000 Monte Carlo Monaco ATP World Tour Masters 1000,CLAY,2,Filippo Volandri,Alessandro Giannessi,Filippo Volandri,7-5; 6-3,R64,88,0,1,52,66,34,52,6,14,2,4,10,40,66,2,5,36,59,23,36,8,23,3,8,11,31,59
2012-04-15 00:00:00.000,ATP World Tour Masters 1000 Monte Carlo Monaco ATP World Tour Masters 1000,CLAY,2,Jarkko Nieminen,Radek Stepanek,Jarkko Nieminen,6-3; 7-6(3),R64,117,2,0,60,81,38,60,14,21,3,5,11,52,81,4,1,61,85,34,61,14,24,8,11,10,48,85
2012-04-15 00:00:00.000,ATP World Tour Masters 1000 Monte Carlo Monaco ATP World Tour Masters 1000,CLAY,2,Rafael Nadal,N/A Bye,Rafael Nadal,,R64,0,0,0,0,0,0,0,0,0,0,0,0,0,0,0,0,0,0,0,0,0,0,0,0,0,0,0
2012-04-15 00:00:00.000,ATP World Tour Masters 1000 Monte Carlo Monaco ATP World Tour Masters 1000,CLAY,2,Novak Djokovic,Andreas Seppi,Novak Djokovic,6-1; 6-4,R32,89,5,1,43,63,33,43,10,20,3,3,9,43,63,0,0,40,66,22,40,13,26,6,9,8,35,66
2012-04-15 00:00:00.000,ATP World Tour Masters 1000 Monte Carlo Monaco ATP World Tour Masters 1000,CLAY,2,Alexandr Dolgopolov,Bernard Tomic,Alexandr Dolgopolov,6-2; 5-7; 6-1,R32,100,11,0,54,86,39,54,19,32,6,7,14,58,86,4,1,53,78,38,53,10,25,6,10,13,48,78
2012-04-15 00:00:00.000,ATP World Tour Masters 1000 Monte Carlo Monaco ATP World Tour Masters 1000,CLAY,2,Robin Haase,Fabio Fognini,Robin Haase,6-4; 6-4,R32,85,3,3,34,60,24,34,12,26,2,5,10,36,60,0,1,45,67,26,45,9,22,6,11,10,35,67
2012-04-15 00:00:00.000,ATP World Tour Masters 1000 Monte Carlo Monaco ATP World Tour Masters 1000,CLAY,2,Thomaz Bellucci,David Ferrer,Thomaz Bellucci,6-3; 6-2,R32,69,3,3,30,56,24,30,15,26,0,0,9,39,56,1,2,26,49,19,26,9,23,6,9,8,28,49
2012-04-15 00:00:00.000,ATP World Tour Masters 1000 Monte Carlo Monaco ATP World Tour Masters 1000,CLAY,2,Andy Murray,Viktor Troicki,Andy Murray,6-0; 6-3,R32,67,1,1,27,33,25,27,3,6,0,0,7,28,33,0,1,32,53,17,32,7,21,7,12,8,24,53
2012-04-15 00:00:00.000,ATP World Tour Masters 1000 Monte Carlo Monaco ATP World Tour Masters 1000,CLAY,2,Julien Benneteau,Jurgen Melzer,Julien Benneteau,6-4; 6-3,R32,68,6,3,41,49,31,41,5,8,0,2,10,36,49,3,0,39,53,22,39,7,14,6,10,9,29,53
2012-04-15 00:00:00.000,ATP World Tour Masters 1000 Monte Carlo Monaco ATP World Tour Masters 1000,CLAY,2,Kei Nishikori,Paul-Henri Mathieu,Kei Nishikori,6-4; 6-2,R32,90,1,6,33,59,26,33,14,26,5,6,9,40,59,2,1,29,50,19,29,10,21,1,5,9,29,50
2012-04-15 00:00:00.000,ATP World Tour Masters 1000 Monte Carlo Monaco ATP World Tour Masters 1000,CLAY,2,Tomas Berdych,Marin Cilic,Tomas Berdych,7-6(3); 6-1,R32,103,5,1,32,59,25,32,17,27,1,3,10,42,59,6,5,33,67,23,33,12,34,5,9,9,35,67
2012-04-15 00:00:00.000,ATP World Tour Masters 1000 Monte Carlo Monaco ATP World Tour Masters 1000,CLAY,2,Janko Tipsarevic,Albert Montanes,Janko Tipsarevic,6-2; 6-3,R32,93,8,2,20,48,16,20,13,28,2,4,8,29,48,0,3,48,76,18,48,17,28,4,10,9,35,76
2012-04-15 00:00:00.000,ATP World Tour Masters 1000 Monte Carlo Monaco ATP World Tour Masters 1000,CLAY,2,Gilles Simon,Frederico Gil,Gilles Simon,6-3; 6-0,R32,63,3,3,21,50,17,21,16,29,2,3,8,33,50,0,3,28,46,12,28,7,18,4,9,7,19,46
2012-04-15 00:00:00.000,ATP World Tour Masters 1000 Monte Carlo Monaco ATP World Tour Masters 1000,CLAY,2,Fernando Verdasco,Ivan Dodig,Fernando Verdasco,3-6; 6-3; 6-1,R32,119,1,4,70,87,46,70,7,17,5,7,12,53,87,7,5,51,86,33,51,16,35,2,7,13,49,86
2012-04-15 00:00:00.000,ATP World Tour Masters 1000 Monte Carlo Monaco ATP World Tour Masters 1000,CLAY,2,Jo-Wilfried Tsonga,Philipp Kohlschreiber,Jo-Wilfried Tsonga,6-2; 6-4,R32,86,5,1,39,63,29,39,13,24,6,6,9,42,63,1,0,38,60,23,38,12,22,5,8,9,35,60
2012-04-15 00:00:00.000,ATP World Tour Masters 1000 Monte Carlo Monaco ATP World Tour Masters 1000,CLAY,2,Nicolas Almagro,Potito Starace,Nicolas Almagro,7-6(3); 6-1,R32,76,5,0,27,55,23,27,21,28,0,0,10,44,55,1,1,47,61,30,47,6,14,0,2,9,36,61
2012-04-15 00:00:00.000,ATP World Tour Masters 1000 Monte Carlo Monaco ATP World Tour Masters 1000,CLAY,2,Stan Wawrinka,Pablo Andujar,Stan Wawrinka,7-5; 6-3,R32,81,7,2,30,64,22,30,21,34,5,7,11,43,64,0,3,39,62,21,39,12,23,2,6,10,33,62
2012-04-15 00:00:00.000,ATP World Tour Masters 1000 Monte Carlo Monaco ATP World Tour Masters 1000,CLAY,2,Mikhail Kukushkin,Filippo Volandri,Mikhail Kukushkin,7-6(8); 2-6; 6-2,R32,137,5,4,57,99,34,57,24,42,2,7,14,58,99,1,4,78,100,46,78,10,22,6,11,14,56,100
2012-04-15 00:00:00.000,ATP World Tour Masters 1000 Monte Carlo Monaco ATP World Tour Masters 1000,CLAY,2,Rafael Nadal,Jarkko Nieminen,Rafael Nadal,6-4; 6-3,R32,87,1,0,31,48,22,31,12,17,0,1,9,34,48,0,4,38,57,24,38,8,19,3,7,10,32,57
2012-04-15 00:00:00.000,ATP World Tour Masters 1000 Monte Carlo Monaco ATP World Tour Masters 1000,CLAY,2,Novak Djokovic,Alexandr Dolgopolov,Novak Djokovic,2-6; 6-1; 6-4,R16,100,5,2,48,67,37,48,10,19,3,5,13,47,67,5,0,49,87,32,49,20,38,6,9,12,52,87
2012-04-15 00:00:00.000,ATP World Tour Masters 1000 Monte Carlo Monaco ATP World Tour Masters 1000,CLAY,2,Robin Haase,Thomaz Bellucci,Robin Haase,6-2; 6-3,R16,94,5,5,44,82,33,44,14,38,9,11,9,47,82,0,1,26,48,13,26,9,22,2,7,8,22,48
2012-04-15 00:00:00.000,ATP World Tour Masters 1000 Monte Carlo Monaco ATP World Tour Masters 1000,CLAY,2,Andy Murray,Julien Benneteau,Andy Murray,6-5 RET,R16,84,3,1,19,42,15,19,12,23,4,5,6,27,42,1,0,30,39,17,30,6,9,2,3,5,23,39
2012-04-15 00:00:00.000,ATP World Tour Masters 1000 Monte Carlo Monaco ATP World Tour Masters 1000,CLAY,2,Tomas Berdych,Kei Nishikori,Tomas Berdych,2-6; 6-2; 6-4,R16,120,8,2,44,73,35,44,14,29,2,4,13,49,73,1,1,45,71,30,45,16,26,5,8,13,46,71
2012-04-15 00:00:00.000,ATP World Tour Masters 1000 Monte Carlo Monaco ATP World Tour Masters 1000,CLAY,2,Gilles Simon,Janko Tipsarevic,Gilles Simon,6-0; 4-6; 6-1,R16,138,4,1,47,93,32,47,28,46,9,10,12,60,93,11,0,32,66,21,32,15,34,0,5,11,36,66
2012-04-15 00:00:00.000,ATP World Tour Masters 1000 Monte Carlo Monaco ATP World Tour Masters 1000,CLAY,2,Jo-Wilfried Tsonga,Fernando Verdasco,Jo-Wilfried Tsonga,7-6(7); 6-2,R16,104,7,2,46,76,38,46,16,30,9,9,10,54,76,0,4,44,65,29,44,13,21,4,6,10,42,65
2012-04-15 00:00:00.000,ATP World Tour Masters 1000 Monte Carlo Monaco ATP World Tour Masters 1000,CLAY,2,Stan Wawrinka,Nicolas Almagro,Stan Wawrinka,6-3; 6-3,R16,80,2,2,27,61,19,27,21,34,3,4,9,40,61,0,0,29,51,19,29,5,22,2,6,9,24,51
2012-04-15 00:00:00.000,ATP World Tour Masters 1000 Monte Carlo Monaco ATP World Tour Masters 1000,CLAY,2,Rafael Nadal,Mikhail Kukushkin,Rafael Nadal,6-1; 6-1,R16,60,5,0,28,34,24,28,4,6,0,0,7,28,34,1,0,27,44,9,27,7,17,1,6,7,16,44
2012-04-15 00:00:00.000,ATP World Tour Masters 1000 Monte Carlo Monaco ATP World Tour Masters 1000,CLAY,2,Novak Djokovic,Robin Haase,Novak Djokovic,6-4; 6-2,Q,78,1,0,33,55,18,33,11,22,4,8,9,29,55,0,0,37,61,16,37,7,24,5,12,9,23,61
2012-04-15 00:00:00.000,ATP World Tour Masters 1000 Monte Carlo Monaco ATP World Tour Masters 1000,CLAY,2,Tomas Berdych,Andy Murray,Tomas Berdych,6-7(4); 6-2; 6-3,Q,168,5,3,51,79,42,51,15,28,0,1,14,57,79,4,0,70,112,45,70,21,42,11,16,15,66,112
2012-04-15 00:00:00.000,ATP World Tour Masters 1000 Monte Carlo Monaco ATP World Tour Masters 1000,CLAY,2,Gilles Simon,Jo-Wilfried Tsonga,Gilles Simon,7-5; 6-4,Q,92,0,1,26,51,21,26,14,25,1,4,11,35,51,0,4,37,63,23,37,9,26,4,9,11,32,63
2012-04-15 00:00:00.000,ATP World Tour Masters 1000 Monte Carlo Monaco ATP World Tour Masters 1000,CLAY,2,Rafael Nadal,Stan Wawrinka,Rafael Nadal,7-5; 6-4,Q,107,4,2,45,61,37,45,8,16,1,2,11,45,61,5,3,37,70,26,37,16,33,4,7,11,42,70
2012-04-15 00:00:00.000,ATP World Tour Masters 1000 Monte Carlo Monaco ATP World Tour Masters 1000,CLAY,2,Novak Djokovic,Tomas Berdych,Novak Djokovic,4-6; 6-3; 6-2,S,162,6,6,60,97,40,60,21,37,8,10,14,61,97,3,8,41,89,31,41,21,48,3,7,13,52,89
2012-04-15 00:00:00.000,ATP World Tour Masters 1000 Monte Carlo Monaco ATP World Tour Masters 1000,CLAY,2,Rafael Nadal,Gilles Simon,Rafael Nadal,6-3; 6-4,S,111,3,2,37,65,27,37,19,28,7,7,10,46,65,2,2,32,56,23,32,12,24,3,5,9,35,56
2012-04-15 00:00:00.000,ATP World Tour Masters 1000 Monte Carlo Monaco ATP World Tour Masters 1000,CLAY,2,Rafael Nadal,Novak Djokovic,Rafael Nadal,6-3; 6-1,F,79,3,1,26,38,22,26,6,12,0,1,8,28,38,0,0,30,48,12,30,10,18,3,8,8,22,48
2012-04-23 00:00:00.000,Barcelona Spain ATP World Tour 500,CLAY,2,Rafael Nadal,N/A Bye,Rafael Nadal,,R64,0,0,0,0,0,0,0,0,0,0,0,0,0,0,0,0,0,0,0,0,0,0,0,0,0,0,0
2012-04-23 00:00:00.000,Barcelona Spain ATP World Tour 500,CLAY,2,Guillermo Garcia-Lopez,Olivier Rochus,Guillermo Garcia-Lopez,6-3; 6-3,R64,85,5,1,37,60,31,37,12,23,4,4,9,43,60,1,1,36,62,21,36,14,26,2,5,9,35,62
2012-04-23 00:00:00.000,Barcelona Spain ATP World Tour 500,CLAY,2,Robert Farah,Arnau Brugues-Davi,Robert Farah,6-4; 7-6(3),R64,101,13,0,41,62,35,41,12,21,2,3,11,47,62,3,2,57,81,36,57,15,24,5,7,11,51,81
2012-04-23 00:00:00.000,Barcelona Spain ATP World Tour 500,CLAY,2,Pablo Andujar,David Goffin,Pablo Andujar,7-6(2); 6-4,R64,102,3,2,41,61,33,41,10,20,4,7,11,43,61,0,2,46,81,25,46,18,35,4,8,11,43,81
2012-04-23 00:00:00.000,Barcelona Spain ATP World Tour 500,CLAY,2,Frederico Gil,Marcel Granollers,Frederico Gil,6-2; 6-2,R64,73,2,1,26,41,18,26,10,15,3,5,8,28,41,1,3,18,44,8,18,9,26,3,9,8,17,44
2012-04-23 00:00:00.000,Barcelona Spain ATP World Tour 500,CLAY,2,Joao Sousa,Igor Kunitsyn,Joao Sousa,7-6(5); 6-3,R64,88,5,2,41,67,33,41,13,26,1,2,11,46,67,3,0,44,67,30,44,12,23,4,6,10,42,67
2012-04-23 00:00:00.000,Barcelona Spain ATP World Tour 500,CLAY,2,Victor Hanescu,Rui Machado,Victor Hanescu,6-3; 7-6(5),R64,121,3,0,62,90,41,62,13,28,9,11,11,54,90,1,3,63,88,39,63,8,25,7,10,10,47,88
2012-04-23 00:00:00.000,Barcelona Spain ATP World Tour 500,CLAY,2,Janko Tipsarevic,N/A Bye,Janko Tipsarevic,,R64,0,0,0,0,0,0,0,0,0,0,0,0,0,0,0,0,0,0,0,0,0,0,0,0,0,0,0
2012-04-23 00:00:00.000,Barcelona Spain ATP World Tour 500,CLAY,2,Fernando Verdasco,N/A Bye,Fernando Verdasco,,R64,0,0,0,0,0,0,0,0,0,0,0,0,0,0,0,0,0,0,0,0,0,0,0,0,0,0,0
2012-04-23 00:00:00.000,Barcelona Spain ATP World Tour 500,CLAY,2,Steve Darcis,Andrey Golubev,Steve Darcis,4-6; 7-6(2); 7-6(5),R64,157,1,4,76,101,56,76,15,25,0,2,17,71,101,11,4,69,122,49,69,32,53,8,9,17,81,122
2012-04-23 00:00:00.000,Barcelona Spain ATP World Tour 500,CLAY,2,Federico Delbonis,Aljaz Bedene,Federico Delbonis,6-3; 7-5,R64,113,2,0,48,66,38,48,9,18,2,3,11,47,66,5,1,58,84,35,58,11,26,9,12,10,46,84
2012-04-23 00:00:00.000,Barcelona Spain ATP World Tour 500,CLAY,2,Kevin Anderson,Malek Jaziri,Kevin Anderson,6-2; 6-3,R64,73,5,0,43,62,32,43,10,19,6,6,9,42,62,3,1,31,52,19,31,10,21,2,5,8,29,52
2012-04-23 00:00:00.000,Barcelona Spain ATP World Tour 500,CLAY,2,Albert Ramos-Vinolas,Andreas Beck,Albert Ramos-Vinolas,4-1 RET,R64,21,0,0,6,8,6,6,2,2,0,0,2,8,8,0,3,5,17,2,5,5,12,0,2,3,7,17
2012-04-23 00:00:00.000,Barcelona Spain ATP World Tour 500,CLAY,2,Benoit Paire,Lukas Rosol,Benoit Paire,6-3; 7-5,R64,57,10,0,33,47,29,33,11,14,0,0,10,40,47,0,2,43,68,28,43,13,25,5,8,11,41,68
2012-04-23 00:00:00.000,Barcelona Spain ATP World Tour 500,CLAY,2,Mikhail Kukushkin,Daniel Gimeno-Traver,Mikhail Kukushkin,6-2; 6-3,R64,69,1,0,40,59,29,40,12,19,3,3,9,41,59,3,3,31,59,19,31,12,28,4,7,8,31,59
2012-04-23 00:00:00.000,Barcelona Spain ATP World Tour 500,CLAY,2,Kei Nishikori,N/A Bye,Kei Nishikori,,R64,0,0,0,0,0,0,0,0,0,0,0,0,0,0,0,0,0,0,0,0,0,0,0,0,0,0,0
2012-04-23 00:00:00.000,Barcelona Spain ATP World Tour 500,CLAY,2,Feliciano Lopez,N/A Bye,Feliciano Lopez,,R64,0,0,0,0,0,0,0,0,0,0,0,0,0,0,0,0,0,0,0,0,0,0,0,0,0,0,0
2012-04-23 00:00:00.000,Barcelona Spain ATP World Tour 500,CLAY,2,Flavio Cipolla,Paolo Lorenzi,Flavio Cipolla,6-0; 6-3,R64,62,2,1,33,47,25,33,8,14,1,2,8,33,47,1,0,28,36,14,28,2,8,3,8,7,16,36
2012-04-23 00:00:00.000,Barcelona Spain ATP World Tour 500,CLAY,2,Jarkko Nieminen,Javier Marti,Jarkko Nieminen,6-4; 6-1,R64,83,1,0,43,64,29,43,9,21,6,8,9,38,64,2,0,37,53,21,37,3,16,2,7,8,24,53
2012-04-23 00:00:00.000,Barcelona Spain ATP World Tour 500,CLAY,2,Eduardo Schwank,Ruben Ramirez Hidalgo,Eduardo Schwank,2-6; 6-4; 6-0,R64,132,4,1,44,69,34,44,12,25,6,8,12,46,69,1,7,42,94,28,42,27,52,5,9,12,55,94
2012-04-23 00:00:00.000,Barcelona Spain ATP World Tour 500,CLAY,2,Bernard Tomic,Ernests Gulbis,Bernard Tomic,6-3; 6-4,R64,67,4,1,41,59,33,41,10,18,3,3,10,43,59,5,4,33,60,24,33,13,27,4,6,9,37,60
2012-04-23 00:00:00.000,Barcelona Spain ATP World Tour 500,CLAY,2,Albert Montanes,Gerard Granollers,Albert Montanes,7-5; 6-2,R64,91,3,3,44,69,27,44,15,25,3,5,10,42,69,0,2,40,57,23,40,5,17,1,6,10,28,57
2012-04-23 00:00:00.000,Barcelona Spain ATP World Tour 500,CLAY,2,Filip Krajinovic,Inigo Cervantes,Filip Krajinovic,6-2; 6-4,R64,77,1,0,33,58,24,33,14,25,3,4,9,38,58,4,4,25,48,17,25,9,23,1,5,9,26,48
2012-04-23 00:00:00.000,Barcelona Spain ATP World Tour 500,CLAY,2,David Ferrer,N/A Bye,David Ferrer,,R64,0,0,0,0,0,0,0,0,0,0,0,0,0,0,0,0,0,0,0,0,0,0,0,0,0,0,0
2012-04-23 00:00:00.000,Barcelona Spain ATP World Tour 500,CLAY,2,Nicolas Almagro,N/A Bye,Nicolas Almagro,,R64,0,0,0,0,0,0,0,0,0,0,0,0,0,0,0,0,0,0,0,0,0,0,0,0,0,0,0
2012-04-23 00:00:00.000,Barcelona Spain ATP World Tour 500,CLAY,2,Edouard Roger-Vasselin,Stephane Robert,Edouard Roger-Vasselin,6-2; 6-3,R64,66,1,2,45,58,33,45,2,13,3,5,8,35,58,3,2,25,50,14,25,7,25,3,9,9,21,50
2012-04-23 00:00:00.000,Barcelona Spain ATP World Tour 500,CLAY,2,Igor Andreev,Diego Junqueira,Igor Andreev,6-2; 6-3,R64,69,5,3,39,49,30,39,7,10,0,0,9,37,49,1,2,52,63,28,52,5,11,10,13,8,33,63
2012-04-23 00:00:00.000,Barcelona Spain ATP World Tour 500,CLAY,2,Milos Raonic,Alejandro Falla,Milos Raonic,6-4; 7-6(3),R64,102,7,0,39,71,30,39,20,32,3,4,11,50,71,1,1,48,75,32,48,16,27,5,7,11,48,75
2012-04-23 00:00:00.000,Barcelona Spain ATP World Tour 500,CLAY,2,Santiago Giraldo,Denis Istomin,Santiago Giraldo,7-6(3); 6-4,R64,99,5,0,51,73,34,51,13,22,2,4,11,47,73,6,1,55,74,37,55,8,19,6,9,11,45,74
2012-04-23 00:00:00.000,Barcelona Spain ATP World Tour 500,CLAY,2,Robin Haase,Sergei Bubka,Robin Haase,6-1; 3-2 RET,R64,48,6,2,20,35,18,20,8,15,0,0,6,26,35,2,0,20,31,12,20,3,11,1,4,6,15,31
2012-04-23 00:00:00.000,Barcelona Spain ATP World Tour 500,CLAY,2,Sergiy Stakhovsky,Evgeny Donskoy,Sergiy Stakhovsky,6-2; 6-3,R64,62,4,0,34,51,27,34,11,17,1,1,9,38,51,2,1,25,42,15,25,9,17,1,4,8,24,42
2012-04-23 00:00:00.000,Barcelona Spain ATP World Tour 500,CLAY,2,Andy Murray,N/A Bye,Andy Murray,,R64,0,0,0,0,0,0,0,0,0,0,0,0,0,0,0,0,0,0,0,0,0,0,0,0,0,0,0
2012-04-23 00:00:00.000,Barcelona Spain ATP World Tour 500,CLAY,2,Rafael Nadal,Guillermo Garcia-Lopez,Rafael Nadal,6-1; 6-2,R32,82,0,2,21,38,17,21,10,17,1,2,7,27,38,1,2,38,60,16,38,10,22,9,15,8,26,60
2012-04-23 00:00:00.000,Barcelona Spain ATP World Tour 500,CLAY,2,Robert Farah,Pablo Andujar,Robert Farah,7-6(8); 4-6; 7-5,R32,170,9,1,76,123,49,76,25,47,10,15,17,74,123,1,5,64,103,47,64,17,39,3,8,17,64,103
2012-04-23 00:00:00.000,Barcelona Spain ATP World Tour 500,CLAY,2,Frederico Gil,Joao Sousa,Frederico Gil,4-6; 6-4; 6-3,R32,133,2,2,62,102,39,62,24,40,7,10,15,63,102,2,0,45,85,29,45,19,40,2,6,14,48,85
2012-04-23 00:00:00.000,Barcelona Spain ATP World Tour 500,CLAY,2,Janko Tipsarevic,Victor Hanescu,Janko Tipsarevic,7-5; 6-4,R32,103,6,4,36,69,28,36,16,33,7,9,11,44,69,0,3,56,73,35,56,5,17,4,8,11,40,73
2012-04-23 00:00:00.000,Barcelona Spain ATP World Tour 500,CLAY,2,Fernando Verdasco,Steve Darcis,Fernando Verdasco,6-3; 6-1,R32,73,1,2,32,45,25,32,8,13,1,1,8,33,45,1,2,31,52,20,31,7,21,6,10,8,27,52
2012-04-23 00:00:00.000,Barcelona Spain ATP World Tour 500,CLAY,2,Kevin Anderson,Federico Delbonis,Kevin Anderson,7-6(5); 7-6(5),R32,115,5,2,55,77,46,55,11,22,1,2,12,57,77,5,2,61,86,44,61,15,25,5,6,12,59,86
2012-04-23 00:00:00.000,Barcelona Spain ATP World Tour 500,CLAY,2,Albert Ramos-Vinolas,Benoit Paire,Albert Ramos-Vinolas,6-3; 7-5,R32,84,3,2,42,64,31,42,11,22,5,7,11,42,64,5,4,29,58,20,29,11,29,3,7,10,31,58
2012-04-23 00:00:00.000,Barcelona Spain ATP World Tour 500,CLAY,2,Kei Nishikori,Mikhail Kukushkin,Kei Nishikori,6-3; 4-6; 6-0,R32,137,3,1,63,89,38,63,16,26,7,9,13,54,89,6,3,63,101,36,63,17,38,6,11,12,53,101
2012-04-23 00:00:00.000,Barcelona Spain ATP World Tour 500,CLAY,2,Feliciano Lopez,Flavio Cipolla,Feliciano Lopez,6-4; 6-3,R32,74,4,3,34,56,26,34,17,22,2,2,10,43,56,1,3,38,53,26,38,7,15,2,4,9,33,53
2012-04-23 00:00:00.000,Barcelona Spain ATP World Tour 500,CLAY,2,Jarkko Nieminen,Eduardo Schwank,Jarkko Nieminen,6-3; 6-7(4); 6-4,R32,134,5,2,84,106,55,84,12,22,1,3,16,67,106,8,2,65,94,44,65,15,29,3,7,15,59,94
2012-04-23 00:00:00.000,Barcelona Spain ATP World Tour 500,CLAY,2,Albert Montanes,Bernard Tomic,Albert Montanes,6-0; 5-7; 7-5,R32,139,1,2,59,103,34,59,30,44,13,16,15,64,103,2,3,50,86,32,50,16,36,5,11,15,48,86
2012-04-23 00:00:00.000,Barcelona Spain ATP World Tour 500,CLAY,2,David Ferrer,Filip Krajinovic,David Ferrer,6-0; 6-3,R32,59,3,2,27,41,21,27,9,14,0,1,8,30,41,0,2,24,44,9,24,9,20,0,5,7,18,44
2012-04-23 00:00:00.000,Barcelona Spain ATP World Tour 500,CLAY,2,Nicolas Almagro,Edouard Roger-Vasselin,Nicolas Almagro,7-5; 7-6(3),R32,107,7,3,20,66,19,20,30,46,2,4,12,49,66,5,4,58,90,37,58,14,32,4,7,12,51,90
2012-04-23 00:00:00.000,Barcelona Spain ATP World Tour 500,CLAY,2,Milos Raonic,Igor Andreev,Milos Raonic,6-4; 6-1,R32,75,5,0,29,44,26,29,11,15,0,0,9,37,44,4,3,38,68,24,38,12,30,4,7,8,36,68
2012-04-23 00:00:00.000,Barcelona Spain ATP World Tour 500,CLAY,2,Santiago Giraldo,Robin Haase,Santiago Giraldo,6-4; 6-3,R32,76,0,0,34,52,27,34,13,18,4,4,9,40,52,5,2,35,57,25,35,10,22,3,6,10,35,57
2012-04-23 00:00:00.000,Barcelona Spain ATP World Tour 500,CLAY,2,Andy Murray,Sergiy Stakhovsky,Andy Murray,6-3; 6-2,R32,79,3,3,27,54,23,27,16,27,2,2,9,39,54,1,2,34,56,21,34,8,22,2,5,8,29,56
2012-04-23 00:00:00.000,Barcelona Spain ATP World Tour 500,CLAY,2,Rafael Nadal,Robert Farah,Rafael Nadal,6-2; 6-3,R16,87,2,0,25,42,19,25,11,17,1,2,8,30,42,3,2,31,55,16,31,9,24,5,10,9,25,55
2012-04-23 00:00:00.000,Barcelona Spain ATP World Tour 500,CLAY,2,Janko Tipsarevic,Frederico Gil,Janko Tipsarevic,6-2; 6-2,R16,69,9,2,22,47,18,22,17,25,1,1,7,35,47,0,1,26,44,17,26,6,18,2,6,8,23,44
2012-04-23 00:00:00.000,Barcelona Spain ATP World Tour 500,CLAY,2,Fernando Verdasco,Kevin Anderson,Fernando Verdasco,6-4; 6-4,R16,105,5,1,44,62,35,44,10,18,4,4,10,45,62,4,1,46,73,31,46,14,27,10,12,10,45,73
2012-04-23 00:00:00.000,Barcelona Spain ATP World Tour 500,CLAY,2,Kei Nishikori,Albert Ramos-Vinolas,Kei Nishikori,7-6(2); 6-3,R16,132,3,5,46,76,34,46,16,30,6,7,11,50,76,6,4,52,88,34,52,17,36,9,11,10,51,88
2012-04-23 00:00:00.000,Barcelona Spain ATP World Tour 500,CLAY,2,Feliciano Lopez,Jarkko Nieminen,Feliciano Lopez,6-3; 6-1,R16,72,8,1,31,55,22,31,16,24,7,7,8,38,55,4,1,33,54,19,33,9,21,7,11,8,28,54
2012-04-23 00:00:00.000,Barcelona Spain ATP World Tour 500,CLAY,2,David Ferrer,Albert Montanes,David Ferrer,6-0; 6-2,R16,81,3,1,30,54,20,30,16,24,4,4,7,36,54,0,2,40,56,20,40,5,16,3,8,7,25,56
2012-04-23 00:00:00.000,Barcelona Spain ATP World Tour 500,CLAY,2,Milos Raonic,Nicolas Almagro,Milos Raonic,6-3; 6-3,R16,68,7,0,31,48,24,31,13,17,2,2,9,37,48,2,1,29,49,17,29,10,20,0,3,9,27,49
2012-04-23 00:00:00.000,Barcelona Spain ATP World Tour 500,CLAY,2,Andy Murray,Santiago Giraldo,Andy Murray,6-1; 6-2,R16,74,9,3,31,50,25,31,8,19,3,4,8,33,50,1,3,35,50,19,35,3,15,4,9,7,22,50
2012-04-23 00:00:00.000,Barcelona Spain ATP World Tour 500,CLAY,2,Rafael Nadal,Janko Tipsarevic,Rafael Nadal,6-2; 6-2,Q,84,3,1,33,48,25,33,7,15,4,5,8,32,48,3,4,30,51,19,30,4,21,2,7,8,23,51
2012-04-23 00:00:00.000,Barcelona Spain ATP World Tour 500,CLAY,2,Fernando Verdasco,Kei Nishikori,Fernando Verdasco,4-2 RET,Q,29,2,0,13,16,10,13,2,3,0,0,3,12,16,0,1,8,17,8,8,2,9,0,1,3,10,17
2012-04-23 00:00:00.000,Barcelona Spain ATP World Tour 500,CLAY,2,David Ferrer,Feliciano Lopez,David Ferrer,6-7(4); 7-6(7); 6-3,Q,165,7,1,64,99,55,64,22,35,2,2,17,77,99,2,1,82,128,51,82,31,46,9,10,16,82,128
2012-04-23 00:00:00.000,Barcelona Spain ATP World Tour 500,CLAY,2,Milos Raonic,Andy Murray,Milos Raonic,6-4; 7-6(3),Q,104,14,1,45,69,38,45,13,24,3,4,11,51,69,3,1,45,71,33,45,13,26,3,5,11,46,71
2012-04-23 00:00:00.000,Barcelona Spain ATP World Tour 500,CLAY,2,Rafael Nadal,Fernando Verdasco,Rafael Nadal,6-0; 6-4,S,86,2,1,35,50,29,35,7,15,4,4,8,36,50,0,2,38,50,20,38,5,12,4,8,8,25,50
2012-04-23 00:00:00.000,Barcelona Spain ATP World Tour 500,CLAY,2,David Ferrer,Milos Raonic,David Ferrer,7-6(2); 7-6(5),S,126,0,2,62,83,47,62,14,21,4,4,12,61,83,15,5,57,97,40,57,23,40,7,7,12,63,97
2012-04-23 00:00:00.000,Barcelona Spain ATP World Tour 500,CLAY,2,Rafael Nadal,David Ferrer,Rafael Nadal,7-6(1); 7-5,F,160,4,3,58,91,36,58,18,33,12,15,12,54,91,0,2,70,93,38,70,11,23,6,10,12,49,93
2012-04-23 00:00:00.000,Bucharest Romania ATP World Tour 250,CLAY,2,Gilles Simon,N/A Bye,Gilles Simon,,R32,0,0,0,0,0,0,0,0,0,0,0,0,0,0,0,0,0,0,0,0,0,0,0,0,0,0,0
2012-04-23 00:00:00.000,Bucharest Romania ATP World Tour 250,CLAY,2,Dudi Sela,Adrian Ungur,Dudi Sela,7-6(2); 6-2,R32,96,3,0,49,70,31,49,15,21,9,11,10,46,70,2,5,38,60,24,38,9,22,3,7,10,33,60
2012-04-23 00:00:00.000,Bucharest Romania ATP World Tour 250,CLAY,2,Marius Copil,Tobias Kamke,Marius Copil,6-3; 6-2,R32,82,6,1,32,51,25,32,13,19,1,1,9,38,51,0,4,44,66,27,44,9,22,9,12,8,36,66
2012-04-23 00:00:00.000,Bucharest Romania ATP World Tour 250,CLAY,2,Lukasz Kubot,Gabriel Moraru,Lukasz Kubot,6-2; 6-3,R32,93,6,4,40,60,27,40,11,20,9,10,8,38,60,2,0,32,54,14,32,13,22,6,11,9,27,54
2012-04-23 00:00:00.000,Bucharest Romania ATP World Tour 250,CLAY,2,Viktor Troicki,N/A Bye,Viktor Troicki,,R32,0,0,0,0,0,0,0,0,0,0,0,0,0,0,0,0,0,0,0,0,0,0,0,0,0,0,0
2012-04-23 00:00:00.000,Bucharest Romania ATP World Tour 250,CLAY,2,Matthias Bachinger,Filippo Volandri,Matthias Bachinger,3-6; 6-1; 6-3,R32,112,9,1,40,79,31,40,18,39,3,6,13,49,79,0,2,74,91,40,74,9,17,5,10,12,49,91
2012-04-23 00:00:00.000,Bucharest Romania ATP World Tour 250,CLAY,2,Jurgen Zopp,Victor Crivoi,Jurgen Zopp,6-3; 6-3,R32,86,6,2,37,57,30,37,10,20,3,3,9,40,57,5,4,45,65,32,45,6,20,6,9,9,38,65
2012-04-23 00:00:00.000,Bucharest Romania ATP World Tour 250,CLAY,2,Daniel Brands,Ivan Dodig,Daniel Brands,7-6(4); 6-2,R32,100,5,0,42,65,36,42,12,23,3,3,10,48,65,4,0,49,71,31,49,12,22,4,6,10,43,71
2012-04-23 00:00:00.000,Bucharest Romania ATP World Tour 250,CLAY,2,Andreas Seppi,Guillaume Rufin,Andreas Seppi,1-6; 7-6(5); 6-4,R32,144,6,2,44,83,30,44,22,39,4,8,14,52,83,4,1,55,95,39,55,24,40,5,8,15,63,95
2012-04-23 00:00:00.000,Bucharest Romania ATP World Tour 250,CLAY,2,Cedrik-Marcel Stebe,Erik Chvojka,Cedrik-Marcel Stebe,6-3; 6-3,R32,85,1,3,39,53,28,39,5,14,1,3,9,33,53,1,4,39,59,25,39,4,20,2,7,9,29,59
2012-04-23 00:00:00.000,Bucharest Romania ATP World Tour 250,CLAY,2,Fabio Fognini,Joao Souza,Fabio Fognini,7-5; 7-6(5),R32,107,1,0,54,74,37,54,13,20,3,5,12,50,74,1,1,57,72,35,57,8,15,0,3,12,43,72
2012-04-23 00:00:00.000,Bucharest Romania ATP World Tour 250,CLAY,2,Marcos Baghdatis,N/A Bye,Marcos Baghdatis,,R32,0,0,0,0,0,0,0,0,0,0,0,0,0,0,0,0,0,0,0,0,0,0,0,0,0,0,0
2012-04-23 00:00:00.000,Bucharest Romania ATP World Tour 250,CLAY,2,Potito Starace,Jeremy Chardy,Potito Starace,6-3; 6-0,R32,65,3,0,38,45,28,38,5,7,0,0,8,33,45,0,5,16,41,9,16,11,25,5,9,7,20,41
2012-04-23 00:00:00.000,Bucharest Romania ATP World Tour 250,CLAY,2,Attila Balazs,Lukas Lacko,Attila Balazs,6-7(7); 7-6(2); 6-4,R32,168,5,5,69,119,54,69,29,50,9,10,17,83,119,4,5,80,133,58,80,25,53,7,9,17,83,133
2012-04-23 00:00:00.000,Bucharest Romania ATP World Tour 250,CLAY,2,Xavier Malisse,Grigor Dimitrov,Xavier Malisse,6-2; 6-4,R32,74,3,0,24,52,18,24,18,28,1,2,9,36,52,1,4,34,60,20,34,11,26,3,7,9,31,60
2012-04-23 00:00:00.000,Bucharest Romania ATP World Tour 250,CLAY,2,Florian Mayer,N/A Bye,Florian Mayer,,R32,0,0,0,0,0,0,0,0,0,0,0,0,0,0,0,0,0,0,0,0,0,0,0,0,0,0,0
2012-04-23 00:00:00.000,Bucharest Romania ATP World Tour 250,CLAY,2,Gilles Simon,Dudi Sela,Gilles Simon,6-4; 6-2,R16,81,1,0,33,60,23,33,16,27,3,4,9,39,60,0,2,33,55,19,33,10,22,2,6,9,29,55
2012-04-23 00:00:00.000,Bucharest Romania ATP World Tour 250,CLAY,2,Lukasz Kubot,Marius Copil,Lukasz Kubot,6-3; 6-3,R16,76,2,1,32,48,26,32,11,16,0,0,9,37,48,2,1,30,45,21,30,9,15,2,5,9,30,45
2012-04-23 00:00:00.000,Bucharest Romania ATP World Tour 250,CLAY,2,Matthias Bachinger,Viktor Troicki,Matthias Bachinger,6-3; 4-6; 7-6(2),R16,151,4,4,56,97,40,56,16,41,5,10,16,56,97,6,1,77,113,47,77,15,36,4,9,15,62,113
2012-04-23 00:00:00.000,Bucharest Romania ATP World Tour 250,CLAY,2,Daniel Brands,Jurgen Zopp,Daniel Brands,7-6(3); 6-3,R16,90,10,2,45,65,36,45,11,20,0,1,11,47,65,2,2,43,63,31,43,11,20,5,7,10,42,63
2012-04-23 00:00:00.000,Bucharest Romania ATP World Tour 250,CLAY,2,Andreas Seppi,Cedrik-Marcel Stebe,Andreas Seppi,6-2; 6-3,R16,71,2,0,32,49,26,32,11,17,1,1,9,37,49,1,2,31,50,20,31,7,19,4,7,8,27,50
2012-04-23 00:00:00.000,Bucharest Romania ATP World Tour 250,CLAY,2,Fabio Fognini,Marcos Baghdatis,Fabio Fognini,7-5; 7-6(4),R16,117,1,1,58,75,33,58,8,17,3,8,12,41,75,1,3,57,89,32,57,15,32,8,14,12,47,89
2012-04-23 00:00:00.000,Bucharest Romania ATP World Tour 250,CLAY,2,Attila Balazs,Potito Starace,Attila Balazs,6-3; 6-4,R16,77,2,3,41,66,29,41,14,25,6,7,10,43,66,2,0,42,53,26,42,6,11,1,4,9,32,53
2012-04-23 00:00:00.000,Bucharest Romania ATP World Tour 250,CLAY,2,Xavier Malisse,Florian Mayer,Xavier Malisse,7-5; 4-6; 6-4,R16,136,4,2,58,106,40,58,25,48,7,10,16,65,106,3,2,59,90,41,59,12,31,1,5,16,53,90
2012-04-23 00:00:00.000,Bucharest Romania ATP World Tour 250,CLAY,2,Gilles Simon,Lukasz Kubot,Gilles Simon,3-6; 6-1; 6-3,Q,134,3,2,55,84,34,55,16,29,8,11,12,50,84,2,6,57,92,35,57,14,35,9,15,13,49,92
2012-04-23 00:00:00.000,Bucharest Romania ATP World Tour 250,CLAY,2,Matthias Bachinger,Daniel Brands,Matthias Bachinger,6-4; 6-1,Q,69,6,1,33,54,26,33,13,21,2,2,9,39,54,5,1,34,44,23,34,3,10,0,3,8,26,44
2012-04-23 00:00:00.000,Bucharest Romania ATP World Tour 250,CLAY,2,Fabio Fognini,Andreas Seppi,Fabio Fognini,6-4; 6-7(4); 6-4,Q,183,2,1,71,96,39,71,16,25,2,8,16,55,96,1,2,73,142,40,73,34,69,9,17,16,74,142
2012-04-23 00:00:00.000,Bucharest Romania ATP World Tour 250,CLAY,2,Attila Balazs,Xavier Malisse,Attila Balazs,4-6; 6-3; 6-4,Q,135,4,2,64,112,42,64,28,48,12,14,15,70,112,5,1,54,91,34,54,21,37,4,7,14,55,91
2012-04-23 00:00:00.000,Bucharest Romania ATP World Tour 250,CLAY,2,Gilles Simon,Matthias Bachinger,Gilles Simon,7-5; 6-2,S,108,1,0,35,56,26,35,10,21,0,2,10,36,56,9,2,46,90,27,46,18,44,12,17,10,45,90
2012-04-23 00:00:00.000,Bucharest Romania ATP World Tour 250,CLAY,2,Fabio Fognini,Attila Balazs,Fabio Fognini,6-3; 6-1,S,69,0,1,43,58,32,43,7,15,3,3,8,39,58,1,1,35,55,16,35,11,20,2,6,8,27,55
2012-04-23 00:00:00.000,Bucharest Romania ATP World Tour 250,CLAY,2,Gilles Simon,Fabio Fognini,Gilles Simon,6-4; 6-3,F,110,2,1,39,72,25,39,18,33,10,12,9,43,72,1,2,51,74,27,51,12,23,7,12,10,39,74
2012-04-30 00:00:00.000,Belgrade Serbia ATP World Tour 250,CLAY,2,Pablo Andujar,N/A Bye,Pablo Andujar,,R32,0,0,0,0,0,0,0,0,0,0,0,0,0,0,0,0,0,0,0,0,0,0,0,0,0,0,0
2012-04-30 00:00:00.000,Belgrade Serbia ATP World Tour 250,CLAY,2,Filippo Volandri,Marko Djokovic,Filippo Volandri,6-3; 6-1,R32,60,1,1,38,49,29,38,6,11,0,0,8,35,49,0,2,23,49,13,23,12,26,4,8,8,25,49
2012-04-30 00:00:00.000,Belgrade Serbia ATP World Tour 250,CLAY,2,Victor Hanescu,Carlos Gomez-Herrera,Victor Hanescu,6-2; 5-7; 6-3,R32,126,3,0,74,97,54,74,12,23,9,10,14,66,97,5,6,61,89,38,61,15,28,7,11,15,53,89
2012-04-30 00:00:00.000,Belgrade Serbia ATP World Tour 250,CLAY,2,Lukas Rosol,Lukasz Kubot,Lukas Rosol,7-5; 6-2,R32,73,3,2,28,45,27,28,13,17,0,0,10,40,45,3,2,49,74,26,49,17,25,9,12,10,43,74
2012-04-30 00:00:00.000,Belgrade Serbia ATP World Tour 250,CLAY,2,Jarkko Nieminen,N/A Bye,Jarkko Nieminen,,R32,0,0,0,0,0,0,0,0,0,0,0,0,0,0,0,0,0,0,0,0,0,0,0,0,0,0,0
2012-04-30 00:00:00.000,Belgrade Serbia ATP World Tour 250,CLAY,2,Antonio Veic,Blaz Kavcic,Antonio Veic,6-1; 6-1,R32,72,0,1,22,39,20,22,8,17,1,2,7,28,39,1,5,35,56,15,35,8,21,6,12,7,23,56
2012-04-30 00:00:00.000,Belgrade Serbia ATP World Tour 250,CLAY,2,Guillermo Garcia-Lopez,Igor Kunitsyn,Guillermo Garcia-Lopez,7-6(4); 6-7(1); 6-2,R32,147,11,9,70,115,55,70,21,45,3,4,16,76,115,7,7,60,106,46,60,23,46,7,10,16,69,106
2012-04-30 00:00:00.000,Belgrade Serbia ATP World Tour 250,CLAY,2,Benoit Paire,Fabio Fognini,Benoit Paire,6-1; 6-4,R32,61,11,3,35,60,28,35,12,25,1,2,9,40,60,0,3,29,43,17,29,4,14,2,6,8,21,43
2012-04-30 00:00:00.000,Belgrade Serbia ATP World Tour 250,CLAY,2,Joao Souza,Ryan Harrison,Joao Souza,6-3; 6-3,R32,77,1,2,33,52,28,33,9,19,0,0,9,37,52,2,4,43,64,28,43,8,21,5,8,9,36,64
2012-04-30 00:00:00.000,Belgrade Serbia ATP World Tour 250,CLAY,2,Dusan Lajovic,Evgeny Donskoy,Dusan Lajovic,7-5; 6-4,R32,102,3,2,35,59,29,35,17,24,0,0,11,46,59,5,1,41,73,27,41,19,32,5,7,11,46,73
2012-04-30 00:00:00.000,Belgrade Serbia ATP World Tour 250,CLAY,2,Aljaz Bedene,Martin Klizan,Aljaz Bedene,6-4; 7-6(6),R32,119,11,5,42,83,33,42,21,41,3,4,11,54,83,1,0,45,70,30,45,13,25,2,4,11,43,70
2012-04-30 00:00:00.000,Belgrade Serbia ATP World Tour 250,CLAY,2,David Nalbandian,N/A Bye,David Nalbandian,,R32,0,0,0,0,0,0,0,0,0,0,0,0,0,0,0,0,0,0,0,0,0,0,0,0,0,0,0
2012-04-30 00:00:00.000,Belgrade Serbia ATP World Tour 250,CLAY,2,Gilles Muller,Lukas Lacko,Gilles Muller,6-0; 4-6; 6-3,R32,102,11,5,36,77,32,36,22,41,2,3,13,54,77,8,4,40,67,28,40,12,27,2,6,12,40,67
2012-04-30 00:00:00.000,Belgrade Serbia ATP World Tour 250,CLAY,2,Eduardo Schwank,Dudi Sela,Eduardo Schwank,6-2; 7-6(2),R32,118,2,3,49,81,31,49,17,32,10,13,10,48,81,2,6,41,73,31,41,8,32,2,7,10,39,73
2012-04-30 00:00:00.000,Belgrade Serbia ATP World Tour 250,CLAY,2,Ivan Dodig,Adrian Ungur,Ivan Dodig,6-2; 6-7(4); 6-4,R32,148,8,3,42,93,33,42,26,51,5,8,15,59,93,2,5,62,105,39,62,20,43,8,14,15,59,105
2012-04-30 00:00:00.000,Belgrade Serbia ATP World Tour 250,CLAY,2,Andreas Seppi,N/A Bye,Andreas Seppi,,R32,0,0,0,0,0,0,0,0,0,0,0,0,0,0,0,0,0,0,0,0,0,0,0,0,0,0,0
2012-04-30 00:00:00.000,Belgrade Serbia ATP World Tour 250,CLAY,2,Pablo Andujar,Filippo Volandri,Pablo Andujar,4-6; 7-5; 6-2,R16,140,1,8,63,117,39,63,27,54,10,14,15,66,117,0,2,64,90,38,64,11,26,6,12,15,49,90
2012-04-30 00:00:00.000,Belgrade Serbia ATP World Tour 250,CLAY,2,Lukas Rosol,Victor Hanescu,Lukas Rosol,7-6(4); 6-3,R16,82,5,5,51,76,43,51,12,25,2,2,11,55,76,2,0,47,64,33,47,12,17,1,2,10,45,64
2012-04-30 00:00:00.000,Belgrade Serbia ATP World Tour 250,CLAY,2,Jarkko Nieminen,Antonio Veic,Jarkko Nieminen,6-3; 4-6; 6-3,R16,129,1,1,57,86,42,57,12,29,6,9,14,54,86,2,5,49,86,34,49,15,37,5,10,14,49,86
2012-04-30 00:00:00.000,Belgrade Serbia ATP World Tour 250,CLAY,2,Benoit Paire,Guillermo Garcia-Lopez,Benoit Paire,4-6; 7-5; 7-5,R16,144,9,5,49,108,36,49,30,59,6,9,17,66,108,3,2,67,108,42,67,24,41,7,11,17,66,108
2012-04-30 00:00:00.000,Belgrade Serbia ATP World Tour 250,CLAY,2,Joao Souza,Dusan Lajovic,Joao Souza,4-2 RET,R16,32,1,0,13,16,7,13,3,3,0,1,3,10,16,1,1,7,14,4,7,2,7,1,3,3,6,14
2012-04-30 00:00:00.000,Belgrade Serbia ATP World Tour 250,CLAY,2,David Nalbandian,Aljaz Bedene,David Nalbandian,6-4; 6-3,R16,81,3,2,26,50,20,26,15,24,0,1,9,35,50,5,4,37,61,23,37,10,24,5,9,10,33,61
2012-04-30 00:00:00.000,Belgrade Serbia ATP World Tour 250,CLAY,2,Gilles Muller,Eduardo Schwank,Gilles Muller,6-3; 7-6(0),R16,94,8,3,35,74,30,35,20,39,3,4,11,50,74,4,1,36,50,26,36,9,14,0,2,10,35,50
2012-04-30 00:00:00.000,Belgrade Serbia ATP World Tour 250,CLAY,2,Andreas Seppi,Ivan Dodig,Andreas Seppi,6-4; 6-2,R16,99,0,1,44,67,26,44,13,23,5,7,9,39,67,6,6,35,63,23,35,7,28,2,7,9,30,63
2012-04-30 00:00:00.000,Belgrade Serbia ATP World Tour 250,CLAY,2,Pablo Andujar,Lukas Rosol,Pablo Andujar,6-4; 6-3,Q,86,0,1,39,54,26,39,9,15,1,2,9,35,54,4,3,36,71,27,36,9,35,9,13,10,36,71
2012-04-30 00:00:00.000,Belgrade Serbia ATP World Tour 250,CLAY,2,Benoit Paire,Jarkko Nieminen,Benoit Paire,0-6; 6-2; 7-5,Q,99,4,6,42,79,30,42,16,37,4,9,13,46,79,1,4,59,94,34,59,15,35,10,15,13,49,94
2012-04-30 00:00:00.000,Belgrade Serbia ATP World Tour 250,CLAY,2,David Nalbandian,Joao Souza,David Nalbandian,6-3; 6-2,Q,72,1,2,23,51,17,23,18,28,3,4,9,35,51,0,0,33,47,19,33,6,14,1,5,8,25,47
2012-04-30 00:00:00.000,Belgrade Serbia ATP World Tour 250,CLAY,2,Andreas Seppi,Gilles Muller,Andreas Seppi,6-4; 6-3,Q,69,7,0,39,52,31,39,8,13,1,1,9,39,52,10,1,37,59,31,37,5,22,2,5,10,36,59
2012-04-30 00:00:00.000,Belgrade Serbia ATP World Tour 250,CLAY,2,Benoit Paire,Pablo Andujar,Benoit Paire,6-3; 1-6; 6-3,S,114,7,5,43,85,34,43,18,42,5,8,13,52,85,1,6,55,81,35,55,12,26,5,8,12,47,81
2012-04-30 00:00:00.000,Belgrade Serbia ATP World Tour 250,CLAY,2,Andreas Seppi,David Nalbandian,Andreas Seppi,2-6; 6-2; 7-5,S,112,1,2,42,77,32,42,18,35,1,4,14,50,77,5,7,53,86,35,53,16,33,6,10,14,51,86
2012-04-30 00:00:00.000,Belgrade Serbia ATP World Tour 250,CLAY,2,Andreas Seppi,Benoit Paire,Andreas Seppi,6-3; 6-2,F,71,1,1,28,41,21,28,9,13,1,2,8,30,41,5,6,36,79,24,36,14,43,11,16,9,38,79
2012-04-30 00:00:00.000,Estoril Portugal ATP World Tour 250,CLAY,2,Juan Martin Del Potro,N/A Bye,Juan Martin Del Potro,,R32,0,0,0,0,0,0,0,0,0,0,0,0,0,0,0,0,0,0,0,0,0,0,0,0,0,0,0
2012-04-30 00:00:00.000,Estoril Portugal ATP World Tour 250,CLAY,2,Rui Machado,Pedro Sousa,Rui Machado,6-7(3); 6-1; 6-2,R32,122,2,8,65,98,44,65,16,33,2,4,14,60,98,3,3,67,91,37,67,10,24,5,11,13,47,91
2012-04-30 00:00:00.000,Estoril Portugal ATP World Tour 250,CLAY,2,Bobby Reynolds,Attila Balazs,Bobby Reynolds,6-3; 6-4,R32,77,2,2,46,69,34,46,13,23,3,3,10,47,69,2,1,46,65,32,46,6,19,3,5,9,38,65
2012-04-30 00:00:00.000,Estoril Portugal ATP World Tour 250,CLAY,2,Albert Montanes,Matthew Ebden,Albert Montanes,6-2; 6-3,R32,77,1,2,30,46,22,30,9,16,0,1,8,31,46,2,5,40,63,22,40,8,23,8,13,9,30,63
2012-04-30 00:00:00.000,Estoril Portugal ATP World Tour 250,CLAY,2,Stan Wawrinka,N/A Bye,Stan Wawrinka,,R32,0,0,0,0,0,0,0,0,0,0,0,0,0,0,0,0,0,0,0,0,0,0,0,0,0,0,0
2012-04-30 00:00:00.000,Estoril Portugal ATP World Tour 250,CLAY,2,Ivan Navarro,Daniel Gimeno-Traver,Ivan Navarro,7-6(5); 6-2,R32,89,0,3,40,65,35,40,9,25,6,8,10,44,65,0,0,32,58,16,32,18,26,0,4,10,34,58
2012-04-30 00:00:00.000,Estoril Portugal ATP World Tour 250,CLAY,2,Inigo Cervantes,Igor Andreev,Inigo Cervantes,6-4; 3-6; 6-3,R32,111,2,2,44,78,29,44,20,34,2,5,14,49,78,4,1,46,75,33,46,15,29,1,5,14,48,75
2012-04-30 00:00:00.000,Estoril Portugal ATP World Tour 250,CLAY,2,Robin Haase,Simone Bolelli,Robin Haase,6-3; 6-2,R32,82,4,1,42,54,27,42,9,12,3,4,9,36,54,3,3,33,59,21,33,10,26,5,9,8,31,59
2012-04-30 00:00:00.000,Estoril Portugal ATP World Tour 250,CLAY,2,Denis Istomin,Paul-Henri Mathieu,Denis Istomin,7-5; 6-1,R32,80,10,1,45,64,33,45,11,19,1,2,10,44,64,2,3,21,52,14,21,15,31,3,7,9,29,52
2012-04-30 00:00:00.000,Estoril Portugal ATP World Tour 250,CLAY,2,Joao Sousa,Gastao Elias,Joao Sousa,5-7; 6-4; 6-2,R32,131,1,4,45,81,34,45,21,36,1,4,15,55,81,3,7,58,105,40,58,22,47,9,14,15,62,105
2012-04-30 00:00:00.000,Estoril Portugal ATP World Tour 250,CLAY,2,Bjorn Phau,Frederico Gil,Bjorn Phau,6-4; 6-2,R32,80,4,3,27,52,21,27,13,25,2,4,9,34,52,0,6,34,60,23,34,7,26,2,7,9,30,60
2012-04-30 00:00:00.000,Estoril Portugal ATP World Tour 250,CLAY,2,Albert Ramos-Vinolas,N/A Bye,Albert Ramos-Vinolas,,R32,0,0,0,0,0,0,0,0,0,0,0,0,0,0,0,0,0,0,0,0,0,0,0,0,0,0,0
2012-04-30 00:00:00.000,Estoril Portugal ATP World Tour 250,CLAY,2,Flavio Cipolla,Diego Junqueira,Flavio Cipolla,6-1; 6-4,R32,81,0,2,34,50,22,34,7,16,4,7,8,29,50,0,1,48,67,19,48,9,19,4,11,9,28,67
2012-04-30 00:00:00.000,Estoril Portugal ATP World Tour 250,CLAY,2,Daniel Munoz-De La Nava,Javier Marti,Daniel Munoz-De La Nava,7-5; 6-3,R32,98,1,5,35,67,23,35,17,32,4,7,11,40,67,1,3,35,53,21,35,5,18,1,6,10,26,53
2012-04-30 00:00:00.000,Estoril Portugal ATP World Tour 250,CLAY,2,Paolo Lorenzi,Edouard Roger-Vasselin,Paolo Lorenzi,3-6; 7-6(2); 6-4,R32,158,3,1,70,108,52,70,18,38,5,7,15,70,108,5,2,64,94,49,64,14,30,1,3,16,63,94
2012-04-30 00:00:00.000,Estoril Portugal ATP World Tour 250,CLAY,2,Richard Gasquet,N/A Bye,Richard Gasquet,,R32,0,0,0,0,0,0,0,0,0,0,0,0,0,0,0,0,0,0,0,0,0,0,0,0,0,0,0
2012-04-30 00:00:00.000,Estoril Portugal ATP World Tour 250,CLAY,2,Juan Martin Del Potro,Rui Machado,Juan Martin Del Potro,6-1; 6-0,R16,62,4,1,25,43,22,25,9,18,2,2,7,31,43,0,4,26,36,12,26,0,10,1,6,6,12,36
2012-04-30 00:00:00.000,Estoril Portugal ATP World Tour 250,CLAY,2,Albert Montanes,Bobby Reynolds,Albert Montanes,4-6; 6-4; 6-3,R16,124,5,3,58,94,41,58,21,36,6,7,14,62,94,1,0,63,95,40,63,21,32,4,7,15,61,95
2012-04-30 00:00:00.000,Estoril Portugal ATP World Tour 250,CLAY,2,Stan Wawrinka,Ivan Navarro,Stan Wawrinka,7-6(5); 6-1,R16,84,6,5,46,68,34,46,12,22,3,4,10,46,68,2,3,31,59,21,31,11,28,3,6,9,32,59
2012-04-30 00:00:00.000,Estoril Portugal ATP World Tour 250,CLAY,2,Robin Haase,Inigo Cervantes,Robin Haase,5-7; 6-4; 6-2,R16,130,3,0,49,81,36,49,18,32,2,5,15,54,81,6,1,52,97,30,52,26,45,3,8,15,56,97
2012-04-30 00:00:00.000,Estoril Portugal ATP World Tour 250,CLAY,2,Joao Sousa,Denis Istomin,Joao Sousa,3-6; 6-3; 4-2 RET,R16,121,0,1,59,103,35,59,19,44,9,14,12,54,103,3,5,37,66,21,37,10,29,4,10,12,31,66
2012-04-30 00:00:00.000,Estoril Portugal ATP World Tour 250,CLAY,2,Albert Ramos-Vinolas,Bjorn Phau,Albert Ramos-Vinolas,7-5; 6-0,R16,91,5,0,29,56,19,29,17,27,1,2,9,36,56,2,3,30,59,19,30,10,29,4,9,9,29,59
2012-04-30 00:00:00.000,Estoril Portugal ATP World Tour 250,CLAY,2,Daniel Munoz-De La Nava,Flavio Cipolla,Daniel Munoz-De La Nava,6-4; 6-4,R16,118,0,3,47,71,32,47,9,24,9,13,10,41,71,1,5,61,82,29,61,9,21,16,22,10,38,82
2012-04-30 00:00:00.000,Estoril Portugal ATP World Tour 250,CLAY,2,Richard Gasquet,Paolo Lorenzi,Richard Gasquet,6-1; 6-1,R16,67,3,1,22,41,19,22,10,19,1,1,7,29,41,0,0,25,41,13,25,3,16,1,6,7,16,41
2012-04-30 00:00:00.000,Estoril Portugal ATP World Tour 250,CLAY,2,Juan Martin Del Potro,Albert Montanes,Juan Martin Del Potro,6-2; 6-2,Q,77,5,2,27,44,18,27,11,17,1,3,8,29,44,0,4,40,62,18,40,8,22,4,10,8,26,62
2012-04-30 00:00:00.000,Estoril Portugal ATP World Tour 250,CLAY,2,Stan Wawrinka,Robin Haase,Stan Wawrinka,6-1; 6-4,Q,59,5,2,27,55,21,27,17,28,5,6,9,38,55,1,1,19,41,12,19,9,22,1,5,8,21,41
2012-04-30 00:00:00.000,Estoril Portugal ATP World Tour 250,CLAY,2,Albert Ramos-Vinolas,Joao Sousa,Albert Ramos-Vinolas,6-2; 6-3,Q,88,1,1,26,50,20,26,14,24,3,3,8,34,50,0,4,32,56,18,32,14,24,4,8,9,32,56
2012-04-30 00:00:00.000,Estoril Portugal ATP World Tour 250,CLAY,2,Richard Gasquet,Daniel Munoz-De La Nava,Richard Gasquet,7-6(1); 6-2,Q,111,2,1,41,64,32,41,13,23,2,3,10,45,64,1,0,34,69,20,34,19,35,2,5,10,39,69
2012-04-30 00:00:00.000,Estoril Portugal ATP World Tour 250,CLAY,2,Juan Martin Del Potro,Stan Wawrinka,Juan Martin Del Potro,7-6(2); 6-4,S,93,5,0,45,65,35,45,15,20,0,0,11,50,65,3,1,44,67,28,44,17,23,6,7,11,45,67
2012-04-30 00:00:00.000,Estoril Portugal ATP World Tour 250,CLAY,2,Richard Gasquet,Albert Ramos-Vinolas,Richard Gasquet,2-6; 7-6(1); 7-5,S,182,5,2,74,112,54,74,16,38,6,10,16,70,112,5,3,62,110,40,62,26,48,5,8,16,66,110
2012-04-30 00:00:00.000,Estoril Portugal ATP World Tour 250,CLAY,2,Juan Martin Del Potro,Richard Gasquet,Juan Martin Del Potro,6-4; 6-2,F,87,6,2,31,46,24,31,12,15,0,0,9,36,46,1,1,41,67,23,41,14,26,5,8,9,37,67
2012-04-30 00:00:00.000,Munich Germany ATP World Tour 250,CLAY,2,Jo-Wilfried Tsonga,N/A Bye,Jo-Wilfried Tsonga,,R32,0,0,0,0,0,0,0,0,0,0,0,0,0,0,0,0,0,0,0,0,0,0,0,0,0,0,0
2012-04-30 00:00:00.000,Munich Germany ATP World Tour 250,CLAY,2,Tommy Haas,Michael Berrer,Tommy Haas,6-0; 6-2,R32,52,6,0,17,31,17,17,11,14,0,0,7,28,31,0,4,27,41,14,27,2,14,4,9,7,16,41
2012-04-30 00:00:00.000,Munich Germany ATP World Tour 250,CLAY,2,Dustin Brown,Daniel Brands,Dustin Brown,6-4; 6-3,R32,63,9,4,43,63,33,43,11,20,8,8,10,44,63,8,1,30,49,23,30,10,19,3,5,9,33,49
2012-04-30 00:00:00.000,Munich Germany ATP World Tour 250,CLAY,2,Marcos Baghdatis,Tobias Kamke,Marcos Baghdatis,6-1; 3-6; 6-3,R32,117,4,4,57,88,42,57,16,31,6,8,13,58,88,1,5,55,83,37,55,8,28,5,9,12,45,83
2012-04-30 00:00:00.000,Munich Germany ATP World Tour 250,CLAY,2,Marin Cilic,N/A Bye,Marin Cilic,,R32,0,0,0,0,0,0,0,0,0,0,0,0,0,0,0,0,0,0,0,0,0,0,0,0,0,0,0
2012-04-30 00:00:00.000,Munich Germany ATP World Tour 250,CLAY,2,Matthias Bachinger,Alejandro Falla,Matthias Bachinger,7-6(3); 6-2,R32,83,5,0,32,55,29,32,17,23,0,0,10,46,55,4,1,42,67,28,42,14,25,3,5,10,42,67
2012-04-30 00:00:00.000,Munich Germany ATP World Tour 250,CLAY,2,Santiago Giraldo,Steve Darcis,Santiago Giraldo,6-4; 6-3,R32,77,4,1,49,68,37,49,10,19,3,3,10,47,68,2,2,33,44,27,33,3,11,1,3,9,30,44
2012-04-30 00:00:00.000,Munich Germany ATP World Tour 250,CLAY,2,Mikhail Youzhny,Philipp Petzschner,Mikhail Youzhny,7-5; 7-5,R32,106,4,3,46,76,34,46,14,30,3,6,12,48,76,7,3,44,69,27,44,11,25,1,6,12,38,69
2012-04-30 00:00:00.000,Munich Germany ATP World Tour 250,CLAY,2,Robert Farah,Nikolay Davydenko,Robert Farah,6-3; 6-2,R32,82,3,1,40,59,29,40,11,19,3,3,8,40,59,0,3,39,55,23,39,5,16,2,6,9,28,55
2012-04-30 00:00:00.000,Munich Germany ATP World Tour 250,CLAY,2,Marinko Matosevic,Mikhail Kukushkin,Marinko Matosevic,7-5; 6-1,R32,76,2,2,42,62,27,42,12,20,5,7,10,39,62,0,2,24,47,13,24,11,23,2,7,9,24,47
2012-04-30 00:00:00.000,Munich Germany ATP World Tour 250,CLAY,2,Ernests Gulbis,Xavier Malisse,Ernests Gulbis,6-4; 6-2,R32,82,6,1,35,57,28,35,12,22,3,3,9,40,57,2,2,35,63,22,35,13,28,5,8,9,35,63
2012-04-30 00:00:00.000,Munich Germany ATP World Tour 250,CLAY,2,Philipp Kohlschreiber,N/A Bye,Philipp Kohlschreiber,,R32,0,0,0,0,0,0,0,0,0,0,0,0,0,0,0,0,0,0,0,0,0,0,0,0,0,0,0
2012-04-30 00:00:00.000,Munich Germany ATP World Tour 250,CLAY,2,Bernard Tomic,Olivier Rochus,Bernard Tomic,6-4; 6-3,R32,69,9,2,37,59,26,37,13,22,2,3,10,39,59,0,3,37,56,28,37,3,19,1,4,9,31,56
2012-04-30 00:00:00.000,Munich Germany ATP World Tour 250,CLAY,2,Potito Starace,David Goffin,Potito Starace,6-3; 7-6(3),R32,101,3,0,54,71,39,54,12,17,4,4,11,51,71,2,3,45,79,29,45,20,34,5,6,10,49,79
2012-04-30 00:00:00.000,Munich Germany ATP World Tour 250,CLAY,2,Sergiy Stakhovsky,Cedrik-Marcel Stebe,Sergiy Stakhovsky,7-6(3); 6-3,R32,106,5,1,36,66,29,36,19,30,2,2,10,48,66,1,1,49,80,28,49,16,31,5,7,11,44,80
2012-04-30 00:00:00.000,Munich Germany ATP World Tour 250,CLAY,2,Feliciano Lopez,N/A Bye,Feliciano Lopez,,R32,0,0,0,0,0,0,0,0,0,0,0,0,0,0,0,0,0,0,0,0,0,0,0,0,0,0,0
2012-04-30 00:00:00.000,Munich Germany ATP World Tour 250,CLAY,2,Tommy Haas,Jo-Wilfried Tsonga,Tommy Haas,6-1; 6-4,R16,60,4,3,35,50,29,35,8,15,0,0,9,37,50,3,1,32,46,21,32,4,14,1,4,8,25,46
2012-04-30 00:00:00.000,Munich Germany ATP World Tour 250,CLAY,2,Marcos Baghdatis,Dustin Brown,Marcos Baghdatis,1-6; 6-4; 6-4,R16,108,5,2,48,83,27,48,27,35,1,4,14,54,83,5,2,47,88,33,47,23,41,5,7,13,56,88
2012-04-30 00:00:00.000,Munich Germany ATP World Tour 250,CLAY,2,Marin Cilic,Matthias Bachinger,Marin Cilic,6-3; 6-2,R16,71,5,2,31,46,25,31,8,15,0,0,8,33,46,4,2,32,56,19,32,11,24,3,7,9,30,56
2012-04-30 00:00:00.000,Munich Germany ATP World Tour 250,CLAY,2,Mikhail Youzhny,Santiago Giraldo,Mikhail Youzhny,6-7(2); 6-4; 6-4,R16,161,13,0,75,108,55,75,19,33,5,5,16,74,108,5,0,83,106,60,83,12,23,2,4,16,72,106
2012-04-30 00:00:00.000,Munich Germany ATP World Tour 250,CLAY,2,Marinko Matosevic,Robert Farah,Marinko Matosevic,6-1; 6-7(2); 6-2,R16,148,4,3,69,104,48,69,18,35,5,6,14,66,104,7,5,57,90,34,57,17,33,9,14,13,51,90
2012-04-30 00:00:00.000,Munich Germany ATP World Tour 250,CLAY,2,Philipp Kohlschreiber,Ernests Gulbis,Philipp Kohlschreiber,7-5; 6-3,R16,97,6,0,37,56,31,37,14,19,1,1,11,45,56,8,2,37,72,27,37,18,35,5,7,10,45,72
2012-04-30 00:00:00.000,Munich Germany ATP World Tour 250,CLAY,2,Bernard Tomic,Potito Starace,Bernard Tomic,6-1; 6-7(4); 6-3,R16,124,6,1,69,102,48,69,17,33,4,6,15,65,102,4,1,65,101,36,65,19,36,3,8,13,55,101
2012-04-30 00:00:00.000,Munich Germany ATP World Tour 250,CLAY,2,Feliciano Lopez,Sergiy Stakhovsky,Feliciano Lopez,6-4; 7-6(4),R16,87,6,0,45,67,34,45,16,22,1,1,11,50,67,6,3,48,76,34,48,17,28,2,3,11,51,76
2012-04-30 00:00:00.000,Munich Germany ATP World Tour 250,CLAY,2,Tommy Haas,Marcos Baghdatis,Tommy Haas,6-1; 7-6(3),Q,89,6,1,46,73,34,46,16,27,3,3,10,50,73,5,3,35,56,24,35,9,21,0,2,9,33,56
2012-04-30 00:00:00.000,Munich Germany ATP World Tour 250,CLAY,2,Marin Cilic,Mikhail Youzhny,Marin Cilic,6-3; 6-7(6); 6-3,Q,165,11,1,71,119,55,71,24,48,7,8,16,79,119,3,1,64,93,44,64,15,29,2,5,14,59,93
2012-04-30 00:00:00.000,Munich Germany ATP World Tour 250,CLAY,2,Philipp Kohlschreiber,Marinko Matosevic,Philipp Kohlschreiber,6-0; 7-6(5),Q,97,6,2,41,63,30,41,14,22,2,3,9,44,63,3,2,51,76,26,51,14,25,6,10,9,40,76
2012-04-30 00:00:00.000,Munich Germany ATP World Tour 250,CLAY,2,Feliciano Lopez,Bernard Tomic,Feliciano Lopez,6-4; 6-2,Q,56,14,1,33,44,30,33,6,11,0,0,9,36,44,3,0,35,53,23,35,7,18,4,7,9,30,53
2012-04-30 00:00:00.000,Munich Germany ATP World Tour 250,CLAY,2,Marin Cilic,Tommy Haas,Marin Cilic,6-3; 6-4,S,75,6,0,28,45,25,28,15,17,0,0,10,40,45,2,2,38,60,23,38,12,22,4,6,9,35,60
2012-04-30 00:00:00.000,Munich Germany ATP World Tour 250,CLAY,2,Philipp Kohlschreiber,Feliciano Lopez,Philipp Kohlschreiber,6-2; 6-7(4); 6-4,S,139,12,5,66,101,49,66,22,35,5,5,15,71,101,12,3,62,100,45,62,19,38,10,13,15,64,100
2012-04-30 00:00:00.000,Munich Germany ATP World Tour 250,CLAY,2,Philipp Kohlschreiber,Marin Cilic,Philipp Kohlschreiber,7-6(8); 6-3,F,109,4,2,61,82,45,61,13,21,7,8,11,58,82,3,2,25,67,18,25,25,42,0,2,10,43,67
2012-05-06 00:00:00.000,ATP World Tour Masters 1000 Madrid Spain ATP World Tour Masters 1000,CLAY,2,Novak Djokovic,N/A Bye,Novak Djokovic,,R64,0,0,0,0,0,0,0,0,0,0,0,0,0,0,0,0,0,0,0,0,0,0,0,0,0,0,0
2012-05-06 00:00:00.000,ATP World Tour Masters 1000 Madrid Spain ATP World Tour Masters 1000,CLAY,2,Daniel Gimeno-Traver,Victor Hanescu,Daniel Gimeno-Traver,7-6(3); 4-6; 6-3,R64,145,7,2,60,105,48,60,26,45,7,8,16,74,105,7,1,74,104,52,74,17,30,3,4,15,69,104
2012-05-06 00:00:00.000,ATP World Tour Masters 1000 Madrid Spain ATP World Tour Masters 1000,CLAY,2,Stan Wawrinka,Olivier Rochus,Stan Wawrinka,6-4; 7-6(3),R64,83,14,1,41,62,36,41,11,21,0,1,11,47,62,2,1,52,79,35,52,12,27,4,6,11,47,79
2012-05-06 00:00:00.000,ATP World Tour Masters 1000 Madrid Spain ATP World Tour Masters 1000,CLAY,2,Jurgen Melzer,Feliciano Lopez,Jurgen Melzer,3-6; 7-6(6); 6-4,R64,130,10,4,72,99,49,72,18,27,5,7,15,67,99,10,1,51,88,38,51,25,37,1,3,16,63,88
2012-05-06 00:00:00.000,ATP World Tour Masters 1000 Madrid Spain ATP World Tour Masters 1000,CLAY,2,Gilles Simon,Fabio Fognini,Gilles Simon,6-7(1); 6-3; 6-3,R64,149,2,2,44,83,29,44,20,39,2,7,15,49,83,0,3,80,116,45,80,11,36,10,18,15,56,116
2012-05-06 00:00:00.000,ATP World Tour Masters 1000 Madrid Spain ATP World Tour Masters 1000,CLAY,2,Guillermo Garcia-Lopez,Marcos Baghdatis,Guillermo Garcia-Lopez,6-4; 3-6; 6-4,R64,144,6,1,55,89,39,55,21,34,1,3,14,60,89,8,1,60,101,44,60,18,41,8,11,15,62,101
2012-05-06 00:00:00.000,ATP World Tour Masters 1000 Madrid Spain ATP World Tour Masters 1000,CLAY,2,Federico Delbonis,Albert Ramos-Vinolas,Federico Delbonis,6-3; 6-2,R64,72,3,0,38,53,30,38,9,15,3,3,9,39,53,0,1,32,52,20,32,8,20,4,7,8,28,52
2012-05-06 00:00:00.000,ATP World Tour Masters 1000 Madrid Spain ATP World Tour Masters 1000,CLAY,2,Janko Tipsarevic,N/A Bye,Janko Tipsarevic,,R64,0,0,0,0,0,0,0,0,0,0,0,0,0,0,0,0,0,0,0,0,0,0,0,0,0,0,0
2012-05-06 00:00:00.000,ATP World Tour Masters 1000 Madrid Spain ATP World Tour Masters 1000,CLAY,2,Roger Federer,N/A Bye,Roger Federer,,R64,0,0,0,0,0,0,0,0,0,0,0,0,0,0,0,0,0,0,0,0,0,0,0,0,0,0,0
2012-05-06 00:00:00.000,ATP World Tour Masters 1000 Madrid Spain ATP World Tour Masters 1000,CLAY,2,Milos Raonic,David Nalbandian,Milos Raonic,6-4; 6-4,R64,75,16,2,27,46,27,27,13,19,0,0,10,40,46,1,2,32,59,26,32,11,27,1,3,10,37,59
2012-05-06 00:00:00.000,ATP World Tour Masters 1000 Madrid Spain ATP World Tour Masters 1000,CLAY,2,Viktor Troicki,Donald Young,Viktor Troicki,6-1; 4-6; 6-1,R64,113,2,1,52,84,33,52,17,32,9,12,12,50,84,4,5,46,84,26,46,12,38,9,16,12,38,84
2012-05-06 00:00:00.000,ATP World Tour Masters 1000 Madrid Spain ATP World Tour Masters 1000,CLAY,2,Richard Gasquet,Thomaz Bellucci,Richard Gasquet,4-6; 6-4; 7-6(5),R64,163,8,0,67,105,50,67,21,38,5,7,16,71,105,6,2,60,109,44,60,27,49,6,8,16,71,109
2012-05-06 00:00:00.000,ATP World Tour Masters 1000 Madrid Spain ATP World Tour Masters 1000,CLAY,2,Nicolas Almagro,Santiago Giraldo,Nicolas Almagro,6-7(5); 6-3; 6-3,R64,130,11,3,44,82,36,44,27,38,0,0,15,63,82,4,3,69,104,48,69,15,35,2,5,15,63,104
2012-05-06 00:00:00.000,ATP World Tour Masters 1000 Madrid Spain ATP World Tour Masters 1000,CLAY,2,Marcel Granollers,Carlos Berlocq,Marcel Granollers,7-5; 3-6; 7-5,R64,190,2,2,83,113,50,83,11,30,5,10,16,61,113,4,2,63,99,36,63,23,36,8,14,17,59,99
2012-05-06 00:00:00.000,ATP World Tour Masters 1000 Madrid Spain ATP World Tour Masters 1000,CLAY,2,Radek Stepanek,Bernard Tomic,Radek Stepanek,6-2; 7-5,R64,85,4,4,35,66,28,35,15,31,6,7,10,43,66,1,3,46,74,23,46,16,28,7,11,10,39,74
2012-05-06 00:00:00.000,ATP World Tour Masters 1000 Madrid Spain ATP World Tour Masters 1000,CLAY,2,David Ferrer,N/A Bye,David Ferrer,,R64,0,0,0,0,0,0,0,0,0,0,0,0,0,0,0,0,0,0,0,0,0,0,0,0,0,0,0
2012-05-06 00:00:00.000,ATP World Tour Masters 1000 Madrid Spain ATP World Tour Masters 1000,CLAY,2,John Isner,N/A Bye,John Isner,,R64,0,0,0,0,0,0,0,0,0,0,0,0,0,0,0,0,0,0,0,0,0,0,0,0,0,0,0
2012-05-06 00:00:00.000,ATP World Tour Masters 1000 Madrid Spain ATP World Tour Masters 1000,CLAY,2,Marin Cilic,Albert Montanes,Marin Cilic,6-3; 6-3,R64,78,3,3,31,67,21,31,25,36,7,7,9,46,67,2,1,40,57,25,40,8,17,5,8,9,33,57
2012-05-06 00:00:00.000,ATP World Tour Masters 1000 Madrid Spain ATP World Tour Masters 1000,CLAY,2,Mikhail Youzhny,Javier Marti,Mikhail Youzhny,6-3; 6-2,R64,76,1,0,39,56,27,39,10,17,2,4,9,37,56,1,3,26,48,13,26,9,22,1,6,8,22,48
2012-05-06 00:00:00.000,ATP World Tour Masters 1000 Madrid Spain ATP World Tour Masters 1000,CLAY,2,Juan Martin Del Potro,Florian Mayer,Juan Martin Del Potro,6-4; 6-2,R64,76,8,1,37,52,28,37,7,15,1,2,9,35,52,4,1,30,53,18,30,10,23,3,7,9,28,53
2012-05-06 00:00:00.000,ATP World Tour Masters 1000 Madrid Spain ATP World Tour Masters 1000,CLAY,2,Alexandr Dolgopolov,Pablo Andujar,Alexandr Dolgopolov,7-6(5); 6-4,R64,100,10,1,36,69,31,36,15,33,2,3,11,46,69,0,7,39,76,25,39,20,37,3,5,11,45,76
2012-05-06 00:00:00.000,ATP World Tour Masters 1000 Madrid Spain ATP World Tour Masters 1000,CLAY,2,Andreas Seppi,Michael Llodra,Andreas Seppi,7-5; 6-4,R64,85,3,4,58,79,44,58,8,21,5,6,11,52,79,7,1,44,71,27,44,13,27,5,8,11,40,71
2012-05-06 00:00:00.000,ATP World Tour Masters 1000 Madrid Spain ATP World Tour Masters 1000,CLAY,2,Ryan Harrison,Sergiy Stakhovsky,Ryan Harrison,7-6(3); 7-6(5),R64,113,7,3,64,96,51,64,13,32,10,11,12,64,96,1,2,63,85,44,63,10,22,2,3,12,54,85
2012-05-06 00:00:00.000,ATP World Tour Masters 1000 Madrid Spain ATP World Tour Masters 1000,CLAY,2,Jo-Wilfried Tsonga,N/A Bye,Jo-Wilfried Tsonga,,R64,0,0,0,0,0,0,0,0,0,0,0,0,0,0,0,0,0,0,0,0,0,0,0,0,0,0,0
2012-05-06 00:00:00.000,ATP World Tour Masters 1000 Madrid Spain ATP World Tour Masters 1000,CLAY,2,Tomas Berdych,N/A Bye,Tomas Berdych,,R64,0,0,0,0,0,0,0,0,0,0,0,0,0,0,0,0,0,0,0,0,0,0,0,0,0,0,0
2012-05-06 00:00:00.000,ATP World Tour Masters 1000 Madrid Spain ATP World Tour Masters 1000,CLAY,2,Kevin Anderson,Alex Bogomolov Jr.,Kevin Anderson,6-3; 6-2,R64,81,6,2,39,58,29,39,10,19,4,4,8,39,58,2,2,34,56,20,34,10,22,3,7,9,30,56
2012-05-06 00:00:00.000,ATP World Tour Masters 1000 Madrid Spain ATP World Tour Masters 1000,CLAY,2,Igor Andreev,Juan Carlos Ferrero,Igor Andreev,6-4; 7-6(4),R64,99,11,2,46,77,37,46,16,31,5,5,11,53,77,6,0,46,67,33,46,14,21,3,4,11,47,67
2012-05-06 00:00:00.000,ATP World Tour Masters 1000 Madrid Spain ATP World Tour Masters 1000,CLAY,2,Gael Monfils,Philipp Kohlschreiber,Gael Monfils,7-5; 6-7(2); 6-3,R64,130,11,2,69,108,52,69,19,39,4,6,17,71,108,3,2,63,101,47,63,16,38,4,8,16,63,101
2012-05-06 00:00:00.000,ATP World Tour Masters 1000 Madrid Spain ATP World Tour Masters 1000,CLAY,2,Fernando Verdasco,Denis Istomin,Fernando Verdasco,7-5; 6-2,R64,81,2,2,37,50,33,37,7,13,0,0,10,40,50,6,0,44,58,27,44,8,14,2,5,10,35,58
2012-05-06 00:00:00.000,ATP World Tour Masters 1000 Madrid Spain ATP World Tour Masters 1000,CLAY,2,Alejandro Falla,Juan Ignacio Chela,Alejandro Falla,6-3; 2-6; 6-2,R64,112,4,0,52,79,39,52,10,27,3,7,13,49,79,3,1,58,87,34,58,12,29,7,12,12,46,87
2012-05-06 00:00:00.000,ATP World Tour Masters 1000 Madrid Spain ATP World Tour Masters 1000,CLAY,2,Nikolay Davydenko,Ivo Karlovic,Nikolay Davydenko,7-6(4); 6-3,R64,87,4,1,59,72,46,59,7,13,6,6,11,53,72,15,1,40,63,31,40,12,23,2,3,10,43,63
2012-05-06 00:00:00.000,ATP World Tour Masters 1000 Madrid Spain ATP World Tour Masters 1000,CLAY,2,Rafael Nadal,N/A Bye,Rafael Nadal,,R64,0,0,0,0,0,0,0,0,0,0,0,0,0,0,0,0,0,0,0,0,0,0,0,0,0,0,0
2012-05-06 00:00:00.000,ATP World Tour Masters 1000 Madrid Spain ATP World Tour Masters 1000,CLAY,2,Novak Djokovic,Daniel Gimeno-Traver,Novak Djokovic,6-2; 2-6; 6-3,R32,107,7,4,40,65,35,40,14,25,3,5,13,49,65,7,0,57,91,37,57,18,34,9,12,12,55,91
2012-05-06 00:00:00.000,ATP World Tour Masters 1000 Madrid Spain ATP World Tour Masters 1000,CLAY,2,Stan Wawrinka,Jurgen Melzer,Stan Wawrinka,6-1; 6-4,R32,62,5,1,25,47,21,25,17,22,1,1,9,38,47,1,0,37,54,17,37,13,17,0,3,8,30,54
2012-05-06 00:00:00.000,ATP World Tour Masters 1000 Madrid Spain ATP World Tour Masters 1000,CLAY,2,Gilles Simon,Guillermo Garcia-Lopez,Gilles Simon,6-4; 6-3,R32,91,5,1,27,52,25,27,14,25,1,1,9,39,52,3,4,37,80,25,37,22,43,9,12,10,47,80
2012-05-06 00:00:00.000,ATP World Tour Masters 1000 Madrid Spain ATP World Tour Masters 1000,CLAY,2,Janko Tipsarevic,Federico Delbonis,Janko Tipsarevic,7-6(5); 6-7(6); 6-3,R32,155,13,4,66,105,54,66,20,39,0,1,17,74,105,7,3,71,107,51,71,21,36,3,5,16,72,107
2012-05-06 00:00:00.000,ATP World Tour Masters 1000 Madrid Spain ATP World Tour Masters 1000,CLAY,2,Roger Federer,Milos Raonic,Roger Federer,4-6; 7-5; 7-6(4),R32,134,7,2,71,111,56,71,21,40,7,8,17,77,111,21,1,57,91,49,57,20,34,1,2,17,69,91
2012-05-06 00:00:00.000,ATP World Tour Masters 1000 Madrid Spain ATP World Tour Masters 1000,CLAY,2,Richard Gasquet,Viktor Troicki,Richard Gasquet,7-5; 6-3,R32,87,3,0,30,53,25,30,19,23,0,0,11,44,53,10,2,45,68,32,45,10,23,2,4,10,42,68
2012-05-06 00:00:00.000,ATP World Tour Masters 1000 Madrid Spain ATP World Tour Masters 1000,CLAY,2,Nicolas Almagro,Marcel Granollers,Nicolas Almagro,6-3; 7-6(3),R32,78,5,1,29,58,25,29,19,29,1,2,11,44,58,2,1,38,57,29,38,8,19,0,2,10,37,57
2012-05-06 00:00:00.000,ATP World Tour Masters 1000 Madrid Spain ATP World Tour Masters 1000,CLAY,2,David Ferrer,Radek Stepanek,David Ferrer,7-6(4); 6-2,R32,87,3,0,37,59,31,37,14,22,1,1,10,45,59,1,5,37,57,27,37,11,20,1,3,10,38,57
2012-05-06 00:00:00.000,ATP World Tour Masters 1000 Madrid Spain ATP World Tour Masters 1000,CLAY,2,Marin Cilic,John Isner,Marin Cilic,7-6(4); 7-6(3),R32,117,7,6,42,88,32,42,31,46,3,3,12,63,88,14,2,54,87,40,54,20,33,2,2,12,60,87
2012-05-06 00:00:00.000,ATP World Tour Masters 1000 Madrid Spain ATP World Tour Masters 1000,CLAY,2,Juan Martin Del Potro,Mikhail Youzhny,Juan Martin Del Potro,6-4; 7-6(1),R32,121,6,0,53,76,40,53,11,23,6,8,11,51,76,4,3,41,72,26,41,17,31,5,8,11,43,72
2012-05-06 00:00:00.000,ATP World Tour Masters 1000 Madrid Spain ATP World Tour Masters 1000,CLAY,2,Alexandr Dolgopolov,Andreas Seppi,Alexandr Dolgopolov,6-7(5); 7-6(5); 6-3,R32,135,15,5,55,116,39,55,32,61,5,8,17,71,116,5,1,57,100,40,57,21,43,4,8,16,61,100
2012-05-06 00:00:00.000,ATP World Tour Masters 1000 Madrid Spain ATP World Tour Masters 1000,CLAY,2,Jo-Wilfried Tsonga,Ryan Harrison,Jo-Wilfried Tsonga,6-2; 7-6(4),R32,82,4,0,45,58,36,45,8,13,0,0,10,44,58,4,3,50,66,35,50,5,16,4,6,10,40,66
2012-05-06 00:00:00.000,ATP World Tour Masters 1000 Madrid Spain ATP World Tour Masters 1000,CLAY,2,Tomas Berdych,Kevin Anderson,Tomas Berdych,6-4; 6-3,R32,81,11,2,40,58,33,40,9,18,3,3,10,42,58,7,4,32,50,23,32,9,18,1,3,9,32,50
2012-05-06 00:00:00.000,ATP World Tour Masters 1000 Madrid Spain ATP World Tour Masters 1000,CLAY,2,Gael Monfils,Igor Andreev,Gael Monfils,6-3; 1-0 RET,R32,39,3,0,19,32,13,19,9,13,3,3,5,22,32,0,0,15,26,8,15,8,11,0,2,5,16,26
2012-05-06 00:00:00.000,ATP World Tour Masters 1000 Madrid Spain ATP World Tour Masters 1000,CLAY,2,Fernando Verdasco,Alejandro Falla,Fernando Verdasco,6-7(4); 6-4; 6-4,R32,166,3,4,69,101,51,69,15,32,1,3,16,66,101,4,3,70,109,44,70,21,39,2,6,16,65,109
2012-05-06 00:00:00.000,ATP World Tour Masters 1000 Madrid Spain ATP World Tour Masters 1000,CLAY,2,Rafael Nadal,Nikolay Davydenko,Rafael Nadal,6-2; 6-2,R32,80,6,0,30,43,24,30,9,13,0,0,8,33,43,0,5,28,51,16,28,7,23,5,9,8,23,51
2012-05-06 00:00:00.000,ATP World Tour Masters 1000 Madrid Spain ATP World Tour Masters 1000,CLAY,2,Novak Djokovic,Stan Wawrinka,Novak Djokovic,7-6(5); 6-4,R16,105,7,2,44,61,36,44,11,17,0,1,11,47,61,7,4,43,82,32,43,17,39,8,10,11,49,82
2012-05-06 00:00:00.000,ATP World Tour Masters 1000 Madrid Spain ATP World Tour Masters 1000,CLAY,2,Janko Tipsarevic,Gilles Simon,Janko Tipsarevic,7-6(3); 5-7; 6-1,R16,158,14,1,55,85,40,55,23,30,0,1,15,63,85,7,4,62,111,44,62,26,49,11,14,16,70,111
2012-05-06 00:00:00.000,ATP World Tour Masters 1000 Madrid Spain ATP World Tour Masters 1000,CLAY,2,Roger Federer,Richard Gasquet,Roger Federer,6-3; 6-2,R16,58,10,0,38,54,33,38,6,16,2,2,9,39,54,2,3,26,43,17,26,8,17,3,6,8,25,43
2012-05-06 00:00:00.000,ATP World Tour Masters 1000 Madrid Spain ATP World Tour Masters 1000,CLAY,2,David Ferrer,Nicolas Almagro,David Ferrer,7-6(5); 3-6; 7-6(8),R16,174,13,1,79,125,56,79,22,46,11,14,16,78,125,13,1,71,121,55,71,22,50,4,6,17,77,121
2012-05-06 00:00:00.000,ATP World Tour Masters 1000 Madrid Spain ATP World Tour Masters 1000,CLAY,2,Juan Martin Del Potro,Marin Cilic,Juan Martin Del Potro,6-2; 6-4,R16,98,6,0,35,57,29,35,12,22,6,6,9,41,57,4,2,28,67,18,28,18,39,4,7,9,36,67
2012-05-06 00:00:00.000,ATP World Tour Masters 1000 Madrid Spain ATP World Tour Masters 1000,CLAY,2,Alexandr Dolgopolov,Jo-Wilfried Tsonga,Alexandr Dolgopolov,7-5; 3-6; 7-6(2),R16,139,6,1,59,96,42,59,23,37,5,9,16,65,96,12,2,71,111,47,71,21,40,4,8,17,68,111
2012-05-06 00:00:00.000,ATP World Tour Masters 1000 Madrid Spain ATP World Tour Masters 1000,CLAY,2,Tomas Berdych,Gael Monfils,Tomas Berdych,6-1; 6-1,R16,50,4,0,23,32,21,23,7,9,0,0,7,28,32,2,2,20,39,9,20,6,19,1,6,7,15,39
2012-05-06 00:00:00.000,ATP World Tour Masters 1000 Madrid Spain ATP World Tour Masters 1000,CLAY,2,Fernando Verdasco,Rafael Nadal,Fernando Verdasco,6-3; 3-6; 7-5,R16,190,5,9,63,101,39,63,15,38,9,15,15,54,101,7,2,55,83,31,55,12,28,3,10,15,43,83
2012-05-06 00:00:00.000,ATP World Tour Masters 1000 Madrid Spain ATP World Tour Masters 1000,CLAY,2,Janko Tipsarevic,Novak Djokovic,Janko Tipsarevic,7-6(2); 6-3,Q,103,7,2,56,80,44,56,13,24,7,7,11,57,80,3,4,30,56,27,30,13,26,3,4,10,40,56
2012-05-06 00:00:00.000,ATP World Tour Masters 1000 Madrid Spain ATP World Tour Masters 1000,CLAY,2,Roger Federer,David Ferrer,Roger Federer,6-4; 6-4,Q,82,7,0,36,46,31,36,9,10,0,0,10,40,46,3,7,48,83,33,48,16,35,6,8,10,49,83
2012-05-06 00:00:00.000,ATP World Tour Masters 1000 Madrid Spain ATP World Tour Masters 1000,CLAY,2,Juan Martin Del Potro,Alexandr Dolgopolov,Juan Martin Del Potro,6-3; 6-4,Q,84,10,2,38,62,29,38,14,24,1,2,10,43,62,4,3,16,52,12,16,17,36,4,7,9,29,52
2012-05-06 00:00:00.000,ATP World Tour Masters 1000 Madrid Spain ATP World Tour Masters 1000,CLAY,2,Tomas Berdych,Fernando Verdasco,Tomas Berdych,6-1; 6-2,Q,67,4,0,26,41,20,26,12,15,0,0,8,32,41,2,4,22,35,12,22,4,13,0,4,7,16,35
2012-05-06 00:00:00.000,ATP World Tour Masters 1000 Madrid Spain ATP World Tour Masters 1000,CLAY,2,Roger Federer,Janko Tipsarevic,Roger Federer,6-2; 6-3,S,67,8,3,36,51,27,36,12,15,1,1,9,39,51,5,1,22,50,17,22,12,28,2,5,8,29,50
2012-05-06 00:00:00.000,ATP World Tour Masters 1000 Madrid Spain ATP World Tour Masters 1000,CLAY,2,Tomas Berdych,Juan Martin Del Potro,Tomas Berdych,7-6(5); 7-6(6),S,138,15,4,50,83,38,50,17,33,3,5,12,55,83,6,0,47,75,35,47,16,28,0,2,12,51,75
2012-05-06 00:00:00.000,ATP World Tour Masters 1000 Madrid Spain ATP World Tour Masters 1000,CLAY,2,Roger Federer,Tomas Berdych,Roger Federer,3-6; 7-5; 7-5,F,158,13,2,68,104,51,68,15,36,6,9,16,66,104,10,4,55,100,37,55,26,45,7,11,17,63,100
2012-05-13 00:00:00.000,ATP World Tour Masters 1000 Rome Italy ATP World Tour Masters 1000,CLAY,2,Novak Djokovic,N/A Bye,Novak Djokovic,,R64,0,0,0,0,0,0,0,0,0,0,0,0,0,0,0,0,0,0,0,0,0,0,0,0,0,0,0
2012-05-13 00:00:00.000,ATP World Tour Masters 1000 Rome Italy ATP World Tour Masters 1000,CLAY,2,Bernard Tomic,Santiago Giraldo,Bernard Tomic,4-6; 6-2; 6-4,R64,121,4,0,64,86,44,64,11,22,4,6,14,55,86,0,0,52,82,31,52,19,30,5,9,14,50,82
2012-05-13 00:00:00.000,ATP World Tour Masters 1000 Rome Italy ATP World Tour Masters 1000,CLAY,2,Radek Stepanek,Juan Ignacio Chela,Radek Stepanek,2-6; 6-0; 6-3,R64,115,0,2,50,74,37,50,12,24,2,4,12,49,74,1,3,45,73,27,45,14,28,5,9,11,41,73
2012-05-13 00:00:00.000,ATP World Tour Masters 1000 Rome Italy ATP World Tour Masters 1000,CLAY,2,Juan Monaco,Adrian Ungur,Juan Monaco,6-2; 6-2,R64,88,0,4,46,66,28,46,10,20,4,6,8,38,66,1,5,28,55,15,28,6,27,5,11,8,21,55
2012-05-13 00:00:00.000,ATP World Tour Masters 1000 Rome Italy ATP World Tour Masters 1000,CLAY,2,Juan Martin Del Potro,Michael Llodra,Juan Martin Del Potro,7-5; 3-6; 6-4,R64,136,2,0,76,92,52,76,10,16,4,6,15,62,92,6,4,69,104,48,69,17,35,4,7,16,65,104
2012-05-13 00:00:00.000,ATP World Tour Masters 1000 Rome Italy ATP World Tour Masters 1000,CLAY,2,Mikhail Youzhny,Thomaz Bellucci,Mikhail Youzhny,6-2; 3-6; 6-3,R64,120,4,1,47,70,33,47,9,23,2,6,13,42,70,3,0,51,84,28,51,15,33,3,9,13,43,84
2012-05-13 00:00:00.000,ATP World Tour Masters 1000 Rome Italy ATP World Tour Masters 1000,CLAY,2,Viktor Troicki,Filippo Volandri,Viktor Troicki,4-6; 6-4; 6-3,R64,134,9,3,72,102,51,72,13,30,6,9,15,64,102,0,1,81,103,49,81,11,22,8,12,14,60,103
2012-05-13 00:00:00.000,ATP World Tour Masters 1000 Rome Italy ATP World Tour Masters 1000,CLAY,2,Jo-Wilfried Tsonga,N/A Bye,Jo-Wilfried Tsonga,,R64,0,0,0,0,0,0,0,0,0,0,0,0,0,0,0,0,0,0,0,0,0,0,0,0,0,0,0
2012-05-13 00:00:00.000,ATP World Tour Masters 1000 Rome Italy ATP World Tour Masters 1000,CLAY,2,Roger Federer,N/A Bye,Roger Federer,,R64,0,0,0,0,0,0,0,0,0,0,0,0,0,0,0,0,0,0,0,0,0,0,0,0,0,0,0
2012-05-13 00:00:00.000,ATP World Tour Masters 1000 Rome Italy ATP World Tour Masters 1000,CLAY,2,Carlos Berlocq,Blaz Kavcic,Carlos Berlocq,6-1; 6-3,R64,98,1,2,32,53,19,32,13,21,1,3,8,32,53,1,2,26,48,12,26,7,22,5,11,8,19,48
2012-05-13 00:00:00.000,ATP World Tour Masters 1000 Rome Italy ATP World Tour Masters 1000,CLAY,2,Juan Carlos Ferrero,Kevin Anderson,Juan Carlos Ferrero,6-4; 7-5,R64,111,3,0,52,67,40,52,7,15,7,8,11,47,67,9,5,47,78,30,47,16,31,5,8,11,46,78
2012-05-13 00:00:00.000,ATP World Tour Masters 1000 Rome Italy ATP World Tour Masters 1000,CLAY,2,Gael Monfils,Alex Bogomolov Jr.,Gael Monfils,6-4; 6-1,R64,80,4,0,37,46,26,37,5,9,1,2,8,31,46,0,5,48,72,28,48,9,24,9,14,9,37,72
2012-05-13 00:00:00.000,ATP World Tour Masters 1000 Rome Italy ATP World Tour Masters 1000,CLAY,2,John Isner,Philipp Kohlschreiber,John Isner,2-6; 7-6(3); 6-2,R64,99,10,1,60,89,44,60,16,29,2,5,14,60,89,5,0,51,78,34,51,19,27,3,6,14,53,78
2012-05-13 00:00:00.000,ATP World Tour Masters 1000 Rome Italy ATP World Tour Masters 1000,CLAY,2,Andreas Seppi,Denis Istomin,Andreas Seppi,6-4; 3-6; 6-3,R64,116,3,1,62,89,43,62,16,27,3,5,14,59,89,5,2,51,84,36,51,17,33,5,8,14,53,84
2012-05-13 00:00:00.000,ATP World Tour Masters 1000 Rome Italy ATP World Tour Masters 1000,CLAY,2,Stan Wawrinka,Robin Haase,Stan Wawrinka,6-1; 4-6; 7-5,R64,136,4,2,67,114,46,67,24,47,10,12,15,70,114,1,1,55,84,35,55,15,29,2,6,14,50,84
2012-05-13 00:00:00.000,ATP World Tour Masters 1000 Rome Italy ATP World Tour Masters 1000,CLAY,2,Janko Tipsarevic,N/A Bye,Janko Tipsarevic,,R64,0,0,0,0,0,0,0,0,0,0,0,0,0,0,0,0,0,0,0,0,0,0,0,0,0,0,0
2012-05-13 00:00:00.000,ATP World Tour Masters 1000 Rome Italy ATP World Tour Masters 1000,CLAY,2,David Ferrer,N/A Bye,David Ferrer,,R64,0,0,0,0,0,0,0,0,0,0,0,0,0,0,0,0,0,0,0,0,0,0,0,0,0,0,0
2012-05-13 00:00:00.000,ATP World Tour Masters 1000 Rome Italy ATP World Tour Masters 1000,CLAY,2,Fernando Verdasco,Alexandr Dolgopolov,Fernando Verdasco,6-0 RET,R64,36,0,1,18,22,11,18,3,4,1,1,3,14,22,0,1,15,26,7,15,3,11,6,9,3,10,26
2012-05-13 00:00:00.000,ATP World Tour Masters 1000 Rome Italy ATP World Tour Masters 1000,CLAY,2,Guillermo Garcia-Lopez,Pablo Andujar,Guillermo Garcia-Lopez,6-4; 6-1,R64,89,3,2,33,52,26,33,9,19,1,2,8,35,52,1,6,32,63,14,32,16,31,3,8,9,30,63
2012-05-13 00:00:00.000,ATP World Tour Masters 1000 Rome Italy ATP World Tour Masters 1000,CLAY,2,Gilles Simon,Donald Young,Gilles Simon,6-2; 7-5,R64,86,1,0,35,60,23,35,18,25,2,3,10,41,60,0,5,29,58,22,29,10,29,3,7,10,32,58
2012-05-13 00:00:00.000,ATP World Tour Masters 1000 Rome Italy ATP World Tour Masters 1000,CLAY,2,Richard Gasquet,Jurgen Melzer,Richard Gasquet,6-1; 7-6(6),R64,100,5,2,38,65,29,38,15,27,2,3,10,44,65,2,1,40,72,28,40,12,32,6,9,9,40,72
2012-05-13 00:00:00.000,ATP World Tour Masters 1000 Rome Italy ATP World Tour Masters 1000,CLAY,2,Paolo Lorenzi,Nikolay Davydenko,Paolo Lorenzi,6-3; 2-6; 6-3,R64,126,1,4,36,76,26,36,22,40,3,6,13,48,76,0,6,63,82,38,63,9,19,4,8,13,47,82
2012-05-13 00:00:00.000,ATP World Tour Masters 1000 Rome Italy ATP World Tour Masters 1000,CLAY,2,David Nalbandian,Albert Ramos-Vinolas,David Nalbandian,6-3; 6-4,R64,97,4,4,42,66,29,42,10,24,1,3,10,39,66,1,5,28,53,17,28,13,25,4,8,9,30,53
2012-05-13 00:00:00.000,ATP World Tour Masters 1000 Rome Italy ATP World Tour Masters 1000,CLAY,2,Andy Murray,N/A Bye,Andy Murray,,R64,0,0,0,0,0,0,0,0,0,0,0,0,0,0,0,0,0,0,0,0,0,0,0,0,0,0,0
2012-05-13 00:00:00.000,ATP World Tour Masters 1000 Rome Italy ATP World Tour Masters 1000,CLAY,2,Tomas Berdych,N/A Bye,Tomas Berdych,,R64,0,0,0,0,0,0,0,0,0,0,0,0,0,0,0,0,0,0,0,0,0,0,0,0,0,0,0
2012-05-13 00:00:00.000,ATP World Tour Masters 1000 Rome Italy ATP World Tour Masters 1000,CLAY,2,Lukasz Kubot,Potito Starace,Lukasz Kubot,6-3; 5-7; 6-2,R64,150,2,5,62,94,44,62,18,32,8,10,15,62,94,5,2,62,93,40,62,14,31,10,14,14,54,93
2012-05-13 00:00:00.000,ATP World Tour Masters 1000 Rome Italy ATP World Tour Masters 1000,CLAY,2,Sam Querrey,Jarkko Nieminen,Sam Querrey,7-6(4); 5-7; 6-4,R64,132,4,4,60,107,47,60,27,47,5,7,17,74,107,5,1,53,87,42,53,23,34,1,3,17,65,87
2012-05-13 00:00:00.000,ATP World Tour Masters 1000 Rome Italy ATP World Tour Masters 1000,CLAY,2,Nicolas Almagro,Marin Cilic,Nicolas Almagro,6-2; 3-6; 6-0,R64,98,3,3,44,79,32,44,14,35,3,6,12,46,79,1,2,38,62,24,38,7,24,3,9,11,31,62
2012-05-13 00:00:00.000,ATP World Tour Masters 1000 Rome Italy ATP World Tour Masters 1000,CLAY,2,Marcel Granollers,Feliciano Lopez,Marcel Granollers,6-4; 6-4,R64,106,1,2,34,56,26,34,13,22,3,4,10,39,56,2,3,37,70,24,37,15,33,9,12,10,39,70
2012-05-13 00:00:00.000,ATP World Tour Masters 1000 Rome Italy ATP World Tour Masters 1000,CLAY,2,Fabio Fognini,Marcos Baghdatis,Fabio Fognini,6-2; 6-2,R64,75,1,0,41,50,30,41,4,9,4,5,8,34,50,0,3,30,60,14,30,13,30,3,8,8,27,60
2012-05-13 00:00:00.000,ATP World Tour Masters 1000 Rome Italy ATP World Tour Masters 1000,CLAY,2,Florian Mayer,Milos Raonic,Florian Mayer,7-6(5); 6-4,R64,92,4,0,39,69,35,39,18,30,2,2,11,53,69,8,1,41,72,32,41,18,31,0,1,11,50,72
2012-05-13 00:00:00.000,ATP World Tour Masters 1000 Rome Italy ATP World Tour Masters 1000,CLAY,2,Rafael Nadal,N/A Bye,Rafael Nadal,,R64,0,0,0,0,0,0,0,0,0,0,0,0,0,0,0,0,0,0,0,0,0,0,0,0,0,0,0
2012-05-13 00:00:00.000,ATP World Tour Masters 1000 Rome Italy ATP World Tour Masters 1000,CLAY,2,Novak Djokovic,Bernard Tomic,Novak Djokovic,6-3; 6-3,R32,69,5,1,34,52,24,34,12,18,1,2,9,36,52,2,0,43,63,25,43,8,20,4,8,9,33,63
2012-05-13 00:00:00.000,ATP World Tour Masters 1000 Rome Italy ATP World Tour Masters 1000,CLAY,2,Juan Monaco,Radek Stepanek,Juan Monaco,6-4; 6-2,R32,98,1,2,47,62,32,47,7,15,3,4,9,39,62,0,3,34,61,21,34,12,27,7,11,9,33,61
2012-05-13 00:00:00.000,ATP World Tour Masters 1000 Rome Italy ATP World Tour Masters 1000,CLAY,2,Juan Martin Del Potro,Mikhail Youzhny,Juan Martin Del Potro,6-4; 6-2,R32,89,5,2,39,53,31,39,8,14,1,1,9,39,53,3,2,43,56,24,43,8,13,1,4,9,32,56
2012-05-13 00:00:00.000,ATP World Tour Masters 1000 Rome Italy ATP World Tour Masters 1000,CLAY,2,Jo-Wilfried Tsonga,Viktor Troicki,Jo-Wilfried Tsonga,6-3; 6-2,R32,71,1,2,29,46,19,29,12,17,2,3,8,31,46,0,1,39,51,18,39,5,12,5,10,9,23,51
2012-05-13 00:00:00.000,ATP World Tour Masters 1000 Rome Italy ATP World Tour Masters 1000,CLAY,2,Roger Federer,Carlos Berlocq,Roger Federer,6-3; 6-4,R32,70,2,0,33,54,27,33,13,21,4,5,10,40,54,1,3,33,45,23,33,5,12,1,4,9,28,45
2012-05-13 00:00:00.000,ATP World Tour Masters 1000 Rome Italy ATP World Tour Masters 1000,CLAY,2,Juan Carlos Ferrero,Gael Monfils,Juan Carlos Ferrero,7-5; 6-3,R32,102,0,0,47,63,32,47,6,16,0,3,11,38,63,2,4,40,59,23,40,7,19,6,11,10,30,59
2012-05-13 00:00:00.000,ATP World Tour Masters 1000 Rome Italy ATP World Tour Masters 1000,CLAY,2,Andreas Seppi,John Isner,Andreas Seppi,2-6; 7-6(5); 7-5,R32,171,8,4,61,99,49,61,21,38,4,6,16,70,99,15,3,69,118,50,69,30,49,11,12,16,80,118
2012-05-13 00:00:00.000,ATP World Tour Masters 1000 Rome Italy ATP World Tour Masters 1000,CLAY,2,Stan Wawrinka,Janko Tipsarevic,Stan Wawrinka,6-3; 6-1,R32,72,3,1,35,58,20,35,14,23,3,5,8,34,58,3,2,25,45,16,25,4,20,3,9,8,20,45
2012-05-13 00:00:00.000,ATP World Tour Masters 1000 Rome Italy ATP World Tour Masters 1000,CLAY,2,David Ferrer,Fernando Verdasco,David Ferrer,6-3; 7-6(3),R32,119,4,1,57,80,41,57,10,23,4,6,11,51,80,1,5,47,70,29,47,10,23,5,8,10,39,70
2012-05-13 00:00:00.000,ATP World Tour Masters 1000 Rome Italy ATP World Tour Masters 1000,CLAY,2,Gilles Simon,Guillermo Garcia-Lopez,Gilles Simon,6-4; 2-6; 6-4,R32,150,9,2,55,99,40,55,16,44,4,9,14,56,99,3,2,59,94,39,59,14,35,6,11,14,53,94
2012-05-13 00:00:00.000,ATP World Tour Masters 1000 Rome Italy ATP World Tour Masters 1000,CLAY,2,Richard Gasquet,Paolo Lorenzi,Richard Gasquet,6-3; 6-2,R32,84,8,0,29,47,25,29,11,18,0,0,9,36,47,3,1,31,47,17,31,8,16,4,7,8,25,47
2012-05-13 00:00:00.000,ATP World Tour Masters 1000 Rome Italy ATP World Tour Masters 1000,CLAY,2,Andy Murray,David Nalbandian,Andy Murray,6-1; 4-6; 7-5,R32,158,2,2,47,92,30,47,28,45,7,10,15,58,92,2,3,61,96,42,61,12,35,9,14,14,54,96
2012-05-13 00:00:00.000,ATP World Tour Masters 1000 Rome Italy ATP World Tour Masters 1000,CLAY,2,Tomas Berdych,Lukasz Kubot,Tomas Berdych,6-4; 6-1,R32,80,3,1,33,47,24,33,9,14,1,2,9,33,47,1,6,26,48,16,26,8,22,1,5,8,24,48
2012-05-13 00:00:00.000,ATP World Tour Masters 1000 Rome Italy ATP World Tour Masters 1000,CLAY,2,Nicolas Almagro,Sam Querrey,Nicolas Almagro,7-5; 6-2,R32,77,7,3,31,55,26,31,11,24,3,5,10,37,55,6,1,31,64,25,31,10,33,7,12,10,35,64
2012-05-13 00:00:00.000,ATP World Tour Masters 1000 Rome Italy ATP World Tour Masters 1000,CLAY,2,Marcel Granollers,Fabio Fognini,Marcel Granollers,6-3; 6-4,R32,95,2,2,49,64,30,49,9,15,1,3,9,39,64,1,1,44,57,23,44,6,13,7,12,10,29,57
2012-05-13 00:00:00.000,ATP World Tour Masters 1000 Rome Italy ATP World Tour Masters 1000,CLAY,2,Rafael Nadal,Florian Mayer,Rafael Nadal,6-1; 7-5,R32,81,1,1,27,48,25,27,15,21,0,0,10,40,48,2,0,34,50,23,34,7,16,2,5,9,30,50
2012-05-13 00:00:00.000,ATP World Tour Masters 1000 Rome Italy ATP World Tour Masters 1000,CLAY,2,Novak Djokovic,Juan Monaco,Novak Djokovic,4-6; 6-2; 6-3,R16,140,3,0,55,82,37,55,17,27,2,4,14,54,82,0,2,61,79,37,61,9,18,2,6,13,46,79
2012-05-13 00:00:00.000,ATP World Tour Masters 1000 Rome Italy ATP World Tour Masters 1000,CLAY,2,Jo-Wilfried Tsonga,Juan Martin Del Potro,Jo-Wilfried Tsonga,6-4; 6-1,R16,85,3,1,37,56,27,37,11,19,1,2,9,38,56,0,1,41,50,20,41,6,9,3,7,8,26,50
2012-05-13 00:00:00.000,ATP World Tour Masters 1000 Rome Italy ATP World Tour Masters 1000,CLAY,2,Roger Federer,Juan Carlos Ferrero,Roger Federer,6-2; 5-7; 6-1,R16,108,12,1,39,76,33,39,23,37,2,3,14,56,76,2,0,64,81,40,64,7,17,5,9,13,47,81
2012-05-13 00:00:00.000,ATP World Tour Masters 1000 Rome Italy ATP World Tour Masters 1000,CLAY,2,Andreas Seppi,Stan Wawrinka,Andreas Seppi,6-7(1); 7-6(6); 7-6(6),R16,201,2,1,71,123,52,71,26,52,8,12,18,78,123,14,5,65,124,50,65,30,59,1,5,18,80,124
2012-05-13 00:00:00.000,ATP World Tour Masters 1000 Rome Italy ATP World Tour Masters 1000,CLAY,2,David Ferrer,Gilles Simon,David Ferrer,6-0; 7-6(5),R16,98,0,1,35,61,21,35,15,26,2,4,9,36,61,3,3,30,58,15,30,11,28,2,7,9,26,58
2012-05-13 00:00:00.000,ATP World Tour Masters 1000 Rome Italy ATP World Tour Masters 1000,CLAY,2,Richard Gasquet,Andy Murray,Richard Gasquet,6-7(1); 6-3; 6-2,R16,179,6,3,76,123,49,76,24,47,15,17,14,73,123,4,5,54,105,36,54,24,51,11,17,15,60,105
2012-05-13 00:00:00.000,ATP World Tour Masters 1000 Rome Italy ATP World Tour Masters 1000,CLAY,2,Tomas Berdych,Nicolas Almagro,Tomas Berdych,7-6(3); 6-3,R16,122,4,5,56,85,36,56,16,29,4,5,10,52,85,7,2,38,71,27,38,14,33,2,5,11,41,71
2012-05-13 00:00:00.000,ATP World Tour Masters 1000 Rome Italy ATP World Tour Masters 1000,CLAY,2,Rafael Nadal,Marcel Granollers,Rafael Nadal,6-1; 6-1,R16,88,0,4,37,47,27,37,5,10,3,3,7,32,47,3,3,40,54,17,40,6,14,4,9,7,23,54
2012-05-13 00:00:00.000,ATP World Tour Masters 1000 Rome Italy ATP World Tour Masters 1000,CLAY,2,Novak Djokovic,Jo-Wilfried Tsonga,Novak Djokovic,7-5; 6-1,Q,83,5,1,43,58,33,43,6,15,2,4,10,39,58,3,2,38,52,21,38,4,14,5,10,9,25,52
2012-05-13 00:00:00.000,ATP World Tour Masters 1000 Rome Italy ATP World Tour Masters 1000,CLAY,2,Roger Federer,Andreas Seppi,Roger Federer,6-1; 6-2,Q,54,1,1,38,47,29,38,7,9,3,3,8,36,47,0,1,19,41,12,19,8,22,4,8,7,20,41
2012-05-13 00:00:00.000,ATP World Tour Masters 1000 Rome Italy ATP World Tour Masters 1000,CLAY,2,David Ferrer,Richard Gasquet,David Ferrer,7-6(4); 6-3,Q,107,3,1,38,64,30,38,15,26,2,4,11,45,64,2,1,38,64,24,38,13,26,3,6,10,37,64
2012-05-13 00:00:00.000,ATP World Tour Masters 1000 Rome Italy ATP World Tour Masters 1000,CLAY,2,Rafael Nadal,Tomas Berdych,Rafael Nadal,6-4; 7-5,Q,126,2,0,46,60,35,46,10,14,2,3,11,45,60,2,2,51,78,34,51,12,27,6,9,11,46,78
2012-05-13 00:00:00.000,ATP World Tour Masters 1000 Rome Italy ATP World Tour Masters 1000,CLAY,2,Novak Djokovic,Roger Federer,Novak Djokovic,6-2; 7-6(4),S,100,1,1,38,66,31,38,16,28,0,1,10,47,66,6,0,32,65,25,32,16,33,3,6,10,41,65
2012-05-13 00:00:00.000,ATP World Tour Masters 1000 Rome Italy ATP World Tour Masters 1000,CLAY,2,Rafael Nadal,David Ferrer,Rafael Nadal,7-6(6); 6-0,S,126,2,0,52,75,39,52,11,23,9,10,9,50,75,2,2,51,71,30,51,9,20,7,11,9,39,71
2012-05-13 00:00:00.000,ATP World Tour Masters 1000 Rome Italy ATP World Tour Masters 1000,CLAY,2,Rafael Nadal,Novak Djokovic,Rafael Nadal,7-5; 6-3,F,141,0,0,39,69,27,39,17,30,6,7,10,44,69,1,4,47,74,32,47,10,27,3,7,11,42,74
2012-05-20 00:00:00.000,Nice France ATP World Tour 250,CLAY,2,John Isner,N/A Bye,John Isner,,R32,0,0,0,0,0,0,0,0,0,0,0,0,0,0,0,0,0,0,0,0,0,0,0,0,0,0,0
2012-05-20 00:00:00.000,Nice France ATP World Tour 250,CLAY,2,Xavier Malisse,Yen-Hsun Lu,Xavier Malisse,7-5; 6-4,R32,112,7,2,49,77,38,49,16,28,1,1,11,54,77,4,3,44,80,29,44,21,36,5,7,11,50,80
2012-05-20 00:00:00.000,Nice France ATP World Tour 250,CLAY,2,Nikolay Davydenko,Matthew Ebden,Nikolay Davydenko,6-3; 6-3,R32,102,1,1,53,69,29,53,8,16,9,12,9,37,69,3,5,39,77,25,39,10,38,9,15,9,35,77
2012-05-20 00:00:00.000,Nice France ATP World Tour 250,CLAY,2,Denis Istomin,Alejandro Falla,Denis Istomin,7-6(3); 1-6; 6-1,R32,145,5,2,59,94,37,59,21,35,5,7,13,58,94,0,2,56,87,39,56,16,31,2,4,13,55,87
2012-05-20 00:00:00.000,Nice France ATP World Tour 250,CLAY,2,Gael Monfils,N/A Bye,Gael Monfils,,R32,0,0,0,0,0,0,0,0,0,0,0,0,0,0,0,0,0,0,0,0,0,0,0,0,0,0,0
2012-05-20 00:00:00.000,Nice France ATP World Tour 250,CLAY,2,Brian Baker,Sergiy Stakhovsky,Brian Baker,6-7(2); 6-4; 7-5,R32,153,4,2,67,108,44,67,24,41,5,9,17,68,108,5,4,73,112,48,73,16,39,8,14,17,64,112
2012-05-20 00:00:00.000,Nice France ATP World Tour 250,CLAY,2,Mikhail Kukushkin,Sam Querrey,Mikhail Kukushkin,6-2; 7-5,R32,81,1,1,43,67,31,43,16,24,5,5,10,47,67,5,5,32,58,24,32,10,26,1,4,10,34,58
2012-05-20 00:00:00.000,Nice France ATP World Tour 250,CLAY,2,Bernard Tomic,Lukas Lacko,Bernard Tomic,6-2; 6-3,R32,65,3,1,36,57,25,36,12,21,1,2,9,37,57,3,0,29,54,15,29,13,25,2,6,8,28,54
2012-05-20 00:00:00.000,Nice France ATP World Tour 250,CLAY,2,Steve Darcis,Fabio Fognini,Steve Darcis,7-6(3); 7-5,R32,108,3,1,43,84,37,43,19,41,6,8,12,56,84,3,2,61,84,38,61,13,23,3,6,12,51,84
2012-05-20 00:00:00.000,Nice France ATP World Tour 250,CLAY,2,Filippo Volandri,Olivier Rochus,Filippo Volandri,4-6; 7-6(2); 6-2,R32,145,2,0,84,100,52,84,8,16,4,8,15,60,100,2,4,70,108,37,70,22,38,12,17,15,59,108
2012-05-20 00:00:00.000,Nice France ATP World Tour 250,CLAY,2,Edouard Roger-Vasselin,Benoit Paire,Edouard Roger-Vasselin,6-4; 7-6(2),R32,109,2,4,64,101,44,64,20,37,8,9,11,64,101,9,5,45,79,34,45,12,34,5,7,11,46,79
2012-05-20 00:00:00.000,Nice France ATP World Tour 250,CLAY,2,Nicolas Almagro,N/A Bye,Nicolas Almagro,,R32,0,0,0,0,0,0,0,0,0,0,0,0,0,0,0,0,0,0,0,0,0,0,0,0,0,0,0
2012-05-20 00:00:00.000,Nice France ATP World Tour 250,CLAY,2,Juan Carlos Ferrero,Robin Haase,Juan Carlos Ferrero,4-6; 7-6(6); 7-6(6),R32,152,3,1,87,115,62,87,16,28,5,8,17,78,115,9,2,71,115,55,71,23,44,2,4,17,78,115
2012-05-20 00:00:00.000,Nice France ATP World Tour 250,CLAY,2,Thomaz Bellucci,Donald Young,Thomaz Bellucci,6-7(5); 6-0; 6-3,R32,143,2,2,73,114,51,73,21,41,10,11,14,72,114,4,2,47,85,29,47,22,38,2,7,13,51,85
2012-05-20 00:00:00.000,Nice France ATP World Tour 250,CLAY,2,Grigor Dimitrov,Dudi Sela,Grigor Dimitrov,7-5; 6-1,R32,68,7,4,34,54,26,34,12,20,2,3,10,38,54,0,3,31,58,19,31,11,27,8,12,9,30,58
2012-05-20 00:00:00.000,Nice France ATP World Tour 250,CLAY,2,Gilles Simon,N/A Bye,Gilles Simon,,R32,0,0,0,0,0,0,0,0,0,0,0,0,0,0,0,0,0,0,0,0,0,0,0,0,0,0,0
2012-05-20 00:00:00.000,Nice France ATP World Tour 250,CLAY,2,John Isner,Xavier Malisse,John Isner,7-6(3); 7-6(5),R16,92,13,0,54,72,46,54,11,18,0,0,12,57,72,7,2,49,76,38,49,18,27,0,0,12,56,76
2012-05-20 00:00:00.000,Nice France ATP World Tour 250,CLAY,2,Nikolay Davydenko,Denis Istomin,Nikolay Davydenko,6-4; 1-6; 6-3,R16,123,0,0,66,78,38,66,7,12,4,9,13,45,78,0,0,44,82,27,44,19,38,1,6,13,46,82
2012-05-20 00:00:00.000,Nice France ATP World Tour 250,CLAY,2,Brian Baker,Gael Monfils,Brian Baker,6-3; 7-6(9),R16,92,4,2,48,70,36,48,12,22,3,5,11,48,70,6,3,49,88,35,49,15,39,13,16,10,50,88
2012-05-20 00:00:00.000,Nice France ATP World Tour 250,CLAY,2,Mikhail Kukushkin,Bernard Tomic,Mikhail Kukushkin,3-6; 6-2; 7-5,R16,139,5,4,72,116,44,72,21,44,16,20,14,65,116,2,1,62,94,40,62,11,32,2,8,15,51,94
2012-05-20 00:00:00.000,Nice France ATP World Tour 250,CLAY,2,Steve Darcis,Filippo Volandri,Steve Darcis,3-6; 6-2; 6-4,R16,109,5,0,50,81,36,50,14,31,2,6,14,50,81,0,0,55,69,33,55,7,14,2,7,13,40,69
2012-05-20 00:00:00.000,Nice France ATP World Tour 250,CLAY,2,Nicolas Almagro,Edouard Roger-Vasselin,Nicolas Almagro,7-6(5); 6-4,R16,95,4,3,37,72,32,37,20,35,3,4,11,52,72,4,0,44,71,31,44,16,27,2,4,11,47,71
2012-05-20 00:00:00.000,Nice France ATP World Tour 250,CLAY,2,Thomaz Bellucci,Juan Carlos Ferrero,Thomaz Bellucci,6-4; 6-3,R16,100,12,1,50,76,35,50,14,26,7,8,10,49,76,0,0,43,63,27,43,9,20,7,10,9,36,63
2012-05-20 00:00:00.000,Nice France ATP World Tour 250,CLAY,2,Gilles Simon,Grigor Dimitrov,Gilles Simon,6-3; 6-3,R16,80,3,1,30,53,23,30,15,23,2,2,9,38,53,3,4,35,68,20,35,18,33,4,7,9,38,68
2012-05-20 00:00:00.000,Nice France ATP World Tour 250,CLAY,2,Nikolay Davydenko,John Isner,Nikolay Davydenko,6-4; 7-6(4),Q,101,0,1,64,77,51,64,6,13,3,3,11,57,77,13,2,55,84,37,55,16,29,6,7,11,53,84
2012-05-20 00:00:00.000,Nice France ATP World Tour 250,CLAY,2,Brian Baker,Mikhail Kukushkin,Brian Baker,4-6; 6-3; 7-6(4),Q,136,2,2,66,108,43,66,24,42,6,10,16,67,108,6,1,59,93,41,59,17,34,2,6,15,58,93
2012-05-20 00:00:00.000,Nice France ATP World Tour 250,CLAY,2,Nicolas Almagro,Steve Darcis,Nicolas Almagro,6-4; 6-4,Q,83,13,3,32,54,29,32,13,22,1,1,10,42,54,5,0,37,73,26,37,18,36,3,5,10,44,73
2012-05-20 00:00:00.000,Nice France ATP World Tour 250,CLAY,2,Gilles Simon,Thomaz Bellucci,Gilles Simon,7-5; 6-0,Q,91,1,0,23,47,20,23,16,24,0,0,9,36,47,1,2,29,68,19,29,17,39,4,8,9,36,68
2012-05-20 00:00:00.000,Nice France ATP World Tour 250,CLAY,2,Brian Baker,Nikolay Davydenko,Brian Baker,6-7(5); 6-4; 6-2,S,152,7,2,72,116,44,72,19,44,9,14,15,63,116,1,5,69,98,36,69,11,29,6,14,15,47,98
2012-05-20 00:00:00.000,Nice France ATP World Tour 250,CLAY,2,Nicolas Almagro,Gilles Simon,Nicolas Almagro,6-1; 6-3,S,68,8,1,27,55,22,27,15,28,4,4,8,37,55,1,1,27,50,18,27,8,23,5,9,8,26,50
2012-05-20 00:00:00.000,Nice France ATP World Tour 250,CLAY,2,Nicolas Almagro,Brian Baker,Nicolas Almagro,6-3; 6-2,F,70,11,1,33,47,29,33,6,14,1,1,8,35,47,4,3,48,65,28,48,6,17,5,9,9,34,65
2012-05-27 00:00:00.000,Roland Garros France Grand Slams,CLAY,3,Novak Djokovic,Potito Starace,Novak Djokovic,7-6(3); 6-3; 6-1,R128,124,6,0,61,79,50,61,12,18,0,0,14,62,79,4,0,79,106,47,79,13,27,11,15,14,60,106
2012-05-27 00:00:00.000,Roland Garros France Grand Slams,CLAY,3,Blaz Kavcic,Lleyton Hewitt,Blaz Kavcic,7-6(2); 6-3; 6-7(4); 6-3,R128,230,11,4,88,140,58,88,32,52,6,10,22,90,140,12,8,80,145,50,80,32,65,3,9,20,82,145
2012-05-27 00:00:00.000,Roland Garros France Grand Slams,CLAY,3,Nicolas Devilder,Filip Krajinovic,Nicolas Devilder,6-2; 6-2; 6-0,R128,96,2,1,36,70,24,36,21,34,3,6,11,45,70,0,4,38,60,16,38,2,22,3,13,11,18,60
2012-05-27 00:00:00.000,Roland Garros France Grand Slams,CLAY,3,Michael Berrer,Jurgen Melzer,Michael Berrer,6-7(5); 4-6; 6-2; 6-2; 6-3,R128,222,15,6,104,168,70,104,34,64,7,12,24,104,168,3,13,85,154,56,85,29,69,9,18,23,85,154
2012-05-27 00:00:00.000,Roland Garros France Grand Slams,CLAY,3,Andreas Seppi,Nikolay Davydenko,Andreas Seppi,6-3; 7-6(5); 7-5,R128,146,13,0,60,96,47,60,21,36,1,3,16,68,96,2,5,89,124,52,89,19,35,3,8,17,71,124
2012-05-27 00:00:00.000,Roland Garros France Grand Slams,CLAY,3,Mikhail Kukushkin,Ernests Gulbis,Mikhail Kukushkin,6-4; 7-6(4); 5-7; 2-6; 6-4,R128,226,1,0,94,158,57,94,38,64,5,13,26,95,158,19,8,93,153,67,93,28,60,7,14,26,95,153
2012-05-27 00:00:00.000,Roland Garros France Grand Slams,CLAY,3,Gilles Muller,Igor Sijsling,Gilles Muller,2-6; 7-5; 3-6; 6-4; 8-6,R128,217,23,8,93,174,70,93,42,81,14,19,27,112,174,11,3,96,158,74,96,32,62,10,14,26,106,158
2012-05-27 00:00:00.000,Roland Garros France Grand Slams,CLAY,3,Fernando Verdasco,Steve Darcis,Fernando Verdasco,6-3; 6-2; 7-6(4),R128,133,7,5,51,81,39,51,20,30,2,4,15,59,81,6,1,63,94,42,63,11,31,7,12,14,53,94
2012-05-27 00:00:00.000,Roland Garros France Grand Slams,CLAY,3,Gilles Simon,Ryan Harrison,Gilles Simon,3-6; 7-5; 6-4; 6-1,R128,167,5,9,74,131,53,74,27,57,5,9,19,80,131,5,2,59,106,37,59,22,47,2,9,19,59,106
2012-05-27 00:00:00.000,Roland Garros France Grand Slams,CLAY,3,Brian Baker,Xavier Malisse,Brian Baker,6-3; 7-6(1); 7-6(5),R128,133,9,1,63,109,48,63,26,46,3,6,17,74,109,12,3,55,105,38,55,26,50,3,7,16,64,105
2012-05-27 00:00:00.000,Roland Garros France Grand Slams,CLAY,3,Pablo Andujar,Victor Hanescu,Pablo Andujar,6-1; 2-6; 1-6; 6-3; 6-1,R128,183,2,8,65,118,44,65,28,53,7,12,19,72,118,6,2,89,129,51,89,18,40,11,18,19,69,129
2012-05-27 00:00:00.000,Roland Garros France Grand Slams,CLAY,3,Stan Wawrinka,Flavio Cipolla,Stan Wawrinka,6-3; 6-3; 4-6; 3-6; 6-2,R128,199,4,4,81,132,58,81,24,51,3,9,23,82,132,2,13,99,152,64,99,18,53,10,18,22,82,152
2012-05-27 00:00:00.000,Roland Garros France Grand Slams,CLAY,3,Viktor Troicki,Thomaz Bellucci,Viktor Troicki,4-6; 6-3; 5-7; 6-3; 6-2,R128,230,15,2,98,159,69,98,26,61,16,23,24,95,159,2,7,84,160,52,84,33,76,11,21,24,85,160
2012-05-27 00:00:00.000,Roland Garros France Grand Slams,CLAY,3,Fabio Fognini,Adrian Mannarino,Fabio Fognini,6-0; 7-5; 6-1,R128,103,1,0,53,75,38,53,15,22,4,5,13,53,75,0,2,43,78,24,43,14,35,6,13,12,38,78
2012-05-27 00:00:00.000,Roland Garros France Grand Slams,CLAY,3,Cedrik-Marcel Stebe,Joao Souza,Cedrik-Marcel Stebe,6-3; 2-0 RET,R128,61,2,3,25,38,17,25,9,13,0,0,6,26,38,2,0,32,40,17,32,3,8,3,5,5,20,40
2012-05-27 00:00:00.000,Roland Garros France Grand Slams,CLAY,3,Jo-Wilfried Tsonga,Andrey Kuznetsov,Jo-Wilfried Tsonga,1-6; 6-3; 6-2; 6-4,R128,138,10,1,63,100,48,63,22,37,4,6,17,70,100,7,2,65,110,47,65,20,45,14,18,17,67,110
2012-05-27 00:00:00.000,Roland Garros France Grand Slams,CLAY,3,Roger Federer,Tobias Kamke,Roger Federer,6-2; 7-5; 6-3,R128,117,7,5,60,101,40,60,21,41,4,7,14,61,101,2,8,58,97,36,58,10,39,8,16,15,46,97
2012-05-27 00:00:00.000,Roland Garros France Grand Slams,CLAY,3,Adrian Ungur,David Nalbandian,Adrian Ungur,6-3; 5-7; 6-4; 7-5,R128,179,5,6,96,142,76,96,22,46,10,11,22,98,142,9,8,70,113,50,70,29,43,3,6,21,79,113
2012-05-27 00:00:00.000,Roland Garros France Grand Slams,CLAY,3,Martin Klizan,Frank Dancevic,Martin Klizan,4-0 RET,R128,17,2,1,6,9,6,6,2,3,0,0,2,8,9,0,2,10,15,4,10,1,5,1,3,2,5,15
2012-05-27 00:00:00.000,Roland Garros France Grand Slams,CLAY,3,Nicolas Mahut,Andy Roddick,Nicolas Mahut,6-3; 6-3; 4-6; 6-2,R128,142,13,4,58,107,41,58,28,49,7,10,18,69,107,8,4,59,97,41,59,17,38,0,7,18,58,97
2012-05-27 00:00:00.000,Roland Garros France Grand Slams,CLAY,3,David Goffin,Radek Stepanek,David Goffin,6-2; 4-6; 2-6; 6-4; 6-2,R128,224,12,8,63,133,48,63,33,70,7,14,22,81,133,7,4,99,169,56,99,33,70,21,30,22,89,169
2012-05-27 00:00:00.000,Roland Garros France Grand Slams,CLAY,3,Arnaud Clement,Alex Bogomolov Jr.,Arnaud Clement,6-2; 3-6; 4-6; 7-6(2); 5-4 RET,R128,259,18,10,92,163,76,92,30,71,2,7,25,106,163,7,4,128,175,84,128,23,47,14,18,23,107,175
2012-05-27 00:00:00.000,Roland Garros France Grand Slams,CLAY,3,Lukasz Kubot,Karol Beck,Lukasz Kubot,7-5; 6-2; 7-5,R128,184,3,1,78,112,51,78,19,34,13,16,16,70,112,5,6,55,99,37,55,17,44,6,13,16,54,99
2012-05-27 00:00:00.000,Roland Garros France Grand Slams,CLAY,3,Florent Serra,Feliciano Lopez,Florent Serra,5-0 RET,R128,18,3,0,9,17,7,9,6,8,0,0,3,13,17,1,0,6,11,2,6,1,5,1,3,2,3,11
2012-05-27 00:00:00.000,Roland Garros France Grand Slams,CLAY,3,Juan Martin Del Potro,Albert Montanes,Juan Martin Del Potro,6-2; 6-7(5); 6-2; 6-1,R128,190,4,6,81,137,60,81,30,56,11,12,18,90,137,3,6,71,114,41,71,21,43,4,11,17,62,114
2012-05-27 00:00:00.000,Roland Garros France Grand Slams,CLAY,3,Edouard Roger-Vasselin,Vasek Pospisil,Edouard Roger-Vasselin,3-6; 6-3; 6-2; 6-2,R128,149,5,6,78,120,50,78,26,42,7,10,17,76,120,9,4,63,104,37,63,19,41,4,11,17,56,104
2012-05-27 00:00:00.000,Roland Garros France Grand Slams,CLAY,3,Juan Carlos Ferrero,Jonathan Dasnieres de Veigy,Juan Carlos Ferrero,6-1; 6-4; 6-3,R128,129,6,2,36,68,28,36,17,32,0,2,13,45,68,6,2,67,108,34,67,19,41,14,21,13,53,108
2012-05-27 00:00:00.000,Roland Garros France Grand Slams,CLAY,3,Marin Cilic,Daniel Munoz-De La Nava,Marin Cilic,6-4; 6-4; 7-5,R128,144,10,6,51,90,36,51,22,39,6,10,16,58,90,1,2,53,96,31,53,19,43,6,13,16,50,96
2012-05-27 00:00:00.000,Roland Garros France Grand Slams,CLAY,3,Kevin Anderson,Rui Machado,Kevin Anderson,7-6(2); 6-7(6); 4-6; 6-1; 11-9,R128,290,26,7,133,198,95,133,37,65,11,15,31,132,198,3,6,146,210,90,146,37,64,10,16,30,127,210
2012-05-27 00:00:00.000,Roland Garros France Grand Slams,CLAY,3,Horacio Zeballos,Eric Prodon,Horacio Zeballos,6-7(8); 6-3; 6-3; 6-2,R128,176,15,5,76,116,64,76,22,40,3,4,19,86,116,2,1,82,146,55,82,29,64,12,18,19,84,146
2012-05-27 00:00:00.000,Roland Garros France Grand Slams,CLAY,3,Michael Llodra,Guillermo Garcia-Lopez,Michael Llodra,7-6(5); 6-2; 3-6; 6-3,R128,176,12,2,72,117,57,72,26,45,4,5,19,83,117,8,14,67,147,51,67,39,80,12,15,19,90,147
2012-05-27 00:00:00.000,Roland Garros France Grand Slams,CLAY,3,Tomas Berdych,Dudi Sela,Tomas Berdych,6-3; 6-4; 6-1,R128,118,6,2,52,91,39,52,22,39,7,8,13,61,91,1,2,42,74,22,42,16,32,4,10,13,38,74
2012-05-27 00:00:00.000,Roland Garros France Grand Slams,CLAY,3,David Ferrer,Lukas Lacko,David Ferrer,6-3; 6-4; 6-1,R128,118,2,3,36,69,32,36,21,33,1,2,13,53,69,0,3,45,89,25,45,20,44,6,12,13,45,89
2012-05-27 00:00:00.000,Roland Garros France Grand Slams,CLAY,3,Benoit Paire,Albert Ramos-Vinolas,Benoit Paire,7-6(3); 6-4; 6-7(5); 6-3,R128,210,5,8,70,156,50,70,41,86,10,18,22,91,156,4,10,82,139,47,82,27,57,7,17,21,74,139
2012-05-27 00:00:00.000,Roland Garros France Grand Slams,CLAY,3,Robin Haase,Ivan Dodig,Robin Haase,6-2; 6-2; 6-1,R128,97,7,3,34,58,32,34,12,24,0,0,11,44,58,7,3,61,90,34,61,8,29,11,18,12,42,90
2012-05-27 00:00:00.000,Roland Garros France Grand Slams,CLAY,3,Mikhail Youzhny,James Blake,Mikhail Youzhny,6-2; 6-1; 6-2,R128,86,8,5,37,66,30,37,19,29,1,1,12,49,66,1,4,50,85,29,50,12,35,9,15,11,41,85
2012-05-27 00:00:00.000,Roland Garros France Grand Slams,CLAY,3,Marcel Granollers,Joao Sousa,Marcel Granollers,6-2; 3-6; 6-3; 6-4,R128,209,6,8,91,148,64,91,21,57,16,20,18,85,148,5,5,73,117,49,73,17,44,9,16,18,66,117
2012-05-27 00:00:00.000,Roland Garros France Grand Slams,CLAY,3,Malek Jaziri,Philipp Petzschner,Malek Jaziri,6-3; 7-5; 7-6(7),R128,176,6,1,66,123,40,66,35,57,11,15,17,75,123,5,4,60,119,41,60,26,59,13,19,16,67,119
2012-05-27 00:00:00.000,Roland Garros France Grand Slams,CLAY,3,Paul-Henri Mathieu,Bjorn Phau,Paul-Henri Mathieu,2-6; 4-6; 6-4; 6-3; 6-0,R128,194,7,10,70,137,55,70,31,67,8,13,22,86,137,13,5,56,113,35,56,31,57,0,7,21,66,113
2012-05-27 00:00:00.000,Roland Garros France Grand Slams,CLAY,3,John Isner,Rogerio Dutra Silva,John Isner,6-3; 6-4; 6-4,R128,94,18,2,52,70,48,52,13,18,2,2,15,61,70,3,5,70,86,49,70,6,16,8,11,14,55,86
2012-05-27 00:00:00.000,Roland Garros France Grand Slams,CLAY,3,Sergiy Stakhovsky,Alexandr Dolgopolov,Sergiy Stakhovsky,6-7(4); 6-4; 7-6(4); 3-6; 6-3,R128,220,8,3,92,150,72,92,33,58,4,8,26,105,150,16,6,64,163,52,64,57,99,6,11,26,109,163
2012-05-27 00:00:00.000,Roland Garros France Grand Slams,CLAY,3,Tommy Haas,Filippo Volandri,Tommy Haas,6-3; 0-6; 6-4; 6-4,R128,164,7,6,80,127,56,80,19,47,7,12,18,75,127,0,2,82,117,49,82,21,35,12,17,17,70,117
2012-05-27 00:00:00.000,Roland Garros France Grand Slams,CLAY,3,Grigor Dimitrov,Donald Young,Grigor Dimitrov,7-6(3); 6-1; 6-1,R128,111,13,5,54,90,44,54,18,36,5,6,13,62,90,1,5,55,87,31,55,15,32,3,9,13,46,87
2012-05-27 00:00:00.000,Roland Garros France Grand Slams,CLAY,3,Richard Gasquet,Jurgen Zopp,Richard Gasquet,6-3; 6-4; 7-6(4),R128,142,8,5,66,103,57,66,21,37,6,6,16,78,103,6,1,50,94,41,50,24,44,4,6,15,65,94
2012-05-27 00:00:00.000,Roland Garros France Grand Slams,CLAY,3,Bernard Tomic,Andreas Haider-Maurer,Bernard Tomic,7-6(5); 6-3; 6-3,R128,121,10,2,76,116,46,76,22,40,6,9,15,68,116,3,9,61,97,34,61,16,36,3,9,15,50,97
2012-05-27 00:00:00.000,Roland Garros France Grand Slams,CLAY,3,Santiago Giraldo,Alejandro Falla,Santiago Giraldo,5-7; 6-2; 6-4; 7-6(4),R128,229,3,0,104,156,65,104,29,52,16,21,21,94,156,2,5,92,147,55,92,27,55,10,17,21,82,147
2012-05-27 00:00:00.000,Roland Garros France Grand Slams,CLAY,3,Jarkko Nieminen,Igor Andreev,Jarkko Nieminen,3-6; 6-2; 2-1 RET,R128,70,4,2,34,51,26,34,7,17,0,3,10,33,51,0,4,37,59,26,37,9,22,5,9,10,35,59
2012-05-27 00:00:00.000,Roland Garros France Grand Slams,CLAY,3,Andy Murray,Tatsuma Ito,Andy Murray,6-1; 7-5; 6-0,R128,95,3,3,39,69,34,39,17,30,3,4,13,51,69,0,4,39,64,19,39,11,25,6,13,12,30,64
2012-05-27 00:00:00.000,Roland Garros France Grand Slams,CLAY,3,Janko Tipsarevic,Sam Querrey,Janko Tipsarevic,2-6; 6-4; 7-6(3); 6-3,R128,156,13,0,71,114,55,71,25,43,3,6,20,80,114,8,8,60,123,46,60,34,63,5,8,19,80,123
2012-05-27 00:00:00.000,Roland Garros France Grand Slams,CLAY,3,Jeremy Chardy,Yen-Hsun Lu,Jeremy Chardy,6-4; 6-1; 6-7(3); 3-6; 11-9,R128,250,17,11,84,165,61,84,50,81,5,9,28,111,165,18,12,106,179,75,106,35,73,8,16,30,110,179
2012-05-27 00:00:00.000,Roland Garros France Grand Slams,CLAY,3,Dmitry Tursunov,Go Soeda,Dmitry Tursunov,6-1; 6-4; 6-4,R128,122,8,1,45,77,34,45,17,32,2,4,14,51,77,0,5,50,92,30,50,20,42,6,12,13,50,92
2012-05-27 00:00:00.000,Roland Garros France Grand Slams,CLAY,3,Julien Benneteau,Mischa Zverev,Julien Benneteau,6-2; 6-7(3); 6-4; 6-4,R128,206,3,10,89,133,61,89,17,44,10,15,20,78,133,9,6,82,139,45,82,29,57,17,26,20,74,139
2012-05-27 00:00:00.000,Roland Garros France Grand Slams,CLAY,3,Philipp Kohlschreiber,Matthew Ebden,Philipp Kohlschreiber,6-4; 6-4; 7-6(4),R128,123,11,1,62,93,46,62,23,31,0,1,16,69,93,6,4,71,98,50,71,11,27,2,5,16,61,98
2012-05-27 00:00:00.000,Roland Garros France Grand Slams,CLAY,3,Leonardo Mayer,Olivier Rochus,Leonardo Mayer,6-3; 6-4; 2-6; 6-4,R128,168,18,4,67,113,58,67,19,46,3,5,19,77,113,2,0,71,104,50,71,19,33,2,5,18,69,104
2012-05-27 00:00:00.000,Roland Garros France Grand Slams,CLAY,3,Marcos Baghdatis,Juan Ignacio Chela,Marcos Baghdatis,6-3; 6-3; 6-1,R128,105,8,3,28,75,25,28,30,47,3,3,13,55,75,1,6,38,71,25,38,16,33,3,8,12,41,71
2012-05-27 00:00:00.000,Roland Garros France Grand Slams,CLAY,3,Nicolas Almagro,Paolo Lorenzi,Nicolas Almagro,6-3; 7-5; 6-4,R128,153,14,4,69,118,53,69,24,49,10,12,16,77,118,7,3,43,89,31,43,22,46,3,8,15,53,89
2012-05-27 00:00:00.000,Roland Garros France Grand Slams,CLAY,3,Juan Monaco,Guillaume Rufin,Juan Monaco,6-2; 2-6; 6-2; 7-6(3),R128,199,5,2,81,111,56,81,17,30,5,9,18,73,111,5,3,81,139,48,81,27,58,13,19,18,75,139
2012-05-27 00:00:00.000,Roland Garros France Grand Slams,CLAY,3,Lukas Rosol,Carlos Berlocq,Lukas Rosol,6-4; 7-5; 6-7(6); 6-2,R128,190,18,6,74,145,54,74,36,71,12,17,21,90,145,2,3,90,128,51,90,18,38,8,17,21,69,128
2012-05-27 00:00:00.000,Roland Garros France Grand Slams,CLAY,3,Jesse Levine,Benjamin Becker,Jesse Levine,7-5; 6-2; 6-4,R128,128,8,4,53,91,38,53,22,38,7,9,15,60,91,10,3,40,97,29,40,23,57,8,14,15,52,97
2012-05-27 00:00:00.000,Roland Garros France Grand Slams,CLAY,3,Milos Raonic,Ruben Ramirez Hidalgo,Milos Raonic,6-4; 6-2; 6-2,R128,102,12,4,38,76,32,38,24,38,3,3,13,56,76,2,5,41,72,28,41,14,31,3,8,13,42,72
2012-05-27 00:00:00.000,Roland Garros France Grand Slams,CLAY,3,Florian Mayer,Daniel Gimeno-Traver,Florian Mayer,6-4; 6-2; 6-3,R128,103,7,1,43,77,37,43,16,34,3,4,13,53,77,6,1,50,88,35,50,13,38,7,13,14,48,88
2012-05-27 00:00:00.000,Roland Garros France Grand Slams,CLAY,3,Eduardo Schwank,Ivo Karlovic,Eduardo Schwank,6-4; 6-0; 6-3,R128,88,5,0,56,69,44,56,10,13,2,2,13,54,69,9,8,41,79,27,41,14,38,3,8,12,41,79
2012-05-27 00:00:00.000,Roland Garros France Grand Slams,CLAY,3,Denis Istomin,Igor Kunitsyn,Denis Istomin,6-2; 6-1; 6-2,R128,92,13,0,42,62,32,42,14,20,1,2,12,46,62,1,2,53,87,32,53,9,34,4,11,11,41,87
2012-05-27 00:00:00.000,Roland Garros France Grand Slams,CLAY,3,Rafael Nadal,Simone Bolelli,Rafael Nadal,6-2; 6-2; 6-1,R128,118,0,3,38,70,29,38,22,32,4,5,12,51,70,3,1,37,68,21,37,11,31,2,9,11,32,68
2012-05-27 00:00:00.000,Roland Garros France Grand Slams,CLAY,3,Novak Djokovic,Blaz Kavcic,Novak Djokovic,6-0; 6-4; 6-4,R64,134,5,1,49,73,36,49,17,24,2,3,13,53,73,0,3,61,95,35,61,16,34,9,15,13,51,95
2012-05-27 00:00:00.000,Roland Garros France Grand Slams,CLAY,3,Nicolas Devilder,Michael Berrer,Nicolas Devilder,7-6(5); 6-4; 6-2,R64,136,2,0,45,91,31,45,30,46,7,9,15,61,91,4,2,67,89,45,67,5,22,3,8,15,50,89
2012-05-27 00:00:00.000,Roland Garros France Grand Slams,CLAY,3,Andreas Seppi,Mikhail Kukushkin,Andreas Seppi,6-7(5); 6-2; 2-6; 6-1; 6-2,R64,197,12,3,78,136,58,78,32,58,1,4,22,90,136,6,1,86,147,54,86,31,61,9,16,21,85,147
2012-05-27 00:00:00.000,Roland Garros France Grand Slams,CLAY,3,Fernando Verdasco,Gilles Muller,Fernando Verdasco,6-7(5); 6-3; 6-2; 6-2,R64,171,6,5,97,115,69,97,10,18,8,10,19,79,115,8,2,68,122,48,68,21,54,7,14,18,69,122
2012-05-27 00:00:00.000,Roland Garros France Grand Slams,CLAY,3,Gilles Simon,Brian Baker,Gilles Simon,6-4; 6-1; 6-7(4); 1-6; 6-0,R64,175,15,3,72,121,52,72,27,49,3,7,20,79,121,10,2,85,144,48,85,33,59,10,19,22,81,144
2012-05-27 00:00:00.000,Roland Garros France Grand Slams,CLAY,3,Stan Wawrinka,Pablo Andujar,Stan Wawrinka,7-6(3); 6-7(4); 6-2; 6-1,R64,179,7,5,72,132,61,72,30,60,3,4,20,91,132,1,5,78,128,53,78,24,50,8,13,19,77,128
2012-05-27 00:00:00.000,Roland Garros France Grand Slams,CLAY,3,Fabio Fognini,Viktor Troicki,Fabio Fognini,6-2; 3-6; 4-6; 6-3; 8-6,R64,210,3,1,104,152,69,104,29,48,9,14,25,98,152,7,1,108,155,73,108,19,47,6,13,25,92,155
2012-05-27 00:00:00.000,Roland Garros France Grand Slams,CLAY,3,Jo-Wilfried Tsonga,Cedrik-Marcel Stebe,Jo-Wilfried Tsonga,6-2; 4-6; 6-2; 6-1,R64,155,4,3,58,97,40,58,24,39,4,7,16,64,97,3,5,61,116,30,61,25,55,6,15,17,55,116
2012-05-27 00:00:00.000,Roland Garros France Grand Slams,CLAY,3,Roger Federer,Adrian Ungur,Roger Federer,6-3; 6-2; 6-7(6); 6-3,R64,147,15,1,83,130,65,83,31,47,6,6,20,96,130,5,7,79,124,56,79,25,45,8,12,18,81,124
2012-05-27 00:00:00.000,Roland Garros France Grand Slams,CLAY,3,Nicolas Mahut,Martin Klizan,Nicolas Mahut,4-6; 6-4; 7-6(5); 6-3,R64,202,20,5,77,135,58,77,33,58,7,10,20,91,135,6,3,81,147,55,81,37,66,7,12,21,92,147
2012-05-27 00:00:00.000,Roland Garros France Grand Slams,CLAY,3,David Goffin,Arnaud Clement,David Goffin,3-6; 7-6(2); 0-6; 6-2; 6-1,R64,215,10,4,53,118,39,53,28,65,7,14,20,67,118,9,4,94,157,57,94,27,63,15,23,22,84,157
2012-05-27 00:00:00.000,Roland Garros France Grand Slams,CLAY,3,Lukasz Kubot,Florent Serra,Lukasz Kubot,7-6(0); 6-2; 7-6(4),R64,159,8,5,69,109,50,69,17,40,2,7,16,67,109,2,2,71,118,36,71,23,47,4,11,16,59,118
2012-05-27 00:00:00.000,Roland Garros France Grand Slams,CLAY,3,Juan Martin Del Potro,Edouard Roger-Vasselin,Juan Martin Del Potro,6-7(5); 7-6(3); 6-4; 6-4,R64,219,8,3,78,130,53,78,34,52,6,9,22,87,130,11,1,88,142,60,88,25,54,3,8,22,85,142
2012-05-27 00:00:00.000,Roland Garros France Grand Slams,CLAY,3,Marin Cilic,Juan Carlos Ferrero,Marin Cilic,7-6(4); 6-2; 6-3,R64,133,7,1,47,90,36,47,25,43,2,3,14,61,90,5,5,56,99,34,56,22,43,3,8,15,56,99
2012-05-27 00:00:00.000,Roland Garros France Grand Slams,CLAY,3,Kevin Anderson,Horacio Zeballos,Kevin Anderson,6-3; 3-6; 6-3; 6-0,R64,131,21,1,68,96,58,68,15,28,5,6,17,73,96,7,5,71,105,48,71,13,34,6,11,16,61,105
2012-05-27 00:00:00.000,Roland Garros France Grand Slams,CLAY,3,Tomas Berdych,Michael Llodra,Tomas Berdych,6-2; 6-3; 6-3,R64,101,8,0,44,72,36,44,18,28,0,0,13,54,72,4,1,50,75,29,50,10,25,2,7,13,39,75
2012-05-27 00:00:00.000,Roland Garros France Grand Slams,CLAY,3,David Ferrer,Benoit Paire,David Ferrer,6-3; 6-3; 6-2,R64,107,0,5,59,82,42,59,13,23,5,7,13,55,82,5,2,56,96,32,56,15,40,13,20,13,47,96
2012-05-27 00:00:00.000,Roland Garros France Grand Slams,CLAY,3,Mikhail Youzhny,Robin Haase,Mikhail Youzhny,6-3; 7-6(5); 6-4,R64,145,4,4,63,101,47,63,22,38,6,9,16,69,101,5,0,70,112,44,70,19,42,6,11,15,63,112
2012-05-27 00:00:00.000,Roland Garros France Grand Slams,CLAY,3,Marcel Granollers,Malek Jaziri,Marcel Granollers,7-6(1); 3-6; 6-1; 3-6; 7-5,R64,267,3,6,98,150,69,98,23,52,9,15,24,92,150,3,2,120,178,73,120,27,58,16,23,25,100,178
2012-05-27 00:00:00.000,Roland Garros France Grand Slams,CLAY,3,Paul-Henri Mathieu,John Isner,Paul-Henri Mathieu,6-7(2); 6-4; 6-4; 3-6; 18-16,R64,341,6,6,131,201,99,131,50,70,2,4,37,149,201,41,1,185,249,131,185,34,64,20,24,38,165,249
2012-05-27 00:00:00.000,Roland Garros France Grand Slams,CLAY,3,Tommy Haas,Sergiy Stakhovsky,Tommy Haas,6-2; 6-3; 6-2,R64,116,5,1,42,67,29,42,15,25,4,7,13,44,67,2,2,57,91,29,57,10,34,11,19,12,39,91
2012-05-27 00:00:00.000,Roland Garros France Grand Slams,CLAY,3,Richard Gasquet,Grigor Dimitrov,Richard Gasquet,5-7; 7-5; 6-2; 6-3,R64,206,10,7,75,124,53,75,28,49,8,12,21,81,124,3,3,99,151,58,99,27,52,16,23,20,85,151
2012-05-27 00:00:00.000,Roland Garros France Grand Slams,CLAY,3,Santiago Giraldo,Bernard Tomic,Santiago Giraldo,6-4; 6-1; 6-3,R64,105,0,0,69,86,52,69,5,17,10,11,13,57,86,6,3,58,92,34,58,13,34,7,13,13,47,92
2012-05-27 00:00:00.000,Roland Garros France Grand Slams,CLAY,3,Andy Murray,Jarkko Nieminen,Andy Murray,1-6; 6-4; 6-1; 6-2,R64,147,0,5,84,108,55,84,11,24,8,12,16,66,108,0,5,63,105,36,63,17,42,8,15,16,53,105
2012-05-27 00:00:00.000,Roland Garros France Grand Slams,CLAY,3,Janko Tipsarevic,Jeremy Chardy,Janko Tipsarevic,7-6(4); 6-1; 7-5,R64,154,12,7,59,107,46,59,27,48,2,4,16,73,107,4,7,48,113,32,48,32,65,4,9,15,64,113
2012-05-27 00:00:00.000,Roland Garros France Grand Slams,CLAY,3,Julien Benneteau,Dmitry Tursunov,Julien Benneteau,6-4; 6-4; 6-4,R64,118,10,1,70,92,55,70,13,22,3,3,15,68,92,8,2,53,90,42,53,16,37,2,5,15,58,90
2012-05-27 00:00:00.000,Roland Garros France Grand Slams,CLAY,3,Leonardo Mayer,Philipp Kohlschreiber,Leonardo Mayer,7-6(5); 7-6(4); 7-5,R64,187,16,2,83,126,67,83,23,43,13,14,18,90,126,4,2,68,121,48,68,34,53,6,8,18,82,121
2012-05-27 00:00:00.000,Roland Garros France Grand Slams,CLAY,3,Nicolas Almagro,Marcos Baghdatis,Nicolas Almagro,6-4; 6-3; 7-5,R64,158,7,7,61,116,46,61,28,55,4,6,16,74,116,4,2,61,115,38,61,26,54,11,16,15,64,115
2012-05-27 00:00:00.000,Roland Garros France Grand Slams,CLAY,3,Juan Monaco,Lukas Rosol,Juan Monaco,7-6(4); 6-0; 7-6(5),R64,130,1,0,71,87,59,71,14,16,0,0,15,73,87,9,4,61,111,46,61,23,50,2,5,15,69,111
2012-05-27 00:00:00.000,Roland Garros France Grand Slams,CLAY,3,Milos Raonic,Jesse Levine,Milos Raonic,6-4; 7-5; 6-2,R64,116,16,8,44,80,39,44,20,36,2,3,15,59,80,4,0,56,89,31,56,20,33,5,10,15,51,89
2012-05-27 00:00:00.000,Roland Garros France Grand Slams,CLAY,3,Eduardo Schwank,Florian Mayer,Eduardo Schwank,2-6; 6-3; 6-4; 7-6(4),R64,150,6,7,67,116,43,67,32,49,2,6,19,75,116,5,2,68,112,51,68,23,44,4,9,20,74,112
2012-05-27 00:00:00.000,Roland Garros France Grand Slams,CLAY,3,Rafael Nadal,Denis Istomin,Rafael Nadal,6-2; 6-2; 6-0,R64,110,0,1,44,64,34,44,14,20,2,2,11,48,64,4,2,41,62,22,41,5,21,8,15,11,27,62
2012-05-27 00:00:00.000,Roland Garros France Grand Slams,CLAY,3,Novak Djokovic,Nicolas Devilder,Novak Djokovic,6-1; 6-2; 6-2,R32,104,3,0,50,77,36,50,18,27,3,4,12,54,77,5,2,41,71,24,41,8,30,3,10,11,32,71
2012-05-27 00:00:00.000,Roland Garros France Grand Slams,CLAY,3,Andreas Seppi,Fernando Verdasco,Andreas Seppi,7-5; 3-6; 6-3; 4-6; 6-2,R32,203,8,4,92,142,66,92,26,50,6,11,24,92,142,12,8,94,137,64,94,21,43,4,11,24,85,137
2012-05-27 00:00:00.000,Roland Garros France Grand Slams,CLAY,3,Stan Wawrinka,Gilles Simon,Stan Wawrinka,7-5; 6-7(5); 6-7(3); 6-3; 6-2,R32,277,9,1,108,182,78,108,37,74,6,11,27,115,182,2,3,95,180,65,95,39,85,10,19,26,104,180
2012-05-27 00:00:00.000,Roland Garros France Grand Slams,CLAY,3,Jo-Wilfried Tsonga,Fabio Fognini,Jo-Wilfried Tsonga,7-5; 6-4; 6-4,R32,148,7,1,60,93,43,60,12,33,3,8,16,55,93,0,3,77,107,40,77,15,30,7,15,16,55,107
2012-05-27 00:00:00.000,Roland Garros France Grand Slams,CLAY,3,Roger Federer,Nicolas Mahut,Roger Federer,6-3; 4-6; 6-2; 7-5,R32,157,7,3,60,104,49,60,29,44,1,3,20,78,104,2,2,84,128,53,84,21,44,9,14,19,74,128
2012-05-27 00:00:00.000,Roland Garros France Grand Slams,CLAY,3,David Goffin,Lukasz Kubot,David Goffin,7-6(4); 7-5; 6-1,R32,152,2,2,58,94,45,58,21,36,5,7,16,66,94,5,1,66,97,43,66,13,31,7,12,15,56,97
2012-05-27 00:00:00.000,Roland Garros France Grand Slams,CLAY,3,Juan Martin Del Potro,Marin Cilic,Juan Martin Del Potro,6-3; 7-6(7); 6-1,R32,152,4,1,59,82,46,59,11,23,0,1,13,57,82,8,5,53,104,28,53,29,51,8,14,15,57,104
2012-05-27 00:00:00.000,Roland Garros France Grand Slams,CLAY,3,Tomas Berdych,Kevin Anderson,Tomas Berdych,6-4; 3-6; 6-7(4); 6-4; 6-4,R32,232,10,5,95,156,71,95,37,61,4,6,25,108,156,22,3,100,143,80,100,20,43,2,6,26,100,143
2012-05-27 00:00:00.000,Roland Garros France Grand Slams,CLAY,3,David Ferrer,Mikhail Youzhny,David Ferrer,6-0; 6-2; 6-2,R32,101,2,1,57,74,42,57,10,17,6,6,11,52,74,0,4,38,69,22,38,8,31,4,11,11,30,69
2012-05-27 00:00:00.000,Roland Garros France Grand Slams,CLAY,3,Marcel Granollers,Paul-Henri Mathieu,Marcel Granollers,6-4; 6-4; 1-6; 4-6; 6-1,R32,236,7,4,91,138,62,91,24,47,12,17,22,86,138,1,4,80,134,48,80,34,54,10,16,22,82,134
2012-05-27 00:00:00.000,Roland Garros France Grand Slams,CLAY,3,Richard Gasquet,Tommy Haas,Richard Gasquet,6-7(3); 6-3; 6-0; 6-0,R32,145,10,2,61,92,45,61,23,31,2,3,16,68,92,7,7,62,108,38,62,20,46,7,16,17,58,108
2012-05-27 00:00:00.000,Roland Garros France Grand Slams,CLAY,3,Andy Murray,Santiago Giraldo,Andy Murray,6-3; 6-4; 6-4,R32,122,9,1,53,76,45,53,17,23,1,1,15,62,76,4,0,70,94,48,70,13,24,4,7,14,61,94
2012-05-27 00:00:00.000,Roland Garros France Grand Slams,CLAY,3,Janko Tipsarevic,Julien Benneteau,Janko Tipsarevic,6-3; 7-5; 6-4,R32,155,16,5,55,102,45,55,26,47,6,7,16,71,102,4,4,67,94,47,67,11,27,8,12,15,58,94
2012-05-27 00:00:00.000,Roland Garros France Grand Slams,CLAY,3,Nicolas Almagro,Leonardo Mayer,Nicolas Almagro,6-4; 6-1; 6-2,R32,111,8,0,44,65,40,44,14,21,1,1,13,54,65,2,6,47,76,23,47,17,29,5,10,12,40,76
2012-05-27 00:00:00.000,Roland Garros France Grand Slams,CLAY,3,Juan Monaco,Milos Raonic,Juan Monaco,6-7(5); 6-3; 6-7(5); 6-3; 6-4,R32,273,5,0,149,192,107,149,25,43,8,8,27,132,192,26,5,95,175,75,95,40,80,13,16,25,115,175
2012-05-27 00:00:00.000,Roland Garros France Grand Slams,CLAY,3,Rafael Nadal,Eduardo Schwank,Rafael Nadal,6-1; 6-3; 6-4,R32,136,1,1,46,77,40,46,16,31,4,4,13,56,77,3,0,58,88,35,58,14,30,5,10,13,49,88
2012-05-27 00:00:00.000,Roland Garros France Grand Slams,CLAY,3,Novak Djokovic,Andreas Seppi,Novak Djokovic,4-6; 6-7(5); 6-3; 7-5; 6-3,R16,258,5,2,91,144,63,91,32,53,4,10,26,95,144,6,4,113,206,64,113,51,93,13,22,26,115,206
2012-05-27 00:00:00.000,Roland Garros France Grand Slams,CLAY,3,Jo-Wilfried Tsonga,Stan Wawrinka,Jo-Wilfried Tsonga,6-4; 7-6(6); 3-6; 3-6; 6-4,R16,246,4,2,105,164,71,105,30,59,11,17,25,101,164,4,2,110,174,78,110,28,64,8,13,25,106,174
2012-05-27 00:00:00.000,Roland Garros France Grand Slams,CLAY,3,Roger Federer,David Goffin,Roger Federer,5-7; 7-5; 6-2; 6-4,R16,174,12,1,76,125,62,76,31,49,7,8,21,93,125,4,8,87,150,56,87,37,63,9,13,21,93,150
2012-05-27 00:00:00.000,Roland Garros France Grand Slams,CLAY,3,Juan Martin Del Potro,Tomas Berdych,Juan Martin Del Potro,7-6(6); 1-6; 6-3; 7-5,R16,206,8,3,82,127,57,82,23,45,9,14,20,80,127,12,2,81,133,55,81,25,52,10,15,20,80,133
2012-05-27 00:00:00.000,Roland Garros France Grand Slams,CLAY,3,David Ferrer,Marcel Granollers,David Ferrer,6-3; 6-2; 6-0,R16,111,0,2,50,70,40,50,13,20,3,3,12,53,70,0,4,55,79,33,55,5,24,8,14,11,38,79
2012-05-27 00:00:00.000,Roland Garros France Grand Slams,CLAY,3,Andy Murray,Richard Gasquet,Andy Murray,1-6; 6-4; 6-1; 6-2,R16,150,8,1,60,92,47,60,17,32,6,9,16,64,92,2,3,77,107,47,77,12,30,6,12,16,59,107
2012-05-27 00:00:00.000,Roland Garros France Grand Slams,CLAY,3,Nicolas Almagro,Janko Tipsarevic,Nicolas Almagro,6-4; 6-4; 6-4,R16,133,9,3,43,85,33,43,26,42,3,5,15,59,85,3,5,69,100,45,69,13,31,7,12,15,58,100
2012-05-27 00:00:00.000,Roland Garros France Grand Slams,CLAY,3,Rafael Nadal,Juan Monaco,Rafael Nadal,6-2; 6-0; 6-0,R16,106,2,0,45,65,31,45,15,20,2,2,10,46,65,0,0,44,61,21,44,3,17,2,10,10,24,61
2012-05-27 00:00:00.000,Roland Garros France Grand Slams,CLAY,3,Novak Djokovic,Jo-Wilfried Tsonga,Novak Djokovic,6-1; 5-7; 5-7; 7-6(6); 6-1,Q,249,7,2,114,169,81,114,29,55,7,11,26,110,169,6,3,106,156,69,106,21,50,7,13,24,90,156
2012-05-27 00:00:00.000,Roland Garros France Grand Slams,CLAY,3,Roger Federer,Juan Martin Del Potro,Roger Federer,3-6; 6-7(4); 6-2; 6-0; 6-3,Q,194,11,1,80,138,55,80,35,58,6,10,23,90,138,6,4,80,135,59,80,17,55,10,18,21,76,135
2012-05-27 00:00:00.000,Roland Garros France Grand Slams,CLAY,3,David Ferrer,Andy Murray,David Ferrer,6-4; 6-7(3); 6-3; 6-2,Q,225,3,5,90,141,61,90,20,51,10,15,19,81,141,3,1,84,158,50,84,29,74,9,19,20,79,158
2012-05-27 00:00:00.000,Roland Garros France Grand Slams,CLAY,3,Rafael Nadal,Nicolas Almagro,Rafael Nadal,7-6(4); 6-2; 6-3,Q,166,10,1,67,101,56,67,17,34,4,4,15,73,101,4,1,66,104,46,66,17,38,3,6,14,63,104
2012-05-27 00:00:00.000,Roland Garros France Grand Slams,CLAY,3,Novak Djokovic,Roger Federer,Novak Djokovic,6-4; 7-5; 6-3,S,125,6,2,62,91,45,62,14,29,4,8,16,59,91,9,3,48,86,27,48,17,38,3,10,15,44,86
2012-05-27 00:00:00.000,Roland Garros France Grand Slams,CLAY,3,Rafael Nadal,David Ferrer,Rafael Nadal,6-2; 6-2; 6-1,S,106,2,1,39,65,33,39,15,26,2,2,11,48,65,1,3,37,66,19,37,12,29,3,10,12,31,66
2012-05-27 00:00:00.000,Roland Garros France Grand Slams,CLAY,3,Rafael Nadal,Novak Djokovic,Rafael Nadal,6-4; 6-3; 2-6; 7-5,F,229,4,4,73,118,45,73,24,45,3,10,19,69,118,3,4,73,123,45,73,22,50,8,17,20,67,123
2012-06-11 00:00:00.000,Halle Germany ATP World Tour 250,GRASS,2,Rafael Nadal,N/A Bye,Rafael Nadal,,R32,0,0,0,0,0,0,0,0,0,0,0,0,0,0,0,0,0,0,0,0,0,0,0,0,0,0,0
2012-06-11 00:00:00.000,Halle Germany ATP World Tour 250,GRASS,2,Lukas Lacko,Konstantin Kravchuk,Lukas Lacko,2-6; 6-2; 6-3,R32,149,5,0,53,75,37,53,9,22,1,4,12,46,75,6,1,54,72,36,54,7,18,6,11,13,43,72
2012-06-11 00:00:00.000,Halle Germany ATP World Tour 250,GRASS,2,Lukasz Kubot,Jarkko Nieminen,Lukasz Kubot,6-4; 6-4,R32,77,7,0,33,53,26,33,14,20,0,0,10,40,53,5,2,46,71,35,46,9,25,8,10,10,44,71
2012-06-11 00:00:00.000,Halle Germany ATP World Tour 250,GRASS,2,Philipp Kohlschreiber,Dustin Brown,Philipp Kohlschreiber,7-6(4); 7-6(4),R32,83,6,1,42,67,36,42,19,25,0,1,12,55,67,10,4,45,77,36,45,18,32,1,2,12,54,77
2012-06-11 00:00:00.000,Halle Germany ATP World Tour 250,GRASS,2,Tomas Berdych,N/A Bye,Tomas Berdych,,R32,0,0,0,0,0,0,0,0,0,0,0,0,0,0,0,0,0,0,0,0,0,0,0,0,0,0,0
2012-06-11 00:00:00.000,Halle Germany ATP World Tour 250,GRASS,2,Viktor Troicki,Benjamin Becker,Viktor Troicki,6-2; 7-6(6),R32,81,21,3,46,65,37,46,10,19,2,2,10,47,65,5,5,40,69,31,40,11,29,3,5,10,42,69
2012-06-11 00:00:00.000,Halle Germany ATP World Tour 250,GRASS,2,Tommy Haas,Bernard Tomic,Tommy Haas,5-2 RET,R32,23,2,0,12,19,11,12,5,7,0,0,4,16,19,1,0,15,21,8,15,5,6,1,2,3,13,21
2012-06-11 00:00:00.000,Halle Germany ATP World Tour 250,GRASS,2,Marcel Granollers,Mischa Zverev,Marcel Granollers,6-4; 6-2,R32,75,3,0,29,49,23,29,14,20,0,0,9,37,49,3,3,38,61,27,38,9,23,6,9,9,36,61
2012-06-11 00:00:00.000,Halle Germany ATP World Tour 250,GRASS,2,Radek Stepanek,Andreas Seppi,Radek Stepanek,7-6(6); 4-6; 7-6(7),R32,174,8,5,72,122,53,72,30,50,8,10,17,83,122,9,2,72,125,55,72,31,53,8,9,17,86,125
2012-06-11 00:00:00.000,Halle Germany ATP World Tour 250,GRASS,2,Cedrik-Marcel Stebe,Carlos Berlocq,Cedrik-Marcel Stebe,6-3; 3-6; 7-5,R32,166,6,4,65,100,49,65,18,35,11,12,15,67,100,4,7,80,125,58,80,20,45,15,17,15,78,125
2012-06-11 00:00:00.000,Halle Germany ATP World Tour 250,GRASS,2,Mikhail Youzhny,Robin Haase,Mikhail Youzhny,6-3; 6-2,R32,68,1,2,39,54,31,39,9,15,2,2,9,40,54,5,2,34,54,22,34,8,20,7,10,8,30,54
2012-06-11 00:00:00.000,Halle Germany ATP World Tour 250,GRASS,2,Alexandr Dolgopolov,N/A Bye,Alexandr Dolgopolov,,R32,0,0,0,0,0,0,0,0,0,0,0,0,0,0,0,0,0,0,0,0,0,0,0,0,0,0,0
2012-06-11 00:00:00.000,Halle Germany ATP World Tour 250,GRASS,2,Milos Raonic,Philipp Petzschner,Milos Raonic,7-5; 7-6(1),R32,84,19,1,46,64,41,46,12,18,0,0,12,53,64,5,1,35,66,28,35,19,31,0,1,12,47,66
2012-06-11 00:00:00.000,Halle Germany ATP World Tour 250,GRASS,2,Ze Zhang,Tobias Kamke,Ze Zhang,6-4; 7-6(2),R32,92,6,3,55,81,36,55,10,26,6,10,11,46,81,1,7,49,72,28,49,10,23,4,9,11,38,72
2012-06-11 00:00:00.000,Halle Germany ATP World Tour 250,GRASS,2,Florian Mayer,Tim Smyczek,Florian Mayer,6-4; 6-4,R32,69,6,0,30,46,29,30,11,16,0,0,10,40,46,2,1,36,67,27,36,14,31,4,6,10,41,67
2012-06-11 00:00:00.000,Halle Germany ATP World Tour 250,GRASS,2,Roger Federer,N/A Bye,Roger Federer,,R32,0,0,0,0,0,0,0,0,0,0,0,0,0,0,0,0,0,0,0,0,0,0,0,0,0,0,0
2012-06-11 00:00:00.000,Halle Germany ATP World Tour 250,GRASS,2,Rafael Nadal,Lukas Lacko,Rafael Nadal,7-5; 6-1,R16,76,2,0,37,52,28,37,10,15,0,1,10,38,52,4,3,42,64,26,42,7,22,4,8,9,33,64
2012-06-11 00:00:00.000,Halle Germany ATP World Tour 250,GRASS,2,Philipp Kohlschreiber,Lukasz Kubot,Philipp Kohlschreiber,6-7(5); 6-1; 6-3,R16,124,11,2,47,82,41,47,22,35,1,1,14,63,82,6,7,58,99,44,58,17,41,4,8,14,61,99
2012-06-11 00:00:00.000,Halle Germany ATP World Tour 250,GRASS,2,Tomas Berdych,Viktor Troicki,Tomas Berdych,6-3; 6-2,R16,64,7,2,24,44,21,24,12,20,0,0,8,33,44,2,1,28,53,19,28,11,25,3,7,9,30,53
2012-06-11 00:00:00.000,Halle Germany ATP World Tour 250,GRASS,2,Tommy Haas,Marcel Granollers,Tommy Haas,6-3; 6-4,R16,79,0,0,34,55,28,34,14,21,1,1,10,42,55,3,3,38,53,26,38,6,15,1,3,9,32,53
2012-06-11 00:00:00.000,Halle Germany ATP World Tour 250,GRASS,2,Radek Stepanek,Cedrik-Marcel Stebe,Radek Stepanek,6-4; 6-4,R16,87,2,1,37,55,29,37,13,18,0,0,10,42,55,5,2,52,69,35,52,9,17,3,5,10,44,69
2012-06-11 00:00:00.000,Halle Germany ATP World Tour 250,GRASS,2,Mikhail Youzhny,Alexandr Dolgopolov,Mikhail Youzhny,6-4; 3-6; 6-3,R16,110,4,0,50,77,38,50,17,27,1,2,14,55,77,11,4,56,99,40,56,23,43,5,7,14,63,99
2012-06-11 00:00:00.000,Halle Germany ATP World Tour 250,GRASS,2,Milos Raonic,Ze Zhang,Milos Raonic,6-1; 6-1,R16,52,9,1,25,37,21,25,8,12,0,0,7,29,37,1,9,28,49,16,28,6,21,7,12,7,22,49
2012-06-11 00:00:00.000,Halle Germany ATP World Tour 250,GRASS,2,Roger Federer,Florian Mayer,Roger Federer,6-4; 7-5,R16,74,11,1,42,59,32,42,13,17,1,1,11,45,59,5,1,40,70,31,40,17,30,4,6,11,48,70
2012-06-11 00:00:00.000,Halle Germany ATP World Tour 250,GRASS,2,Philipp Kohlschreiber,Rafael Nadal,Philipp Kohlschreiber,6-3; 6-4,Q,86,8,0,30,60,27,30,18,30,3,3,10,45,60,3,2,38,59,28,38,9,21,6,8,9,37,59
2012-06-11 00:00:00.000,Halle Germany ATP World Tour 250,GRASS,2,Tommy Haas,Tomas Berdych,Tommy Haas,6-4; 3-6; 7-5,Q,125,10,3,55,90,47,55,18,35,4,5,15,65,90,9,7,52,93,41,52,22,41,3,5,16,63,93
2012-06-11 00:00:00.000,Halle Germany ATP World Tour 250,GRASS,2,Mikhail Youzhny,Radek Stepanek,Mikhail Youzhny,6-4; 4-6; 6-4,Q,149,4,1,57,88,40,57,20,31,4,6,15,60,88,8,1,87,119,58,87,13,32,12,15,15,71,119
2012-06-11 00:00:00.000,Halle Germany ATP World Tour 250,GRASS,2,Roger Federer,Milos Raonic,Roger Federer,6-7(4); 6-4; 7-6(3),Q,119,9,0,65,94,53,65,24,29,0,0,17,77,94,25,2,65,99,58,65,18,34,3,4,17,76,99
2012-06-11 00:00:00.000,Halle Germany ATP World Tour 250,GRASS,2,Tommy Haas,Philipp Kohlschreiber,Tommy Haas,7-6(5); 7-5,S,95,9,1,49,69,39,49,14,20,0,0,12,53,69,7,1,42,76,35,42,19,34,3,4,12,54,76
2012-06-11 00:00:00.000,Halle Germany ATP World Tour 250,GRASS,2,Roger Federer,Mikhail Youzhny,Roger Federer,6-1; 6-4,S,60,8,0,32,47,27,32,7,15,3,4,9,34,47,2,2,27,48,18,27,6,21,4,8,8,24,48
2012-06-11 00:00:00.000,Halle Germany ATP World Tour 250,GRASS,2,Tommy Haas,Roger Federer,Tommy Haas,7-6(5); 6-4,F,95,5,3,43,70,32,43,17,27,3,4,11,49,70,7,3,58,84,42,58,10,26,2,4,11,52,84
2012-06-11 00:00:00.000,London / Queen's Club Great Britain ATP World Tour 250,GRASS,2,Andy Murray,N/A Bye,Andy Murray,,R64,0,0,0,0,0,0,0,0,0,0,0,0,0,0,0,0,0,0,0,0,0,0,0,0,0,0,0
2012-06-11 00:00:00.000,London / Queen's Club Great Britain ATP World Tour 250,GRASS,2,Nicolas Mahut,Guillermo Garcia-Lopez,Nicolas Mahut,6-4; 6-2,R64,77,5,1,30,58,23,30,18,28,3,3,9,41,58,6,1,30,50,20,30,10,20,4,7,9,30,50
2012-06-11 00:00:00.000,London / Queen's Club Great Britain ATP World Tour 250,GRASS,2,Grigor Dimitrov,Bobby Reynolds,Grigor Dimitrov,6-3; 7-5,R64,88,4,2,35,66,27,35,17,31,5,7,11,44,66,3,4,50,82,29,50,16,32,11,15,10,45,82
2012-06-11 00:00:00.000,London / Queen's Club Great Britain ATP World Tour 250,GRASS,2,Gilles Muller,Liam Broady,Gilles Muller,6-2; 6-1,R64,54,11,2,32,44,29,32,5,12,3,3,8,34,44,2,5,24,44,14,24,6,20,1,5,7,20,44
2012-06-11 00:00:00.000,London / Queen's Club Great Britain ATP World Tour 250,GRASS,2,Kevin Anderson,James Ward,Kevin Anderson,4-6; 6-3; 6-4,R64,109,16,5,54,78,47,54,12,24,3,4,15,59,78,12,6,57,83,43,57,11,26,4,6,14,54,83
2012-06-11 00:00:00.000,London / Queen's Club Great Britain ATP World Tour 250,GRASS,2,Sergiy Stakhovsky,Flavio Cipolla,Sergiy Stakhovsky,6-4; 6-1,R64,77,4,3,38,58,30,38,12,20,4,4,9,42,58,1,2,38,60,23,38,11,22,2,5,8,34,60
2012-06-11 00:00:00.000,London / Queen's Club Great Britain ATP World Tour 250,GRASS,2,Steve Darcis,Ruben Ramirez Hidalgo,Steve Darcis,7-6(2); 7-5,R64,99,5,0,46,71,37,46,13,25,1,2,12,50,71,7,5,53,87,38,53,13,34,4,6,12,51,87
2012-06-11 00:00:00.000,London / Queen's Club Great Britain ATP World Tour 250,GRASS,2,Feliciano Lopez,N/A Bye,Feliciano Lopez,,R64,0,0,0,0,0,0,0,0,0,0,0,0,0,0,0,0,0,0,0,0,0,0,0,0,0,0,0
2012-06-11 00:00:00.000,London / Queen's Club Great Britain ATP World Tour 250,GRASS,2,Gilles Simon,N/A Bye,Gilles Simon,,R64,0,0,0,0,0,0,0,0,0,0,0,0,0,0,0,0,0,0,0,0,0,0,0,0,0,0,0
2012-06-11 00:00:00.000,London / Queen's Club Great Britain ATP World Tour 250,GRASS,2,Simone Bolelli,Ernests Gulbis,Simone Bolelli,6-3; 6-4,R64,64,5,2,37,53,32,37,10,16,1,1,10,42,53,9,2,33,56,26,33,8,23,1,3,9,34,56
2012-06-11 00:00:00.000,London / Queen's Club Great Britain ATP World Tour 250,GRASS,2,Xavier Malisse,Adrian Ungur,Xavier Malisse,6-4; 6-4,R64,68,10,1,35,52,27,35,13,17,2,3,10,40,52,5,4,32,68,25,32,14,36,4,7,10,39,68
2012-06-11 00:00:00.000,London / Queen's Club Great Britain ATP World Tour 250,GRASS,2,Alex Bogomolov Jr.,Martin Klizan,Alex Bogomolov Jr.,6-2; 7-6(5),R64,116,2,6,62,87,46,62,9,25,11,12,10,55,87,3,4,51,87,36,51,14,36,9,12,10,50,87
2012-06-11 00:00:00.000,London / Queen's Club Great Britain ATP World Tour 250,GRASS,2,David Nalbandian,Vasek Pospisil,David Nalbandian,4-6; 6-2; 6-2,R64,101,2,3,52,83,36,52,19,31,5,6,13,55,83,9,4,47,80,36,47,13,33,4,8,13,49,80
2012-06-11 00:00:00.000,London / Queen's Club Great Britain ATP World Tour 250,GRASS,2,Ruben Bemelmans,Malek Jaziri,Ruben Bemelmans,6-4; 1-6; 6-3,R64,110,8,4,50,84,37,50,15,34,8,11,13,52,84,3,1,51,86,32,51,20,35,5,8,13,52,86
2012-06-11 00:00:00.000,London / Queen's Club Great Britain ATP World Tour 250,GRASS,2,Edouard Roger-Vasselin,Evgeny Korolev,Edouard Roger-Vasselin,6-7(5); 6-2; 6-4,R64,115,7,6,54,89,49,54,19,35,5,5,15,68,89,10,5,68,110,45,68,23,42,6,9,15,68,110
2012-06-11 00:00:00.000,London / Queen's Club Great Britain ATP World Tour 250,GRASS,2,Andy Roddick,N/A Bye,Andy Roddick,,R64,0,0,0,0,0,0,0,0,0,0,0,0,0,0,0,0,0,0,0,0,0,0,0,0,0,0,0
2012-06-11 00:00:00.000,London / Queen's Club Great Britain ATP World Tour 250,GRASS,2,Marin Cilic,N/A Bye,Marin Cilic,,R64,0,0,0,0,0,0,0,0,0,0,0,0,0,0,0,0,0,0,0,0,0,0,0,0,0,0,0
2012-06-11 00:00:00.000,London / Queen's Club Great Britain ATP World Tour 250,GRASS,2,Matthew Ebden,Matthias Bachinger,Matthew Ebden,7-6(5); 6-3,R64,88,3,6,32,67,27,32,23,35,3,3,10,50,67,5,1,52,86,38,52,16,34,5,7,11,54,86
2012-06-11 00:00:00.000,London / Queen's Club Great Britain ATP World Tour 250,GRASS,2,Lukas Rosol,Victor Hanescu,Lukas Rosol,6-4; 7-6(5),R64,74,5,2,40,65,34,40,14,25,0,1,11,48,65,1,0,49,63,38,49,8,14,3,5,11,46,63
2012-06-11 00:00:00.000,London / Queen's Club Great Britain ATP World Tour 250,GRASS,2,Marcos Baghdatis,Frederico Gil,Marcos Baghdatis,7-6(2); 4-6; 6-2,R64,139,13,5,78,118,62,78,15,40,5,7,15,77,118,2,4,67,105,45,67,19,38,7,10,15,64,105
2012-06-11 00:00:00.000,London / Queen's Club Great Britain ATP World Tour 250,GRASS,2,Ivo Karlovic,Lleyton Hewitt,Ivo Karlovic,6-3; 6-2,R64,65,22,2,32,43,28,32,8,11,0,0,9,36,43,3,4,34,67,23,34,15,33,8,11,8,38,67
2012-06-11 00:00:00.000,London / Queen's Club Great Britain ATP World Tour 250,GRASS,2,Yen-Hsun Lu,Igor Kunitsyn,Yen-Hsun Lu,4-6; 7-6(4); 6-3,R64,136,6,8,47,86,36,47,19,39,1,5,16,55,86,8,3,62,100,40,62,20,38,5,9,15,60,100
2012-06-11 00:00:00.000,London / Queen's Club Great Britain ATP World Tour 250,GRASS,2,Ryan Sweeting,Dmitry Tursunov,Ryan Sweeting,6-4; 7-6(6),R64,93,7,6,56,90,42,56,17,34,7,7,11,59,90,6,1,40,65,34,40,13,25,0,1,11,47,65
2012-06-11 00:00:00.000,London / Queen's Club Great Britain ATP World Tour 250,GRASS,2,Janko Tipsarevic,N/A Bye,Janko Tipsarevic,,R64,0,0,0,0,0,0,0,0,0,0,0,0,0,0,0,0,0,0,0,0,0,0,0,0,0,0,0
2012-06-11 00:00:00.000,London / Queen's Club Great Britain ATP World Tour 250,GRASS,2,Julien Benneteau,N/A Bye,Julien Benneteau,,R64,0,0,0,0,0,0,0,0,0,0,0,0,0,0,0,0,0,0,0,0,0,0,0,0,0,0,0
2012-06-11 00:00:00.000,London / Queen's Club Great Britain ATP World Tour 250,GRASS,2,Tatsuma Ito,Paolo Lorenzi,Tatsuma Ito,7-6(6); 4-6; 6-2,R64,131,3,2,63,102,42,63,25,39,5,7,15,67,102,9,1,69,106,45,69,20,37,2,5,15,65,106
2012-06-11 00:00:00.000,London / Queen's Club Great Britain ATP World Tour 250,GRASS,2,Sam Querrey,Olivier Rochus,Sam Querrey,6-1; 6-7(4); 6-4,R64,100,24,2,57,86,53,57,13,29,2,2,15,66,86,5,4,52,81,37,52,16,29,2,5,14,53,81
2012-06-11 00:00:00.000,London / Queen's Club Great Britain ATP World Tour 250,GRASS,2,Denis Istomin,Kenny De Schepper,Denis Istomin,6-4; 7-6(4),R64,85,3,0,39,64,32,39,20,25,4,4,11,52,64,8,4,42,65,34,42,14,23,3,4,11,48,65
2012-06-11 00:00:00.000,London / Queen's Club Great Britain ATP World Tour 250,GRASS,2,Go Soeda,Bjorn Phau,Go Soeda,6-2; 6-2,R64,59,1,4,19,38,13,19,13,19,0,2,8,26,38,4,4,34,61,19,34,7,27,7,13,8,26,61
2012-06-11 00:00:00.000,London / Queen's Club Great Britain ATP World Tour 250,GRASS,2,Ivan Dodig,Frank Dancevic,Ivan Dodig,6-1 RET,R64,19,5,0,10,16,10,10,6,6,0,0,4,16,16,0,0,13,22,4,13,5,9,3,5,3,9,22
2012-06-11 00:00:00.000,London / Queen's Club Great Britain ATP World Tour 250,GRASS,2,Jamie Baker,Oliver Golding,Jamie Baker,7-6(1); 6-3,R64,82,6,0,38,60,33,38,10,22,2,3,10,43,60,9,15,55,89,40,55,11,34,6,9,11,51,89
2012-06-11 00:00:00.000,London / Queen's Club Great Britain ATP World Tour 250,GRASS,2,Jo-Wilfried Tsonga,N/A Bye,Jo-Wilfried Tsonga,,R64,0,0,0,0,0,0,0,0,0,0,0,0,0,0,0,0,0,0,0,0,0,0,0,0,0,0,0
2012-06-11 00:00:00.000,London / Queen's Club Great Britain ATP World Tour 250,GRASS,2,Nicolas Mahut,Andy Murray,Nicolas Mahut,6-3; 6-7(4); 7-6(1),R32,156,13,6,79,121,61,79,19,42,5,7,17,80,121,7,1,79,116,56,79,17,37,7,10,16,73,116
2012-06-11 00:00:00.000,London / Queen's Club Great Britain ATP World Tour 250,GRASS,2,Grigor Dimitrov,Gilles Muller,Grigor Dimitrov,7-6(1); 6-4,R32,77,9,0,44,57,40,44,8,13,0,0,11,48,57,10,4,53,68,38,53,6,15,1,2,11,44,68
2012-06-11 00:00:00.000,London / Queen's Club Great Britain ATP World Tour 250,GRASS,2,Kevin Anderson,Sergiy Stakhovsky,Kevin Anderson,7-6(5); 2-6; 3-4 RET,R32,123,12,8,57,92,37,57,23,35,7,11,14,60,92,5,2,65,91,46,65,16,26,3,4,13,62,91
2012-06-11 00:00:00.000,London / Queen's Club Great Britain ATP World Tour 250,GRASS,2,Feliciano Lopez,Steve Darcis,Feliciano Lopez,6-3; 3-6; 7-5,R32,97,15,3,49,79,42,49,17,30,0,2,15,59,79,7,0,54,77,40,54,13,23,2,5,15,53,77
2012-06-11 00:00:00.000,London / Queen's Club Great Britain ATP World Tour 250,GRASS,2,Simone Bolelli,Gilles Simon,Simone Bolelli,4-6; 6-3; 7-6(2),R32,152,2,1,69,98,51,69,15,29,3,5,16,66,98,11,3,56,95,40,56,20,39,4,6,15,60,95
2012-06-11 00:00:00.000,London / Queen's Club Great Britain ATP World Tour 250,GRASS,2,Xavier Malisse,Alex Bogomolov Jr.,Xavier Malisse,6-3; 4-6; 6-0,R32,92,9,0,51,71,36,51,12,20,6,8,12,48,71,2,2,52,74,30,52,11,22,5,11,13,41,74
2012-06-11 00:00:00.000,London / Queen's Club Great Britain ATP World Tour 250,GRASS,2,David Nalbandian,Ruben Bemelmans,David Nalbandian,6-4; 6-2,R32,69,2,4,31,55,23,31,14,24,2,3,9,37,55,5,1,38,51,22,38,5,13,3,7,9,27,51
2012-06-11 00:00:00.000,London / Queen's Club Great Britain ATP World Tour 250,GRASS,2,Edouard Roger-Vasselin,Andy Roddick,Edouard Roger-Vasselin,6-4; 4-6; 7-5,R32,121,13,2,63,98,49,63,20,35,4,5,16,69,98,22,2,65,82,50,65,10,17,3,5,16,60,82
2012-06-11 00:00:00.000,London / Queen's Club Great Britain ATP World Tour 250,GRASS,2,Marin Cilic,Matthew Ebden,Marin Cilic,6-2; 6-1,R32,63,4,0,24,43,20,24,14,19,1,1,8,34,43,1,4,38,56,19,38,6,18,6,10,7,25,56
2012-06-11 00:00:00.000,London / Queen's Club Great Britain ATP World Tour 250,GRASS,2,Lukas Rosol,Marcos Baghdatis,Lukas Rosol,6-3; 4-6; 6-4,R32,121,8,4,61,107,42,61,26,46,7,9,15,68,107,9,6,52,93,35,52,24,41,6,9,14,59,93
2012-06-11 00:00:00.000,London / Queen's Club Great Britain ATP World Tour 250,GRASS,2,Yen-Hsun Lu,Ivo Karlovic,Yen-Hsun Lu,6-7(3); 7-6(6); 7-6(7),R32,171,6,3,80,118,70,80,20,38,5,5,18,90,118,35,4,79,117,70,79,19,38,2,2,18,89,117
2012-06-11 00:00:00.000,London / Queen's Club Great Britain ATP World Tour 250,GRASS,2,Janko Tipsarevic,Ryan Sweeting,Janko Tipsarevic,6-1; 7-6(2),R32,81,8,2,44,66,33,44,16,22,3,3,10,49,66,5,2,43,72,32,43,11,29,3,5,9,43,72
2012-06-11 00:00:00.000,London / Queen's Club Great Britain ATP World Tour 250,GRASS,2,Julien Benneteau,Tatsuma Ito,Julien Benneteau,5-7; 6-4; 7-5,R32,126,6,2,66,92,51,66,13,26,2,4,17,64,92,11,4,66,107,49,66,20,41,5,8,17,69,107
2012-06-11 00:00:00.000,London / Queen's Club Great Britain ATP World Tour 250,GRASS,2,Sam Querrey,Denis Istomin,Sam Querrey,7-6(4); 6-3,R32,77,8,1,38,62,31,38,18,24,0,0,11,49,62,4,1,55,79,39,55,11,24,9,10,10,50,79
2012-06-11 00:00:00.000,London / Queen's Club Great Britain ATP World Tour 250,GRASS,2,Ivan Dodig,Go Soeda,Ivan Dodig,6-3; 7-6(3),R32,95,11,5,35,67,29,35,17,32,2,4,11,46,67,2,1,39,69,28,39,9,30,4,7,10,37,69
2012-06-11 00:00:00.000,London / Queen's Club Great Britain ATP World Tour 250,GRASS,2,Jo-Wilfried Tsonga,Jamie Baker,Jo-Wilfried Tsonga,6-3; 6-2,R32,57,4,0,36,49,28,36,10,13,1,1,9,38,49,1,0,29,45,17,29,9,16,1,4,8,26,45
2012-06-11 00:00:00.000,London / Queen's Club Great Britain ATP World Tour 250,GRASS,2,Grigor Dimitrov,Nicolas Mahut,Grigor Dimitrov,7-6(3); 6-4,R16,96,10,1,43,65,36,43,14,22,2,3,11,50,65,3,0,56,85,33,56,21,29,12,14,11,54,85
2012-06-11 00:00:00.000,London / Queen's Club Great Britain ATP World Tour 250,GRASS,2,Kevin Anderson,Feliciano Lopez,Kevin Anderson,7-6(10); 7-6(7),R16,101,18,1,60,78,47,60,13,18,0,1,12,60,78,11,0,52,80,41,52,19,28,0,1,12,60,80
2012-06-11 00:00:00.000,London / Queen's Club Great Britain ATP World Tour 250,GRASS,2,Xavier Malisse,Simone Bolelli,Xavier Malisse,7-6(5); 6-3,R16,95,12,1,39,64,32,39,16,25,0,1,11,48,64,2,1,48,80,32,48,16,32,7,9,10,48,80
2012-06-11 00:00:00.000,London / Queen's Club Great Britain ATP World Tour 250,GRASS,2,David Nalbandian,Edouard Roger-Vasselin,David Nalbandian,4-6; 7-5; 6-3,R16,135,7,14,65,112,47,65,21,47,6,9,16,68,112,6,5,60,98,44,60,13,38,3,7,15,57,98
2012-06-11 00:00:00.000,London / Queen's Club Great Britain ATP World Tour 250,GRASS,2,Marin Cilic,Lukas Rosol,Marin Cilic,7-6(3); 6-2,R16,77,11,2,37,61,27,37,15,24,0,1,10,42,61,0,1,43,64,26,43,12,21,4,7,10,38,64
2012-06-11 00:00:00.000,London / Queen's Club Great Britain ATP World Tour 250,GRASS,2,Yen-Hsun Lu,Janko Tipsarevic,Yen-Hsun Lu,6-3; 2-6; 7-6(5),R16,124,9,3,62,92,47,62,15,30,3,5,15,62,92,11,3,45,87,38,45,26,42,4,5,14,64,87
2012-06-11 00:00:00.000,London / Queen's Club Great Britain ATP World Tour 250,GRASS,2,Sam Querrey,Julien Benneteau,Sam Querrey,6-3; 3-6; 6-3,R16,105,15,1,58,84,51,58,9,26,6,7,14,60,84,8,3,49,83,36,49,19,34,5,7,13,55,83
2012-06-11 00:00:00.000,London / Queen's Club Great Britain ATP World Tour 250,GRASS,2,Ivan Dodig,Jo-Wilfried Tsonga,Ivan Dodig,7-6(3); 3-6; 7-6(5),R16,143,5,3,76,119,58,76,25,43,6,8,17,83,119,11,1,64,107,50,64,27,43,3,3,16,77,107
2012-06-11 00:00:00.000,London / Queen's Club Great Britain ATP World Tour 250,GRASS,2,Grigor Dimitrov,Kevin Anderson,Grigor Dimitrov,4-6; 6-4; 6-3,Q,123,7,1,72,97,53,72,11,25,1,2,14,64,97,15,4,77,102,54,77,11,25,6,9,15,65,102
2012-06-11 00:00:00.000,London / Queen's Club Great Britain ATP World Tour 250,GRASS,2,David Nalbandian,Xavier Malisse,David Nalbandian,4-6; 7-6(2); 6-4,Q,119,10,2,56,91,51,56,16,35,2,4,16,67,91,18,1,62,99,49,62,16,37,5,7,16,65,99
2012-06-11 00:00:00.000,London / Queen's Club Great Britain ATP World Tour 250,GRASS,2,Marin Cilic,Yen-Hsun Lu,Marin Cilic,6-4; 2-0 RET,Q,40,5,1,21,28,19,21,4,7,0,1,6,23,28,1,2,21,30,11,21,5,9,0,3,6,16,30
2012-06-11 00:00:00.000,London / Queen's Club Great Britain ATP World Tour 250,GRASS,2,Sam Querrey,Ivan Dodig,Sam Querrey,7-5; 3-6; 6-3,Q,92,8,2,58,83,49,58,12,25,3,4,15,61,83,10,1,56,75,42,56,13,19,1,3,15,55,75
2012-06-11 00:00:00.000,London / Queen's Club Great Britain ATP World Tour 250,GRASS,2,David Nalbandian,Grigor Dimitrov,David Nalbandian,6-4; 6-4,S,91,1,0,41,65,24,41,15,24,1,4,10,39,65,6,1,48,71,27,48,10,23,7,12,10,37,71
2012-06-11 00:00:00.000,London / Queen's Club Great Britain ATP World Tour 250,GRASS,2,Marin Cilic,Sam Querrey,Marin Cilic,6-3; 3-6; 6-3,S,116,6,4,63,103,44,63,20,40,10,13,14,64,103,6,2,57,80,34,57,12,23,1,5,13,46,80
2012-06-11 00:00:00.000,London / Queen's Club Great Britain ATP World Tour 250,GRASS,2,Marin Cilic,David Nalbandian,Marin Cilic,6-7(3); 4-3 DEF,F,86,7,2,44,61,30,44,6,17,3,5,9,36,61,1,1,40,58,29,40,9,18,1,4,10,38,58
2012-06-17 00:00:00.000,s-Hertogenbosch The Netherlands ATP World Tour 250,GRASS,2,David Ferrer,Pierre-Ludovic Duclos,David Ferrer,6-4; 6-4,R32,93,4,0,33,51,24,33,15,18,1,2,10,39,51,6,1,46,77,30,46,12,31,6,9,10,42,77
2012-06-17 00:00:00.000,s-Hertogenbosch The Netherlands ATP World Tour 250,GRASS,2,Leonardo Mayer,Mikhail Ledovskikh,Leonardo Mayer,6-4; 6-2,R32,71,5,2,35,54,26,35,11,19,2,3,9,37,54,7,2,34,52,23,34,6,18,0,4,9,29,52
2012-06-17 00:00:00.000,s-Hertogenbosch The Netherlands ATP World Tour 250,GRASS,2,Olivier Rochus,Malek Jaziri,Olivier Rochus,6-3; 4-0 RET,R32,58,3,1,21,34,18,21,8,13,2,3,7,26,34,3,2,26,47,14,26,7,21,3,7,6,21,47
2012-06-17 00:00:00.000,s-Hertogenbosch The Netherlands ATP World Tour 250,GRASS,2,Igor Sijsling,Jarkko Nieminen,Igor Sijsling,6-2; 6-4,R32,55,3,2,29,48,25,29,13,19,1,1,9,38,48,1,3,33,54,21,33,9,21,0,3,9,30,54
2012-06-17 00:00:00.000,s-Hertogenbosch The Netherlands ATP World Tour 250,GRASS,2,Jurgen Melzer,Igor Kunitsyn,Jurgen Melzer,6-1; 6-1,R32,55,2,1,17,34,16,17,12,17,0,0,7,28,34,1,1,32,51,16,32,6,19,4,9,7,22,51
2012-06-17 00:00:00.000,s-Hertogenbosch The Netherlands ATP World Tour 250,GRASS,2,Tatsuma Ito,Marton Fucsovics,Tatsuma Ito,3-6; 6-3; 7-6(2),R32,144,2,4,53,106,38,53,32,53,6,7,15,70,106,9,2,57,109,43,57,29,52,5,6,15,72,109
2012-06-17 00:00:00.000,s-Hertogenbosch The Netherlands ATP World Tour 250,GRASS,2,Benoit Paire,David Goffin,Benoit Paire,6-1; 6-4,R32,61,5,1,34,52,28,34,10,18,0,0,9,38,52,1,4,28,55,18,28,12,27,3,6,8,30,55
2012-06-17 00:00:00.000,s-Hertogenbosch The Netherlands ATP World Tour 250,GRASS,2,Lukasz Kubot,Dudi Sela,Lukasz Kubot,6-1; 6-2,R32,59,2,2,28,45,24,28,9,17,1,1,8,33,45,2,2,23,42,13,23,8,19,2,6,7,21,42
2012-06-17 00:00:00.000,s-Hertogenbosch The Netherlands ATP World Tour 250,GRASS,2,Edouard Roger-Vasselin,Alex Bogomolov Jr.,Edouard Roger-Vasselin,6-4; 6-4,R32,91,2,3,42,66,33,42,11,24,4,5,10,44,66,4,1,51,73,31,51,12,22,4,7,10,43,73
2012-06-17 00:00:00.000,s-Hertogenbosch The Netherlands ATP World Tour 250,GRASS,2,Flavio Cipolla,Potito Starace,Flavio Cipolla,4-2 RET,R32,25,2,0,9,13,8,9,4,4,0,0,3,12,13,0,2,15,22,10,15,3,7,1,2,3,13,22
2012-06-17 00:00:00.000,s-Hertogenbosch The Netherlands ATP World Tour 250,GRASS,2,Philipp Petzschner,Dmitry Tursunov,Philipp Petzschner,6-4; 6-2,R32,67,5,2,27,51,22,27,16,24,1,1,9,38,51,4,2,37,65,26,37,12,28,8,11,9,38,65
2012-06-17 00:00:00.000,s-Hertogenbosch The Netherlands ATP World Tour 250,GRASS,2,Mate Pavic,Robin Haase,Mate Pavic,6-4; 7-6(2),R32,77,6,2,57,74,42,57,10,17,3,3,11,52,74,7,3,35,59,29,35,13,24,0,1,11,42,59
2012-06-17 00:00:00.000,s-Hertogenbosch The Netherlands ATP World Tour 250,GRASS,2,Gilles Muller,Santiago Giraldo,Gilles Muller,7-6(5); 6-7(4); 6-3,R32,131,16,2,62,99,54,62,22,37,0,0,17,76,99,5,2,83,118,61,83,18,35,7,8,16,79,118
2012-06-17 00:00:00.000,s-Hertogenbosch The Netherlands ATP World Tour 250,GRASS,2,Alejandro Falla,Ruben Ramirez Hidalgo,Alejandro Falla,6-4; 6-4,R32,84,4,1,40,62,33,40,9,22,4,5,10,42,62,0,4,35,64,23,35,15,29,4,7,10,38,64
2012-06-17 00:00:00.000,s-Hertogenbosch The Netherlands ATP World Tour 250,GRASS,2,Paolo Lorenzi,Ivan Dodig,Paolo Lorenzi,6-4; 6-4,R32,93,0,0,40,59,26,40,14,19,2,3,10,40,59,6,2,42,67,28,42,10,25,7,10,10,38,67
2012-06-17 00:00:00.000,s-Hertogenbosch The Netherlands ATP World Tour 250,GRASS,2,Xavier Malisse,Viktor Troicki,Xavier Malisse,7-6(4); 6-2,R32,70,6,1,34,53,32,34,12,19,0,0,10,44,53,11,3,31,61,26,31,14,30,2,4,10,40,61
2012-06-17 00:00:00.000,s-Hertogenbosch The Netherlands ATP World Tour 250,GRASS,2,David Ferrer,Leonardo Mayer,David Ferrer,6-3; 6-1,R16,60,2,0,27,38,22,27,10,11,0,0,8,32,38,4,3,27,45,15,27,8,18,0,4,8,23,45
2012-06-17 00:00:00.000,s-Hertogenbosch The Netherlands ATP World Tour 250,GRASS,2,Igor Sijsling,Olivier Rochus,Igor Sijsling,7-5; 7-6(4),R16,86,21,2,46,71,37,46,16,25,2,3,12,53,71,3,0,49,70,36,49,12,21,1,3,12,48,70
2012-06-17 00:00:00.000,s-Hertogenbosch The Netherlands ATP World Tour 250,GRASS,2,Tatsuma Ito,Jurgen Melzer,Tatsuma Ito,6-2; 6-2,R16,57,2,0,23,46,19,23,16,23,0,0,8,35,46,7,3,34,48,21,34,4,14,2,6,8,25,48
2012-06-17 00:00:00.000,s-Hertogenbosch The Netherlands ATP World Tour 250,GRASS,2,Benoit Paire,Lukasz Kubot,Benoit Paire,6-3; 0-6; 6-4,R16,97,6,8,47,84,34,47,15,37,5,9,13,49,84,3,3,45,74,29,45,16,29,2,5,12,45,74
2012-06-17 00:00:00.000,s-Hertogenbosch The Netherlands ATP World Tour 250,GRASS,2,Edouard Roger-Vasselin,Flavio Cipolla,Edouard Roger-Vasselin,6-2; 3-6; 6-1,R16,102,5,0,57,76,34,57,11,19,6,10,12,45,76,3,1,47,74,26,47,8,27,4,11,12,34,74
2012-06-17 00:00:00.000,s-Hertogenbosch The Netherlands ATP World Tour 250,GRASS,2,Philipp Petzschner,Mate Pavic,Philipp Petzschner,W/O,R16,0,0,0,0,0,0,0,0,0,0,0,0,0,0,0,0,0,0,0,0,0,0,0,0,0,0,0
2012-06-17 00:00:00.000,s-Hertogenbosch The Netherlands ATP World Tour 250,GRASS,2,Gilles Muller,Alejandro Falla,Gilles Muller,6-3; 6-0,R16,55,2,0,34,46,28,34,6,12,3,3,8,34,46,3,4,25,42,14,25,6,17,1,5,7,20,42
2012-06-17 00:00:00.000,s-Hertogenbosch The Netherlands ATP World Tour 250,GRASS,2,Xavier Malisse,Paolo Lorenzi,Xavier Malisse,7-6(3); 6-2,R16,83,10,1,50,66,39,50,10,16,1,1,10,49,66,2,0,41,61,28,41,11,20,2,4,10,39,61
2012-06-17 00:00:00.000,s-Hertogenbosch The Netherlands ATP World Tour 250,GRASS,2,David Ferrer,Igor Sijsling,David Ferrer,6-0; 6-1,Q,43,3,0,22,31,20,22,8,9,0,0,7,28,31,4,1,26,42,12,26,4,16,2,7,6,16,42
2012-06-17 00:00:00.000,s-Hertogenbosch The Netherlands ATP World Tour 250,GRASS,2,Benoit Paire,Tatsuma Ito,Benoit Paire,6-3; 7-5,Q,72,15,3,37,60,32,37,11,23,2,3,11,43,60,3,4,36,69,25,36,15,33,5,8,10,40,69
2012-06-17 00:00:00.000,s-Hertogenbosch The Netherlands ATP World Tour 250,GRASS,2,Philipp Petzschner,Edouard Roger-Vasselin,Philipp Petzschner,6-4; 7-6(6),Q,96,14,0,55,80,41,55,13,25,4,5,11,54,80,2,3,50,77,33,50,17,27,3,5,11,50,77
2012-06-17 00:00:00.000,s-Hertogenbosch The Netherlands ATP World Tour 250,GRASS,2,Xavier Malisse,Gilles Muller,Xavier Malisse,6-3; 4-6; 6-1,Q,87,5,2,46,73,37,46,17,27,3,4,13,54,73,14,1,41,65,34,41,10,24,1,5,13,44,65
2012-06-17 00:00:00.000,s-Hertogenbosch The Netherlands ATP World Tour 250,GRASS,2,David Ferrer,Benoit Paire,David Ferrer,7-6(5); 3-6; 6-1,S,104,2,2,71,90,53,71,10,19,5,6,14,63,90,6,3,48,82,39,48,18,34,0,2,14,57,82
2012-06-17 00:00:00.000,s-Hertogenbosch The Netherlands ATP World Tour 250,GRASS,2,Philipp Petzschner,Xavier Malisse,Philipp Petzschner,7-5; 7-5,S,89,4,0,44,70,30,44,13,26,0,3,12,43,70,3,4,42,71,27,42,10,29,2,7,12,37,71
2012-06-17 00:00:00.000,s-Hertogenbosch The Netherlands ATP World Tour 250,GRASS,2,David Ferrer,Philipp Petzschner,David Ferrer,6-3; 6-4,F,69,2,0,36,49,28,36,9,13,0,1,10,37,49,2,1,49,63,32,49,4,14,9,12,9,36,63
2012-06-18 00:00:00.000,Eastbourne Great Britain ATP World Tour 250,GRASS,2,Richard Gasquet,N/A Bye,Richard Gasquet,,R32,0,0,0,0,0,0,0,0,0,0,0,0,0,0,0,0,0,0,0,0,0,0,0,0,0,0,0
2012-06-18 00:00:00.000,Eastbourne Great Britain ATP World Tour 250,GRASS,2,Marinko Matosevic,James Ward,Marinko Matosevic,4-6; 6-1; 6-4,R32,118,8,1,54,90,37,54,25,36,3,4,14,62,90,6,0,43,78,27,43,21,35,1,4,13,48,78
2012-06-18 00:00:00.000,Eastbourne Great Britain ATP World Tour 250,GRASS,2,Steve Darcis,Matthew Ebden,Steve Darcis,6-2; 6-4,R32,67,1,0,42,53,32,42,6,11,6,6,9,38,53,4,4,32,56,22,32,8,24,6,9,9,30,56
2012-06-18 00:00:00.000,Eastbourne Great Britain ATP World Tour 250,GRASS,2,Marcos Baghdatis,Pablo Andujar,Marcos Baghdatis,6-1; 6-1,R32,49,1,3,23,42,18,23,12,19,0,0,7,30,42,1,3,19,40,9,19,7,21,3,8,7,16,40
2012-06-18 00:00:00.000,Eastbourne Great Britain ATP World Tour 250,GRASS,2,Bernard Tomic,N/A Bye,Bernard Tomic,,R32,0,0,0,0,0,0,0,0,0,0,0,0,0,0,0,0,0,0,0,0,0,0,0,0,0,0,0
2012-06-18 00:00:00.000,Eastbourne Great Britain ATP World Tour 250,GRASS,2,Fabio Fognini,Albert Ramos-Vinolas,Fabio Fognini,7-6(2); 6-7(3); 6-2,R32,129,2,4,67,104,46,67,19,37,3,7,16,65,104,4,4,56,104,36,56,22,48,6,12,16,58,104
2012-06-18 00:00:00.000,Eastbourne Great Britain ATP World Tour 250,GRASS,2,Jeremy Chardy,Paul-Henri Mathieu,Jeremy Chardy,7-5; 6-7(5); 7-6(4),R32,179,20,4,65,132,50,65,34,67,10,12,18,84,132,11,7,63,122,51,63,29,59,3,6,18,80,122
2012-06-18 00:00:00.000,Eastbourne Great Britain ATP World Tour 250,GRASS,2,Andy Roddick,Sam Querrey,Andy Roddick,5-2 RET,R32,25,5,1,11,15,9,11,3,4,0,0,3,12,15,2,1,21,30,13,21,2,9,3,5,4,15,30
2012-06-18 00:00:00.000,Eastbourne Great Britain ATP World Tour 250,GRASS,2,Philipp Kohlschreiber,Go Soeda,Philipp Kohlschreiber,6-4; 7-5,R32,87,8,2,28,66,24,28,21,38,5,6,11,45,66,4,3,41,71,27,41,15,30,2,5,11,42,71
2012-06-18 00:00:00.000,Eastbourne Great Britain ATP World Tour 250,GRASS,2,Jamie Baker,Donald Young,Jamie Baker,6-1; 6-4,R32,59,0,1,28,47,20,28,10,19,2,4,9,30,47,1,6,28,49,18,28,4,21,6,11,8,22,49
2012-06-18 00:00:00.000,Eastbourne Great Britain ATP World Tour 250,GRASS,2,Carlos Berlocq,Mikhail Kukushkin,Carlos Berlocq,3-6; 6-4; 6-2,R32,100,4,3,49,72,41,49,11,23,2,3,13,52,72,5,1,43,76,31,43,19,33,3,6,14,50,76
2012-06-18 00:00:00.000,Eastbourne Great Britain ATP World Tour 250,GRASS,2,Andreas Seppi,N/A Bye,Andreas Seppi,,R32,0,0,0,0,0,0,0,0,0,0,0,0,0,0,0,0,0,0,0,0,0,0,0,0,0,0,0
2012-06-18 00:00:00.000,Eastbourne Great Britain ATP World Tour 250,GRASS,2,Yen-Hsun Lu,Julien Benneteau,Yen-Hsun Lu,6-3; 2-6; 7-6(4),R32,150,3,9,79,119,51,79,15,40,11,16,15,66,119,7,3,60,93,40,60,15,33,1,5,14,55,93
2012-06-18 00:00:00.000,Eastbourne Great Britain ATP World Tour 250,GRASS,2,Ryan Harrison,Vasek Pospisil,Ryan Harrison,3-6; 7-6(2); 7-6(6),R32,150,3,2,61,97,46,61,27,36,2,3,16,73,97,11,8,76,127,57,76,28,51,9,9,17,85,127
2012-06-18 00:00:00.000,Eastbourne Great Britain ATP World Tour 250,GRASS,2,Denis Istomin,Michael Llodra,Denis Istomin,6-4; 6-3,R32,66,9,2,38,54,32,38,8,16,4,4,9,40,54,5,1,56,69,35,56,6,13,7,10,10,41,69
2012-06-18 00:00:00.000,Eastbourne Great Britain ATP World Tour 250,GRASS,2,Marcel Granollers,N/A Bye,Marcel Granollers,,R32,0,0,0,0,0,0,0,0,0,0,0,0,0,0,0,0,0,0,0,0,0,0,0,0,0,0,0
2012-06-18 00:00:00.000,Eastbourne Great Britain ATP World Tour 250,GRASS,2,Marinko Matosevic,Richard Gasquet,Marinko Matosevic,1-6; 7-6(5); 7-6(3),R16,147,10,2,77,117,50,77,23,40,5,8,15,73,117,13,0,81,102,62,81,12,21,6,7,16,74,102
2012-06-18 00:00:00.000,Eastbourne Great Britain ATP World Tour 250,GRASS,2,Steve Darcis,Marcos Baghdatis,Steve Darcis,6-4; 4-6; 6-4,R16,121,2,0,62,88,43,62,16,26,1,3,15,59,88,6,11,49,99,38,49,24,50,2,5,15,62,99
2012-06-18 00:00:00.000,Eastbourne Great Britain ATP World Tour 250,GRASS,2,Fabio Fognini,Bernard Tomic,Fabio Fognini,4-6; 6-3; 7-5,R16,114,4,4,61,98,49,61,15,37,10,13,16,64,98,4,1,55,83,34,55,19,28,5,9,15,53,83
2012-06-18 00:00:00.000,Eastbourne Great Britain ATP World Tour 250,GRASS,2,Andy Roddick,Jeremy Chardy,Andy Roddick,6-2; 7-6(6),R16,84,7,0,32,52,26,32,18,20,0,0,10,44,52,2,2,52,79,38,52,8,27,5,7,10,46,79
2012-06-18 00:00:00.000,Eastbourne Great Britain ATP World Tour 250,GRASS,2,Philipp Kohlschreiber,Jamie Baker,Philipp Kohlschreiber,6-2; 3-6; 6-3,R16,110,10,4,46,77,33,46,16,31,2,4,13,49,77,8,1,70,94,45,70,8,24,4,8,13,53,94
2012-06-18 00:00:00.000,Eastbourne Great Britain ATP World Tour 250,GRASS,2,Andreas Seppi,Carlos Berlocq,Andreas Seppi,7-6(2); 6-3,R16,87,4,3,33,61,26,33,16,28,1,2,10,42,61,6,4,42,77,27,42,17,35,3,6,11,44,77
2012-06-18 00:00:00.000,Eastbourne Great Britain ATP World Tour 250,GRASS,2,Ryan Harrison,Yen-Hsun Lu,Ryan Harrison,6-1; 7-6(2),R16,88,6,2,49,82,39,49,15,33,5,5,10,54,82,2,3,38,56,25,38,11,18,2,4,9,36,56
2012-06-18 00:00:00.000,Eastbourne Great Britain ATP World Tour 250,GRASS,2,Denis Istomin,Marcel Granollers,Denis Istomin,6-1; 4-6; 7-6(2),R16,137,7,2,69,105,53,69,18,36,6,8,15,71,105,9,1,63,97,46,63,14,34,4,7,14,60,97
2012-06-18 00:00:00.000,Eastbourne Great Britain ATP World Tour 250,GRASS,2,Steve Darcis,Marinko Matosevic,Steve Darcis,6-2; 7-6(4),Q,93,2,0,59,75,36,59,9,16,4,6,10,45,75,1,2,43,61,25,43,6,18,1,5,10,31,61
2012-06-18 00:00:00.000,Eastbourne Great Britain ATP World Tour 250,GRASS,2,Andy Roddick,Fabio Fognini,Andy Roddick,6-3; 3-6; 7-5,Q,131,4,1,61,93,40,61,18,32,6,9,15,58,93,3,3,71,105,45,71,15,34,8,12,15,60,105
2012-06-18 00:00:00.000,Eastbourne Great Britain ATP World Tour 250,GRASS,2,Andreas Seppi,Philipp Kohlschreiber,Andreas Seppi,7-5; 2-1 RET,Q,62,1,3,38,51,29,38,5,13,5,6,7,34,51,4,2,36,55,21,36,9,19,4,7,8,30,55
2012-06-18 00:00:00.000,Eastbourne Great Britain ATP World Tour 250,GRASS,2,Ryan Harrison,Denis Istomin,Ryan Harrison,7-6(5); 6-4,Q,100,0,3,51,78,30,51,16,27,5,8,11,46,78,0,2,54,76,37,54,8,22,4,8,11,45,76
2012-06-18 00:00:00.000,Eastbourne Great Britain ATP World Tour 250,GRASS,2,Andy Roddick,Steve Darcis,Andy Roddick,6-3; 3-1 RET,S,61,6,0,19,35,16,19,10,16,1,2,7,26,35,1,2,28,43,16,28,7,15,2,5,6,23,43
2012-06-18 00:00:00.000,Eastbourne Great Britain ATP World Tour 250,GRASS,2,Andreas Seppi,Ryan Harrison,Andreas Seppi,7-5; 6-1,S,75,2,1,39,59,26,39,12,20,0,2,10,38,59,2,4,33,55,17,33,10,22,4,9,9,27,55
2012-06-18 00:00:00.000,Eastbourne Great Britain ATP World Tour 250,GRASS,2,Andy Roddick,Andreas Seppi,Andy Roddick,6-3; 6-2,F,72,5,2,38,51,26,38,6,13,1,3,9,32,51,1,1,47,58,22,47,4,11,6,11,8,26,58
2012-06-25 00:00:00.000,Wimbledon Great Britain Grand Slams,GRASS,3,Novak Djokovic,Juan Carlos Ferrero,Novak Djokovic,6-3; 6-3; 6-1,R128,98,13,3,56,85,47,56,12,29,7,8,13,59,85,2,2,48,72,27,48,10,24,5,11,12,37,72
2012-06-25 00:00:00.000,Wimbledon Great Britain Grand Slams,GRASS,3,Ryan Harrison,Yen-Hsun Lu,Ryan Harrison,4-6; 6-3; 6-4; 6-2,R128,160,11,1,80,114,62,80,18,34,5,6,19,80,114,5,3,80,121,56,80,21,41,7,11,18,77,121
2012-06-25 00:00:00.000,Wimbledon Great Britain Grand Slams,GRASS,3,Benjamin Becker,James Blake,Benjamin Becker,6-7(4); 7-5; 6-0; 6-4,R128,151,27,3,87,125,65,87,21,38,6,9,20,86,125,5,5,88,141,60,88,22,53,9,17,20,82,141
2012-06-25 00:00:00.000,Wimbledon Great Britain Grand Slams,GRASS,3,Radek Stepanek,Sergiy Stakhovsky,Radek Stepanek,6-1; 1-0 RET,R128,37,1,0,12,20,10,12,6,8,0,0,4,16,20,0,0,18,28,5,18,5,10,0,3,4,10,28
2012-06-25 00:00:00.000,Wimbledon Great Britain Grand Slams,GRASS,3,Viktor Troicki,Marcel Granollers,Viktor Troicki,7-5; 7-6(5); 3-6; 2-6; 8-6,R128,220,15,2,100,151,69,100,31,51,3,9,27,100,151,7,9,123,194,94,123,28,71,10,15,28,122,194
2012-06-25 00:00:00.000,Wimbledon Great Britain Grand Slams,GRASS,3,Martin Klizan,Juan Ignacio Chela,Martin Klizan,7-5; 3-6; 7-6(6); 1-6; 11-9,R128,293,13,7,98,190,73,98,47,92,12,18,29,120,190,9,2,138,210,95,138,40,72,13,18,31,135,210
2012-06-25 00:00:00.000,Wimbledon Great Britain Grand Slams,GRASS,3,Jeremy Chardy,Filippo Volandri,Jeremy Chardy,6-0; 6-1; 1-0 RET,R128,55,5,0,26,40,20,26,10,14,1,1,7,30,40,2,0,45,57,22,45,1,12,5,11,7,23,57
2012-06-25 00:00:00.000,Wimbledon Great Britain Grand Slams,GRASS,3,Juan Monaco,Leonardo Mayer,Juan Monaco,6-4; 7-6(5); 7-6(5),R128,154,3,7,73,101,65,73,14,28,1,1,17,79,101,6,4,73,112,57,73,21,39,1,2,17,78,112
2012-06-25 00:00:00.000,Wimbledon Great Britain Grand Slams,GRASS,3,Nicolas Almagro,Olivier Rochus,Nicolas Almagro,6-7(4); 3-6; 7-6(4); 6-2; 6-4,R128,204,48,3,81,135,66,81,29,54,2,6,25,95,135,4,4,114,175,84,114,25,61,9,15,26,109,175
2012-06-25 00:00:00.000,Wimbledon Great Britain Grand Slams,GRASS,3,Guillaume Rufin,Steve Darcis,Guillaume Rufin,6-4; 3-6; 5-7; 6-4; 6-4,R128,221,15,8,111,179,79,111,26,68,7,14,26,105,179,7,0,103,145,67,103,24,42,6,13,25,91,145
2012-06-25 00:00:00.000,Wimbledon Great Britain Grand Slams,GRASS,3,Ruben Bemelmans,Carlos Berlocq,Ruben Bemelmans,7-5; 6-7(4); 6-3; 7-6(2),R128,211,13,7,92,152,70,92,32,60,8,10,23,102,152,26,4,94,149,71,94,23,55,2,6,22,94,149
2012-06-25 00:00:00.000,Wimbledon Great Britain Grand Slams,GRASS,3,Richard Gasquet,Tobias Kamke,Richard Gasquet,6-2; 6-2; 6-2,R128,108,5,4,33,72,27,33,26,39,3,3,12,53,72,2,6,64,90,38,64,9,26,5,11,12,47,90
2012-06-25 00:00:00.000,Wimbledon Great Britain Grand Slams,GRASS,3,Florian Mayer,Dmitry Tursunov,Florian Mayer,7-6(3); 6-2; 6-3,R128,113,13,2,57,90,50,57,20,33,4,4,15,70,90,10,2,59,95,39,59,21,36,6,9,14,60,95
2012-06-25 00:00:00.000,Wimbledon Great Britain Grand Slams,GRASS,3,Philipp Petzschner,Blaz Kavcic,Philipp Petzschner,6-4; 6-4; 6-2,R128,103,14,0,59,76,49,59,11,17,3,3,14,60,76,8,1,61,90,40,61,14,29,4,8,14,54,90
2012-06-25 00:00:00.000,Wimbledon Great Britain Grand Slams,GRASS,3,Jerzy Janowicz,Simone Bolelli,Jerzy Janowicz,3-6; 6-3; 6-3; 6-3,R128,132,19,1,68,89,57,68,11,21,0,1,18,68,89,7,5,75,109,55,75,14,34,5,9,18,69,109
2012-06-25 00:00:00.000,Wimbledon Great Britain Grand Slams,GRASS,3,Ernests Gulbis,Tomas Berdych,Ernests Gulbis,7-6(5); 7-6(4); 7-6(4),R128,154,30,2,79,110,66,79,19,31,0,1,18,85,110,13,4,72,122,61,72,24,50,6,7,18,85,122
2012-06-25 00:00:00.000,Wimbledon Great Britain Grand Slams,GRASS,3,Roger Federer,Albert Ramos-Vinolas,Roger Federer,6-1; 6-1; 6-1,R128,79,9,1,40,58,29,40,13,18,1,2,11,42,58,0,5,46,80,21,46,10,34,10,18,10,31,80
2012-06-25 00:00:00.000,Wimbledon Great Britain Grand Slams,GRASS,3,Fabio Fognini,Michael Llodra,Fabio Fognini,3-6; 6-3; 6-4; 7-5,R128,142,7,1,92,139,60,92,29,47,7,10,20,89,139,16,3,84,117,59,84,18,33,5,10,20,77,117
2012-06-25 00:00:00.000,Wimbledon Great Britain Grand Slams,GRASS,3,Michael Russell,Adrian Menendez-Maceiras,Michael Russell,6-3; 6-1; 7-6(7),R128,126,7,2,66,88,50,66,14,22,4,5,14,64,88,2,5,57,99,35,57,19,42,5,10,14,54,99
2012-06-25 00:00:00.000,Wimbledon Great Britain Grand Slams,GRASS,3,Julien Benneteau,Gilles Muller,Julien Benneteau,6-2; 7-5; 7-6(4),R128,124,15,3,76,102,62,76,13,26,6,7,16,75,102,16,1,72,92,53,72,8,20,5,9,16,61,92
2012-06-25 00:00:00.000,Wimbledon Great Britain Grand Slams,GRASS,3,Fernando Verdasco,Jimmy Wang,Fernando Verdasco,7-6(3); 6-4; 7-5,R128,141,12,6,70,111,53,70,23,41,6,9,17,76,111,0,4,63,101,45,63,16,38,6,11,17,61,101
2012-06-25 00:00:00.000,Wimbledon Great Britain Grand Slams,GRASS,3,Grega Zemlja,Josh Goodall,Grega Zemlja,6-4; 3-6; 7-6(3); 6-4,R128,142,19,4,72,107,56,72,24,35,2,4,20,80,107,21,6,74,134,55,74,33,60,8,11,21,88,134
2012-06-25 00:00:00.000,Wimbledon Great Britain Grand Slams,GRASS,3,Xavier Malisse,Marinko Matosevic,Xavier Malisse,6-2; 6-2; 7-5,R128,93,14,2,59,87,49,59,10,28,3,4,14,59,87,1,3,44,77,28,44,14,33,5,11,14,42,77
2012-06-25 00:00:00.000,Wimbledon Great Britain Grand Slams,GRASS,3,Gilles Simon,Paul-Henri Mathieu,Gilles Simon,6-3; 5-4 RET,R128,84,7,4,39,63,31,39,10,24,5,6,9,41,63,3,2,28,59,23,28,12,31,6,9,9,35,59
2012-06-25 00:00:00.000,Wimbledon Great Britain Grand Slams,GRASS,3,Alejandro Falla,John Isner,Alejandro Falla,6-4; 6-7(7); 3-6; 7-6(7); 7-5,R128,192,4,4,112,169,89,112,38,57,7,9,28,127,169,31,4,121,158,99,121,23,37,3,5,27,122,158
2012-06-25 00:00:00.000,Wimbledon Great Britain Grand Slams,GRASS,3,Nicolas Mahut,Paolo Lorenzi,Nicolas Mahut,6-3; 5-7; 6-7(3); 7-5; 6-2,R128,231,20,2,118,173,94,118,24,55,9,11,27,118,173,8,3,103,161,76,103,29,58,4,9,26,105,161
2012-06-25 00:00:00.000,Wimbledon Great Britain Grand Slams,GRASS,3,Igor Andreev,Oliver Golding,Igor Andreev,1-6; 7-6(4); 7-6(7); 7-5,R128,184,10,3,85,129,63,85,26,44,1,4,21,89,129,17,10,109,154,83,109,19,45,5,7,22,102,154
2012-06-25 00:00:00.000,Wimbledon Great Britain Grand Slams,GRASS,3,Denis Istomin,Andreas Seppi,Denis Istomin,6-7(2); 6-4; 3-6; 6-3; 8-6,R128,206,13,3,125,191,93,125,32,66,14,18,27,125,191,8,6,87,146,61,87,38,59,0,6,27,99,146
2012-06-25 00:00:00.000,Wimbledon Great Britain Grand Slams,GRASS,3,Mikhail Youzhny,Donald Young,Mikhail Youzhny,4-6; 6-3; 6-2; 6-3,R128,142,4,4,63,92,45,63,12,29,3,9,18,57,92,2,3,77,127,40,77,20,50,9,19,18,60,127
2012-06-25 00:00:00.000,Wimbledon Great Britain Grand Slams,GRASS,3,Inigo Cervantes,Flavio Cipolla,Inigo Cervantes,2-6; 6-7(4); 6-3; 6-2; 6-1,R128,212,7,2,73,133,52,73,32,60,2,6,22,84,133,1,4,93,143,58,93,22,50,3,11,22,80,143
2012-06-25 00:00:00.000,Wimbledon Great Britain Grand Slams,GRASS,3,Ryan Sweeting,Potito Starace,Ryan Sweeting,6-2; 2-0 RET,R128,49,5,2,23,34,19,23,6,11,3,3,5,25,34,1,1,22,41,15,22,5,19,2,5,5,20,41
2012-06-25 00:00:00.000,Wimbledon Great Britain Grand Slams,GRASS,3,Janko Tipsarevic,David Nalbandian,Janko Tipsarevic,6-4; 7-6(4); 6-2,R128,148,18,3,65,112,50,65,24,47,8,9,15,74,112,10,3,53,95,38,53,20,42,5,9,15,58,95
2012-06-25 00:00:00.000,Wimbledon Great Britain Grand Slams,GRASS,3,David Ferrer,Dustin Brown,David Ferrer,7-6(5); 6-4; 6-4,R128,116,4,1,69,100,53,69,21,31,3,3,16,74,100,9,7,73,113,57,73,16,40,3,5,16,73,113
2012-06-25 00:00:00.000,Wimbledon Great Britain Grand Slams,GRASS,3,Kenny De Schepper,Matthias Bachinger,Kenny De Schepper,6-4; 6-2; 6-2,R128,88,15,1,52,76,43,52,14,24,1,1,13,57,76,7,3,47,75,32,47,11,28,5,10,13,43,75
2012-06-25 00:00:00.000,Wimbledon Great Britain Grand Slams,GRASS,3,Bjorn Phau,Wayne Odesnik,Bjorn Phau,6-3; 3-6; 6-7(3); 6-3; 6-4,R128,205,15,11,102,166,78,102,31,64,10,14,25,109,166,6,5,97,153,66,97,29,56,6,12,24,95,153
2012-06-25 00:00:00.000,Wimbledon Great Britain Grand Slams,GRASS,3,Andy Roddick,Jamie Baker,Andy Roddick,7-6(1); 6-4; 7-5,R128,181,14,1,97,130,70,97,17,33,5,5,17,87,130,6,2,67,107,49,67,20,40,7,9,17,69,107
2012-06-25 00:00:00.000,Wimbledon Great Britain Grand Slams,GRASS,3,Kei Nishikori,Mikhail Kukushkin,Kei Nishikori,7-5; 6-3; 6-4,R128,140,1,3,61,95,44,61,18,34,6,9,16,62,95,4,6,56,99,40,56,17,43,6,12,15,57,99
2012-06-25 00:00:00.000,Wimbledon Great Britain Grand Slams,GRASS,3,Florent Serra,Andrey Kuznetsov,Florent Serra,3-6; 7-6(3); 6-4; 4-6; 6-4,R128,184,7,6,108,171,74,108,32,63,11,17,26,106,171,19,7,94,156,72,94,30,62,7,12,25,102,156
2012-06-25 00:00:00.000,Wimbledon Great Britain Grand Slams,GRASS,3,Go Soeda,Igor Kunitsyn,Go Soeda,6-3; 6-2; 6-1,R128,103,9,6,33,75,23,33,28,42,2,3,12,51,75,3,0,53,72,27,53,6,19,6,13,12,33,72
2012-06-25 00:00:00.000,Wimbledon Great Britain Grand Slams,GRASS,3,Juan Martin Del Potro,Robin Haase,Juan Martin Del Potro,6-4; 3-6; 7-6(3); 7-5,R128,170,16,2,79,121,63,79,22,42,2,5,21,85,121,18,1,82,131,65,82,22,49,3,7,22,87,131
2012-06-25 00:00:00.000,Wimbledon Great Britain Grand Slams,GRASS,3,Marin Cilic,Cedrik-Marcel Stebe,Marin Cilic,6-4; 3-6; 6-3; 6-2,R128,183,7,3,88,138,59,88,21,50,12,16,18,80,138,4,4,67,115,42,67,21,48,6,13,18,63,115
2012-06-25 00:00:00.000,Wimbledon Great Britain Grand Slams,GRASS,3,Lukasz Kubot,Tatsuma Ito,Lukasz Kubot,7-6(6); 6-3; 6-3,R128,128,9,3,65,92,46,65,15,27,2,5,15,61,92,3,2,73,108,40,73,20,35,4,10,15,60,108
2012-06-25 00:00:00.000,Wimbledon Great Britain Grand Slams,GRASS,3,Sam Querrey,Vasek Pospisil,Sam Querrey,7-5; 6-7(5); 6-3; 6-4,R128,161,19,4,78,132,69,78,28,54,5,6,22,97,132,17,5,77,137,52,77,37,60,6,10,21,89,137
2012-06-25 00:00:00.000,Wimbledon Great Britain Grand Slams,GRASS,3,Milos Raonic,Santiago Giraldo,Milos Raonic,6-4; 6-4; 6-4,R128,91,20,3,53,81,50,53,16,28,2,2,15,66,81,5,1,57,84,38,57,17,27,1,4,15,55,84
2012-06-25 00:00:00.000,Wimbledon Great Britain Grand Slams,GRASS,3,Grigor Dimitrov,Kevin Anderson,Grigor Dimitrov,7-5; 7-6(3); 6-7(4); 6-3,R128,209,24,0,105,167,84,105,32,62,11,11,23,116,167,20,4,117,157,84,117,21,40,5,7,22,105,157
2012-06-25 00:00:00.000,Wimbledon Great Britain Grand Slams,GRASS,3,Marcos Baghdatis,Albert Montanes,Marcos Baghdatis,6-2; 6-4; 6-4,R128,83,12,3,45,74,34,45,14,29,1,4,14,48,74,1,2,66,82,33,66,7,16,6,13,14,40,82
2012-06-25 00:00:00.000,Wimbledon Great Britain Grand Slams,GRASS,3,Ivo Karlovic,Dudi Sela,Ivo Karlovic,6-4; 6-4; 7-6(5),R128,116,26,3,62,89,56,62,14,27,4,5,16,70,89,2,4,57,106,41,57,27,49,6,9,16,68,106
2012-06-25 00:00:00.000,Wimbledon Great Britain Grand Slams,GRASS,3,Andy Murray,Nikolay Davydenko,Andy Murray,6-1; 6-1; 6-4,R128,95,10,1,40,60,33,40,15,20,0,0,12,48,60,4,3,42,79,25,42,14,37,7,13,12,39,79
2012-06-25 00:00:00.000,Wimbledon Great Britain Grand Slams,GRASS,3,Jo-Wilfried Tsonga,Lleyton Hewitt,Jo-Wilfried Tsonga,6-3; 6-4; 6-4,R128,118,21,3,61,88,50,61,16,27,8,8,15,66,88,1,3,51,86,33,51,18,35,4,7,14,51,86
2012-06-25 00:00:00.000,Wimbledon Great Britain Grand Slams,GRASS,3,Guillermo Garcia-Lopez,Edouard Roger-Vasselin,Guillermo Garcia-Lopez,6-7(2); 6-3; 7-6(4); 5-7; 10-8,R128,288,18,6,112,196,90,112,43,84,10,15,32,133,196,6,4,140,211,98,140,39,71,6,12,31,137,211
2012-06-25 00:00:00.000,Wimbledon Great Britain Grand Slams,GRASS,3,Lukas Lacko,Adrian Ungur,Lukas Lacko,7-6(4); 6-1; 6-3,R128,100,9,1,60,92,50,60,17,32,1,2,14,67,92,3,6,62,96,37,62,18,34,4,9,14,55,96
2012-06-25 00:00:00.000,Wimbledon Great Britain Grand Slams,GRASS,3,Jurgen Melzer,Stan Wawrinka,Jurgen Melzer,3-6; 7-6(2); 2-6; 6-4; 8-6,R128,209,1,10,96,165,68,96,37,69,6,12,26,105,165,20,14,84,165,62,84,44,81,4,9,27,106,165
2012-06-25 00:00:00.000,Wimbledon Great Britain Grand Slams,GRASS,3,David Goffin,Bernard Tomic,David Goffin,3-6; 6-3; 6-4; 6-4,R128,153,11,3,72,117,52,72,26,45,6,9,19,78,117,5,1,83,120,57,83,20,37,9,14,19,77,120
2012-06-25 00:00:00.000,Wimbledon Great Britain Grand Slams,GRASS,3,Jesse Levine,Karol Beck,Jesse Levine,6-4; 6-7(6); 6-3; 6-2,R128,155,9,1,76,118,57,76,30,42,1,2,20,87,118,16,5,68,120,49,68,26,52,3,8,19,75,120
2012-06-25 00:00:00.000,Wimbledon Great Britain Grand Slams,GRASS,3,James Ward,Pablo Andujar,James Ward,4-6; 6-0; 3-6; 6-3; 6-3,R128,206,10,2,89,135,65,89,23,46,5,8,21,88,135,5,10,97,151,66,97,20,54,8,15,22,86,151
2012-06-25 00:00:00.000,Wimbledon Great Britain Grand Slams,GRASS,3,Mardy Fish,Ruben Ramirez Hidalgo,Mardy Fish,7-6(3); 7-5; 7-6(1),R128,157,24,6,56,103,52,56,29,47,4,5,18,81,103,4,5,75,128,48,75,31,53,8,10,18,79,128
2012-06-25 00:00:00.000,Wimbledon Great Britain Grand Slams,GRASS,3,Jarkko Nieminen,Feliciano Lopez,Jarkko Nieminen,7-6(4); 3-6; 7-6(5); 6-4,R128,179,9,0,97,144,72,97,27,47,2,3,21,99,144,28,6,88,154,73,88,32,66,8,9,22,105,154
2012-06-25 00:00:00.000,Wimbledon Great Britain Grand Slams,GRASS,3,Brian Baker,Rui Machado,Brian Baker,7-6(2); 6-4; 6-0,R128,114,6,6,43,83,37,43,25,40,1,2,14,62,83,6,11,55,104,38,55,19,49,4,9,14,57,104
2012-06-25 00:00:00.000,Wimbledon Great Britain Grand Slams,GRASS,3,Benoit Paire,Matthew Ebden,Benoit Paire,6-1; 6-3; 6-7(1); 6-3,R128,145,8,8,81,140,57,81,36,59,11,11,19,93,140,3,9,84,131,51,84,25,47,15,20,18,76,131
2012-06-25 00:00:00.000,Wimbledon Great Britain Grand Slams,GRASS,3,Alexandr Dolgopolov,Alex Bogomolov Jr.,Alexandr Dolgopolov,6-3; 6-4; 7-5,R128,110,23,4,67,106,54,67,19,39,10,10,16,73,106,5,5,67,99,45,67,15,32,8,11,15,60,99
2012-06-25 00:00:00.000,Wimbledon Great Britain Grand Slams,GRASS,3,Philipp Kohlschreiber,Tommy Haas,Philipp Kohlschreiber,3-6; 7-6(8); 6-7(5); 7-6(1); 6-2,R128,199,31,2,108,172,86,108,36,64,4,6,26,122,172,20,7,117,168,90,117,27,51,8,11,27,117,168
2012-06-25 00:00:00.000,Wimbledon Great Britain Grand Slams,GRASS,3,Malek Jaziri,Jurgen Zopp,Malek Jaziri,4-6; 4-6; 6-3; 6-4; 9-7,R128,211,16,0,103,166,80,103,35,63,8,11,28,115,166,18,6,93,152,72,93,31,59,5,9,27,103,152
2012-06-25 00:00:00.000,Wimbledon Great Britain Grand Slams,GRASS,3,Lukas Rosol,Ivan Dodig,Lukas Rosol,6-4; 3-6; 7-6(0); 7-5,R128,160,12,4,88,130,73,88,23,42,5,6,21,96,130,27,8,77,134,62,77,29,57,3,5,22,91,134
2012-06-25 00:00:00.000,Wimbledon Great Britain Grand Slams,GRASS,3,Rafael Nadal,Thomaz Bellucci,Rafael Nadal,7-6(0); 6-2; 6-3,R128,135,6,1,57,89,43,57,19,32,1,4,15,62,89,5,1,56,91,33,56,14,35,3,9,14,47,91
2012-06-25 00:00:00.000,Wimbledon Great Britain Grand Slams,GRASS,3,Novak Djokovic,Ryan Harrison,Novak Djokovic,6-4; 6-4; 6-4,R64,116,8,1,63,85,48,63,18,22,6,6,15,66,85,8,4,55,88,40,55,16,33,0,3,15,56,88
2012-06-25 00:00:00.000,Wimbledon Great Britain Grand Slams,GRASS,3,Radek Stepanek,Benjamin Becker,Radek Stepanek,6-2; 7-6(4); 6-3,R64,129,6,2,55,86,40,55,20,31,2,4,15,60,86,7,3,45,89,27,45,23,44,3,8,14,50,89
2012-06-25 00:00:00.000,Wimbledon Great Britain Grand Slams,GRASS,3,Viktor Troicki,Martin Klizan,Viktor Troicki,6-4; 4-6; 5-7; 7-6(3); 6-4,R64,227,18,7,104,169,81,104,31,65,11,16,27,112,169,5,5,103,162,73,103,32,59,5,10,27,105,162
2012-06-25 00:00:00.000,Wimbledon Great Britain Grand Slams,GRASS,3,Juan Monaco,Jeremy Chardy,Juan Monaco,6-2; 3-6; 6-3; 7-6(3),R64,153,2,5,69,105,51,69,23,36,0,2,19,74,105,17,1,73,112,52,73,22,39,4,8,19,74,112
2012-06-25 00:00:00.000,Wimbledon Great Britain Grand Slams,GRASS,3,Nicolas Almagro,Guillaume Rufin,Nicolas Almagro,6-2; 5-7; 6-2; 6-4,R64,124,20,0,65,91,60,65,14,26,0,1,19,74,91,11,3,71,114,49,71,22,43,2,7,19,71,114
2012-06-25 00:00:00.000,Wimbledon Great Britain Grand Slams,GRASS,3,Richard Gasquet,Ruben Bemelmans,Richard Gasquet,6-3; 6-4; 6-4,R64,102,6,0,49,75,40,49,15,26,0,2,15,55,75,7,3,56,89,36,56,13,33,3,8,14,49,89
2012-06-25 00:00:00.000,Wimbledon Great Britain Grand Slams,GRASS,3,Florian Mayer,Philipp Petzschner,Florian Mayer,3-6; 3-6; 6-4; 6-2; 6-4,R64,161,7,3,92,149,65,92,32,57,11,15,23,97,149,15,3,89,144,60,89,31,55,9,14,23,91,144
2012-06-25 00:00:00.000,Wimbledon Great Britain Grand Slams,GRASS,3,Jerzy Janowicz,Ernests Gulbis,Jerzy Janowicz,2-6; 6-4; 3-6; 7-6(2); 9-7,R64,190,14,6,94,151,82,94,31,57,5,8,27,113,151,39,3,108,148,86,108,28,40,5,7,28,114,148
2012-06-25 00:00:00.000,Wimbledon Great Britain Grand Slams,GRASS,3,Roger Federer,Fabio Fognini,Roger Federer,6-1; 6-3; 6-2,R64,74,13,2,41,60,37,41,11,19,0,0,12,48,60,1,0,54,73,29,54,8,19,2,8,12,37,73
2012-06-25 00:00:00.000,Wimbledon Great Britain Grand Slams,GRASS,3,Julien Benneteau,Michael Russell,Julien Benneteau,7-6(4); 2-6; 6-4; 7-5,R64,187,13,4,80,124,58,80,25,44,3,6,21,83,124,10,5,77,128,58,77,27,51,3,6,21,85,128
2012-06-25 00:00:00.000,Wimbledon Great Britain Grand Slams,GRASS,3,Fernando Verdasco,Grega Zemlja,Fernando Verdasco,7-6(4); 7-6(4); 3-6; 6-3,R64,175,22,5,84,128,66,84,27,44,3,5,21,93,128,12,8,81,141,61,81,32,60,5,7,21,93,141
2012-06-25 00:00:00.000,Wimbledon Great Britain Grand Slams,GRASS,3,Xavier Malisse,Gilles Simon,Xavier Malisse,6-4; 6-4; 7-6(5),R64,150,10,0,62,104,49,62,19,42,3,6,16,68,104,7,3,67,113,47,67,17,46,9,14,16,64,113
2012-06-25 00:00:00.000,Wimbledon Great Britain Grand Slams,GRASS,3,Alejandro Falla,Nicolas Mahut,Alejandro Falla,6-4; 6-3; 4-6; 4-6; 7-5,R64,189,7,2,91,132,64,91,25,41,3,8,25,89,132,5,6,82,140,60,82,31,58,8,15,26,91,140
2012-06-25 00:00:00.000,Wimbledon Great Britain Grand Slams,GRASS,3,Denis Istomin,Igor Andreev,Denis Istomin,6-3; 7-6(3); 4-6; 6-2,R64,138,20,1,78,105,67,78,14,27,2,4,20,81,105,3,3,74,123,53,74,23,49,4,8,19,76,123
2012-06-25 00:00:00.000,Wimbledon Great Britain Grand Slams,GRASS,3,Mikhail Youzhny,Inigo Cervantes,Mikhail Youzhny,6-1; 6-3; 6-4,R64,111,1,1,50,73,40,50,16,23,1,1,13,56,73,10,5,57,95,38,57,13,38,4,9,13,51,95
2012-06-25 00:00:00.000,Wimbledon Great Britain Grand Slams,GRASS,3,Janko Tipsarevic,Ryan Sweeting,Janko Tipsarevic,5-7; 7-5; 6-4; 6-2,R64,176,17,3,61,105,55,61,28,44,0,1,21,83,105,16,4,96,147,67,96,24,51,9,13,21,91,147
2012-06-25 00:00:00.000,Wimbledon Great Britain Grand Slams,GRASS,3,David Ferrer,Kenny De Schepper,David Ferrer,7-6(1); 6-2; 6-4,R64,119,4,0,64,89,51,64,17,25,3,3,15,68,89,7,3,56,90,39,56,17,34,5,8,15,56,90
2012-06-25 00:00:00.000,Wimbledon Great Britain Grand Slams,GRASS,3,Andy Roddick,Bjorn Phau,Andy Roddick,6-3; 7-6(1); 6-3,R64,122,13,3,62,85,53,62,14,23,1,2,16,67,85,11,6,45,84,36,45,17,39,3,6,14,53,84
2012-06-25 00:00:00.000,Wimbledon Great Britain Grand Slams,GRASS,3,Kei Nishikori,Florent Serra,Kei Nishikori,6-3; 7-5; 6-2,R64,105,6,6,36,73,29,36,21,37,1,4,14,50,73,4,3,53,92,31,53,14,39,5,13,15,45,92
2012-06-25 00:00:00.000,Wimbledon Great Britain Grand Slams,GRASS,3,Juan Martin Del Potro,Go Soeda,Juan Martin Del Potro,6-2; 6-3; 1-6; 6-4,R64,127,12,5,62,96,44,62,22,34,0,2,17,66,96,4,2,46,87,37,46,22,41,1,5,17,59,87
2012-06-25 00:00:00.000,Wimbledon Great Britain Grand Slams,GRASS,3,Marin Cilic,Lukasz Kubot,Marin Cilic,7-6(4); 6-2; 6-1,R64,114,14,1,48,77,40,48,19,29,0,1,14,59,77,5,7,41,74,25,41,16,33,1,6,13,41,74
2012-06-25 00:00:00.000,Wimbledon Great Britain Grand Slams,GRASS,3,Sam Querrey,Milos Raonic,Sam Querrey,6-7(3); 7-6(7); 7-6(8); 6-4,R64,183,21,3,89,156,71,89,39,67,4,5,23,110,156,25,3,107,150,83,107,24,43,4,6,23,107,150
2012-06-25 00:00:00.000,Wimbledon Great Britain Grand Slams,GRASS,3,Marcos Baghdatis,Grigor Dimitrov,Marcos Baghdatis,7-5; 4-1 RET,R64,72,9,2,25,46,22,25,12,21,1,2,8,34,46,2,3,44,68,25,44,10,24,5,9,9,35,68
2012-06-25 00:00:00.000,Wimbledon Great Britain Grand Slams,GRASS,3,Andy Murray,Ivo Karlovic,Andy Murray,7-5; 6-7(5); 6-2; 7-6(4),R64,188,11,6,78,127,66,78,33,49,0,1,22,99,127,17,9,83,136,69,83,24,53,3,7,22,93,136
2012-06-25 00:00:00.000,Wimbledon Great Britain Grand Slams,GRASS,3,Jo-Wilfried Tsonga,Guillermo Garcia-Lopez,Jo-Wilfried Tsonga,6-7(3); 6-4; 6-1; 6-3,R64,153,10,1,76,113,60,76,24,37,2,2,19,84,113,7,6,70,112,47,70,25,42,5,10,19,72,112
2012-06-25 00:00:00.000,Wimbledon Great Britain Grand Slams,GRASS,3,Lukas Lacko,Jurgen Melzer,Lukas Lacko,6-4; 6-7(4); 3-6; 6-3; 6-4,R64,167,25,1,93,148,78,93,26,55,5,8,25,104,148,13,6,114,157,81,114,22,43,5,10,25,103,157
2012-06-25 00:00:00.000,Wimbledon Great Britain Grand Slams,GRASS,3,David Goffin,Jesse Levine,David Goffin,4-6; 6-4; 6-1; 6-3,R64,147,14,6,84,124,59,84,21,40,10,12,18,80,124,14,5,70,111,49,70,17,41,6,12,18,66,111
2012-06-25 00:00:00.000,Wimbledon Great Britain Grand Slams,GRASS,3,Mardy Fish,James Ward,Mardy Fish,6-3; 5-7; 6-4; 6-7(3); 6-3,R64,253,26,4,82,162,65,82,44,80,5,8,27,109,162,16,3,106,172,74,106,32,66,12,17,25,106,172
2012-06-25 00:00:00.000,Wimbledon Great Britain Grand Slams,GRASS,3,Brian Baker,Jarkko Nieminen,Brian Baker,6-0; 6-2; 6-4,R64,80,6,2,42,64,35,42,14,22,0,0,12,49,64,5,2,48,76,30,48,8,28,6,12,12,38,76
2012-06-25 00:00:00.000,Wimbledon Great Britain Grand Slams,GRASS,3,Benoit Paire,Alexandr Dolgopolov,Benoit Paire,7-6(2); 6-4; 6-4,R64,115,11,5,57,109,44,57,29,52,5,7,16,73,109,9,2,73,113,49,73,18,40,9,13,16,67,113
2012-06-25 00:00:00.000,Wimbledon Great Britain Grand Slams,GRASS,3,Philipp Kohlschreiber,Malek Jaziri,Philipp Kohlschreiber,6-1; 7-6(2); 6-1,R64,91,22,5,51,80,46,51,17,29,1,1,14,63,80,8,6,46,80,34,46,11,34,1,5,12,45,80
2012-06-25 00:00:00.000,Wimbledon Great Britain Grand Slams,GRASS,3,Lukas Rosol,Rafael Nadal,Lukas Rosol,6-7(9); 6-4; 6-4; 2-6; 6-4,R64,198,22,3,92,137,76,92,26,45,1,4,25,102,137,19,2,93,139,73,93,29,46,4,8,25,102,139
2012-06-25 00:00:00.000,Wimbledon Great Britain Grand Slams,GRASS,3,Novak Djokovic,Radek Stepanek,Novak Djokovic,4-6; 6-2; 6-2; 6-2,R32,169,12,1,63,96,50,63,20,33,4,5,17,70,96,8,1,94,143,57,94,19,49,14,20,17,76,143
2012-06-25 00:00:00.000,Wimbledon Great Britain Grand Slams,GRASS,3,Viktor Troicki,Juan Monaco,Viktor Troicki,7-5; 7-5; 6-3,R32,158,13,9,64,115,54,64,19,51,6,9,17,73,115,0,2,78,115,46,78,17,37,7,13,16,63,115
2012-06-25 00:00:00.000,Wimbledon Great Britain Grand Slams,GRASS,3,Richard Gasquet,Nicolas Almagro,Richard Gasquet,6-3; 6-4; 6-4,R32,98,9,3,61,88,50,61,16,27,3,3,15,66,88,7,2,53,77,38,53,13,24,4,7,14,51,77
2012-06-25 00:00:00.000,Wimbledon Great Britain Grand Slams,GRASS,3,Florian Mayer,Jerzy Janowicz,Florian Mayer,7-6(5); 3-6; 2-6; 6-3; 7-5,R32,195,8,2,126,168,89,126,24,42,7,10,25,113,168,20,6,90,151,69,90,36,61,4,6,25,105,151
2012-06-25 00:00:00.000,Wimbledon Great Britain Grand Slams,GRASS,3,Roger Federer,Julien Benneteau,Roger Federer,4-6; 6-7(3); 6-2; 7-6(6); 6-1,R32,214,14,4,101,156,80,101,31,55,4,6,25,111,156,15,10,115,168,79,115,27,53,8,13,24,106,168
2012-06-25 00:00:00.000,Wimbledon Great Britain Grand Slams,GRASS,3,Xavier Malisse,Fernando Verdasco,Xavier Malisse,1-6; 7-6(5); 6-1; 4-6; 6-3,R32,190,8,0,74,135,53,74,41,61,3,6,22,94,135,21,8,109,161,80,109,24,52,13,17,23,104,161
2012-06-25 00:00:00.000,Wimbledon Great Britain Grand Slams,GRASS,3,Denis Istomin,Alejandro Falla,Denis Istomin,6-3; 6-4; 3-6; 7-6(5),R32,163,16,4,91,132,68,91,24,41,7,8,20,92,132,1,3,81,122,59,81,26,41,6,8,20,85,122
2012-06-25 00:00:00.000,Wimbledon Great Britain Grand Slams,GRASS,3,Mikhail Youzhny,Janko Tipsarevic,Mikhail Youzhny,6-3; 6-4; 3-6; 6-3,R32,146,10,1,69,106,57,69,20,37,2,3,19,77,106,11,2,66,103,49,66,20,37,5,8,18,69,103
2012-06-25 00:00:00.000,Wimbledon Great Britain Grand Slams,GRASS,3,David Ferrer,Andy Roddick,David Ferrer,2-6; 7-6(8); 6-4; 6-3,R32,158,10,3,66,113,53,66,29,47,3,6,19,82,113,15,1,85,118,64,85,17,33,4,8,20,81,118
2012-06-25 00:00:00.000,Wimbledon Great Britain Grand Slams,GRASS,3,Juan Martin Del Potro,Kei Nishikori,Juan Martin Del Potro,6-3; 7-6(3); 6-1,R32,146,12,4,71,96,52,71,14,25,2,3,15,66,96,1,5,55,93,37,55,19,38,7,11,13,56,93
2012-06-25 00:00:00.000,Wimbledon Great Britain Grand Slams,GRASS,3,Marin Cilic,Sam Querrey,Marin Cilic,7-6(6); 6-4; 6-7(2); 6-7(3); 17-15,R32,331,14,6,138,226,104,138,56,88,5,8,39,160,226,23,9,172,273,132,172,47,101,11,16,39,179,273
2012-06-25 00:00:00.000,Wimbledon Great Britain Grand Slams,GRASS,3,Andy Murray,Marcos Baghdatis,Andy Murray,7-5; 3-6; 7-5; 6-1,R32,193,10,4,74,117,51,74,28,43,5,8,20,79,117,5,3,86,154,54,86,33,68,17,23,20,87,154
2012-06-25 00:00:00.000,Wimbledon Great Britain Grand Slams,GRASS,3,Jo-Wilfried Tsonga,Lukas Lacko,Jo-Wilfried Tsonga,6-4; 6-3; 6-3,R32,96,7,2,51,77,42,51,17,26,3,3,14,59,77,5,3,49,73,36,49,12,24,1,5,14,48,73
2012-06-25 00:00:00.000,Wimbledon Great Britain Grand Slams,GRASS,3,Mardy Fish,David Goffin,Mardy Fish,6-3; 7-6(6); 7-6(6),R32,136,17,1,66,103,59,66,23,37,1,1,17,82,103,6,2,72,109,54,72,20,37,1,2,16,74,109
2012-06-25 00:00:00.000,Wimbledon Great Britain Grand Slams,GRASS,3,Brian Baker,Benoit Paire,Brian Baker,6-4; 4-6; 6-1; 6-3,R32,131,5,3,65,112,49,65,28,47,4,6,18,77,112,17,2,65,115,45,65,20,50,4,10,18,65,115
2012-06-25 00:00:00.000,Wimbledon Great Britain Grand Slams,GRASS,3,Philipp Kohlschreiber,Lukas Rosol,Philipp Kohlschreiber,6-2; 6-3; 7-6(6),R32,97,12,0,46,78,41,46,22,32,0,0,14,63,78,7,3,65,92,45,65,11,27,2,6,15,56,92
2012-06-25 00:00:00.000,Wimbledon Great Britain Grand Slams,GRASS,3,Novak Djokovic,Viktor Troicki,Novak Djokovic,6-3; 6-1; 6-3,R16,90,4,2,53,70,43,53,9,17,3,4,13,52,70,3,2,42,73,23,42,13,31,2,8,12,36,73
2012-06-25 00:00:00.000,Wimbledon Great Britain Grand Slams,GRASS,3,Florian Mayer,Richard Gasquet,Florian Mayer,6-3; 6-1; 3-6; 6-2,R16,112,14,0,49,81,40,49,22,32,0,1,16,62,81,7,2,82,108,55,82,9,26,6,12,17,64,108
2012-06-25 00:00:00.000,Wimbledon Great Britain Grand Slams,GRASS,3,Roger Federer,Xavier Malisse,Roger Federer,7-6(1); 6-1; 4-6; 6-3,R16,131,9,1,82,117,60,82,20,35,8,11,19,80,117,9,2,79,111,53,79,9,32,1,7,19,62,111
2012-06-25 00:00:00.000,Wimbledon Great Britain Grand Slams,GRASS,3,Mikhail Youzhny,Denis Istomin,Mikhail Youzhny,6-3; 5-7; 6-4; 6-7(5); 7-5,R16,256,12,3,113,188,81,113,40,75,11,14,28,121,188,16,1,103,147,82,103,21,44,3,8,27,103,147
2012-06-25 00:00:00.000,Wimbledon Great Britain Grand Slams,GRASS,3,David Ferrer,Juan Martin Del Potro,David Ferrer,6-3; 6-2; 6-3,R16,118,4,0,49,76,37,49,21,27,4,4,13,58,76,6,3,60,82,38,60,9,22,3,8,13,47,82
2012-06-25 00:00:00.000,Wimbledon Great Britain Grand Slams,GRASS,3,Andy Murray,Marin Cilic,Andy Murray,7-5; 6-2; 6-3,R16,130,16,1,60,88,43,60,20,28,7,8,15,63,88,4,3,54,92,39,54,13,38,7,12,14,52,92
2012-06-25 00:00:00.000,Wimbledon Great Britain Grand Slams,GRASS,3,Jo-Wilfried Tsonga,Mardy Fish,Jo-Wilfried Tsonga,4-6; 7-6(4); 6-4; 6-4,R16,198,20,4,89,158,67,89,37,69,9,11,21,104,158,17,4,64,117,55,64,29,53,5,8,21,84,117
2012-06-25 00:00:00.000,Wimbledon Great Britain Grand Slams,GRASS,3,Philipp Kohlschreiber,Brian Baker,Philipp Kohlschreiber,6-1; 7-6(4); 6-3,R16,115,23,4,66,103,53,66,20,37,5,5,15,73,103,7,3,56,77,41,56,11,21,0,3,13,52,77
2012-06-25 00:00:00.000,Wimbledon Great Britain Grand Slams,GRASS,3,Novak Djokovic,Florian Mayer,Novak Djokovic,6-4; 6-1; 6-4,Q,105,7,3,55,84,42,55,17,29,7,8,14,59,84,2,1,44,77,27,44,15,33,4,9,13,42,77
2012-06-25 00:00:00.000,Wimbledon Great Britain Grand Slams,GRASS,3,Roger Federer,Mikhail Youzhny,Roger Federer,6-1; 6-2; 6-2,Q,92,2,0,41,66,36,41,13,25,2,2,12,49,66,3,2,53,82,27,53,15,29,14,20,11,42,82
2012-06-25 00:00:00.000,Wimbledon Great Britain Grand Slams,GRASS,3,Andy Murray,David Ferrer,Andy Murray,6-7(5); 7-6(6); 6-4; 7-6(4),Q,232,18,3,92,150,74,92,34,58,10,12,23,108,150,6,0,112,165,79,112,28,53,6,9,23,107,165
2012-06-25 00:00:00.000,Wimbledon Great Britain Grand Slams,GRASS,3,Jo-Wilfried Tsonga,Philipp Kohlschreiber,Jo-Wilfried Tsonga,7-6(5); 4-6; 7-6(3); 6-2,Q,168,17,0,80,126,64,80,27,46,3,5,21,91,126,10,4,85,136,60,85,29,51,7,10,21,89,136
2012-06-25 00:00:00.000,Wimbledon Great Britain Grand Slams,GRASS,3,Roger Federer,Novak Djokovic,Roger Federer,6-3; 3-6; 6-4; 6-3,S,139,12,0,65,101,49,65,26,36,2,3,19,75,101,9,2,73,115,52,73,24,42,8,11,18,76,115
2012-06-25 00:00:00.000,Wimbledon Great Britain Grand Slams,GRASS,3,Andy Murray,Jo-Wilfried Tsonga,Andy Murray,6-3; 6-4; 3-6; 7-5,S,167,9,2,67,111,50,67,28,44,6,8,20,78,111,11,2,85,135,64,85,16,50,8,12,20,80,135
2012-06-25 00:00:00.000,Wimbledon Great Britain Grand Slams,GRASS,3,Roger Federer,Andy Murray,Roger Federer,4-6; 7-5; 6-3; 6-4,F,204,12,3,90,131,68,90,20,41,5,7,21,88,131,16,1,88,157,61,88,33,69,8,12,20,94,157
2012-07-09 00:00:00.000,Bastad Sweden ATP World Tour 250,CLAY,2,David Ferrer,N/A Bye,David Ferrer,,R32,0,0,0,0,0,0,0,0,0,0,0,0,0,0,0,0,0,0,0,0,0,0,0,0,0,0,0
2012-07-09 00:00:00.000,Bastad Sweden ATP World Tour 250,CLAY,2,Simone Bolelli,Paul Capdeville,Simone Bolelli,7-6(5); 7-6(3),R32,134,4,3,61,82,36,61,11,21,6,12,12,47,82,2,6,52,91,32,52,16,39,7,13,12,48,91
2012-07-09 00:00:00.000,Bastad Sweden ATP World Tour 250,CLAY,2,Joao Souza,Horacio Zeballos,Joao Souza,6-4; 6-2,R32,77,4,1,34,50,25,34,12,16,0,0,9,37,50,3,0,33,54,22,33,9,21,3,6,9,31,54
2012-07-09 00:00:00.000,Bastad Sweden ATP World Tour 250,CLAY,2,Tommy Robredo,Adrian Ungur,Tommy Robredo,6-4; 6-2,R32,68,4,0,31,49,25,31,13,18,2,2,9,38,49,1,2,31,52,23,31,10,21,3,6,9,33,52
2012-07-09 00:00:00.000,Bastad Sweden ATP World Tour 250,CLAY,2,Albert Ramos-Vinolas,N/A Bye,Albert Ramos-Vinolas,,R32,0,0,0,0,0,0,0,0,0,0,0,0,0,0,0,0,0,0,0,0,0,0,0,0,0,0,0
2012-07-09 00:00:00.000,Bastad Sweden ATP World Tour 250,CLAY,2,Evgeny Korolev,Thiago Alves,Evgeny Korolev,6-0; 6-3,R32,60,4,2,24,41,19,24,6,17,0,2,7,25,41,2,1,39,59,14,39,8,20,8,15,8,22,59
2012-07-09 00:00:00.000,Bastad Sweden ATP World Tour 250,CLAY,2,Frederico Gil,Marsel Ilhan,Frederico Gil,6-4; 1-6; 6-3,R32,108,3,2,57,88,36,57,17,31,6,8,13,53,88,2,1,50,75,33,50,18,25,5,7,13,51,75
2012-07-09 00:00:00.000,Bastad Sweden ATP World Tour 250,CLAY,2,Grigor Dimitrov,Rogerio Dutra Silva,Grigor Dimitrov,6-1; 6-4,R32,70,5,1,30,49,26,30,11,19,1,1,9,37,49,0,0,35,51,17,35,10,16,4,7,8,27,51
2012-07-09 00:00:00.000,Bastad Sweden ATP World Tour 250,CLAY,2,Filippo Volandri,Michael Ryderstedt,Filippo Volandri,6-4; 6-2,R32,69,1,0,35,49,27,35,8,14,3,4,9,35,49,1,2,31,52,18,31,8,21,1,5,9,26,52
2012-07-09 00:00:00.000,Bastad Sweden ATP World Tour 250,CLAY,2,Jurgen Zopp,Christian Lindell,Jurgen Zopp,6-2; 6-2,R32,88,0,3,29,50,22,29,12,21,2,3,8,34,50,4,2,48,75,26,48,9,27,6,11,8,35,75
2012-07-09 00:00:00.000,Bastad Sweden ATP World Tour 250,CLAY,2,Jan Hajek,Federico Delbonis,Jan Hajek,7-6(3); 6-3,R32,90,3,0,50,69,34,50,13,19,2,3,10,47,69,3,3,46,73,31,46,10,27,2,5,11,41,73
2012-07-09 00:00:00.000,Bastad Sweden ATP World Tour 250,CLAY,2,Jarkko Nieminen,N/A Bye,Jarkko Nieminen,,R32,0,0,0,0,0,0,0,0,0,0,0,0,0,0,0,0,0,0,0,0,0,0,0,0,0,0,0
2012-07-09 00:00:00.000,Bastad Sweden ATP World Tour 250,CLAY,2,Daniel Gimeno-Traver,Mikhail Kukushkin,Daniel Gimeno-Traver,6-4; 3-6; 6-3,R32,142,10,2,56,99,40,56,21,43,9,12,14,61,99,2,2,52,94,32,52,24,42,4,8,14,56,94
2012-07-09 00:00:00.000,Bastad Sweden ATP World Tour 250,CLAY,2,Alessandro Giannessi,Michael Berrer,Alessandro Giannessi,6-4; 3-6; 7-6(5),R32,175,0,7,86,110,52,86,12,24,11,16,15,64,110,1,3,86,118,52,86,16,32,8,13,16,68,118
2012-07-09 00:00:00.000,Bastad Sweden ATP World Tour 250,CLAY,2,Ivo Minar,Roberto Bautista Agut,Ivo Minar,7-5; 7-6(4),R32,103,8,1,49,68,32,49,11,19,0,3,12,43,68,1,1,59,86,33,59,16,27,11,15,12,49,86
2012-07-09 00:00:00.000,Bastad Sweden ATP World Tour 250,CLAY,2,Nicolas Almagro,N/A Bye,Nicolas Almagro,,R32,0,0,0,0,0,0,0,0,0,0,0,0,0,0,0,0,0,0,0,0,0,0,0,0,0,0,0
2012-07-09 00:00:00.000,Bastad Sweden ATP World Tour 250,CLAY,2,David Ferrer,Simone Bolelli,David Ferrer,6-4; 6-3,R16,75,3,1,28,51,23,28,10,23,0,2,10,33,51,0,0,42,55,22,42,6,13,3,7,9,28,55
2012-07-09 00:00:00.000,Bastad Sweden ATP World Tour 250,CLAY,2,Tommy Robredo,Joao Souza,Tommy Robredo,6-3; 6-1,R16,70,7,2,28,44,23,28,7,16,0,1,8,30,44,0,2,24,42,14,24,6,18,0,5,8,20,42
2012-07-09 00:00:00.000,Bastad Sweden ATP World Tour 250,CLAY,2,Albert Ramos-Vinolas,Evgeny Korolev,Albert Ramos-Vinolas,6-3; 6-3,R16,83,5,3,44,63,31,44,8,19,6,8,9,39,63,1,5,33,58,19,33,9,25,4,9,9,28,58
2012-07-09 00:00:00.000,Bastad Sweden ATP World Tour 250,CLAY,2,Grigor Dimitrov,Frederico Gil,Grigor Dimitrov,6-3; 6-4,R16,82,5,1,36,58,25,36,14,22,3,5,10,39,58,1,1,35,56,19,35,10,21,6,10,9,29,56
2012-07-09 00:00:00.000,Bastad Sweden ATP World Tour 250,CLAY,2,Jurgen Zopp,Filippo Volandri,Jurgen Zopp,3-6; 6-1; 6-4,R16,118,5,1,53,79,29,53,14,26,2,7,13,43,79,0,4,85,111,46,85,9,26,10,17,13,55,111
2012-07-09 00:00:00.000,Bastad Sweden ATP World Tour 250,CLAY,2,Jan Hajek,Jarkko Nieminen,Jan Hajek,6-1; 7-6(2),R16,88,1,0,35,59,27,35,12,24,0,1,9,39,59,1,3,62,82,34,62,8,20,6,10,10,42,82
2012-07-09 00:00:00.000,Bastad Sweden ATP World Tour 250,CLAY,2,Daniel Gimeno-Traver,Alessandro Giannessi,Daniel Gimeno-Traver,6-4; 6-3,R16,84,7,1,42,64,32,42,11,22,4,5,10,43,64,0,1,42,57,25,42,8,15,5,8,9,33,57
2012-07-09 00:00:00.000,Bastad Sweden ATP World Tour 250,CLAY,2,Nicolas Almagro,Ivo Minar,Nicolas Almagro,1-6; 7-6(8); 6-4,R16,116,9,1,61,97,46,61,16,36,5,9,15,62,97,9,1,58,93,44,58,18,35,4,6,14,62,93
2012-07-09 00:00:00.000,Bastad Sweden ATP World Tour 250,CLAY,2,David Ferrer,Tommy Robredo,David Ferrer,6-3; 4-6; 6-0,Q,124,3,3,47,77,37,47,16,30,0,1,13,53,77,3,2,51,90,35,51,16,39,6,10,12,51,90
2012-07-09 00:00:00.000,Bastad Sweden ATP World Tour 250,CLAY,2,Grigor Dimitrov,Albert Ramos-Vinolas,Grigor Dimitrov,7-6(1); 6-3,Q,109,2,1,43,65,24,43,18,22,4,6,10,42,65,0,3,48,80,28,48,13,32,5,9,11,41,80
2012-07-09 00:00:00.000,Bastad Sweden ATP World Tour 250,CLAY,2,Jan Hajek,Jurgen Zopp,Jan Hajek,6-3; 4-6; 6-3,Q,108,5,1,55,82,38,55,13,27,5,8,14,51,82,1,5,56,86,32,56,16,30,1,6,14,48,86
2012-07-09 00:00:00.000,Bastad Sweden ATP World Tour 250,CLAY,2,Nicolas Almagro,Daniel Gimeno-Traver,Nicolas Almagro,7-6(5); 4-6; 6-3,Q,135,7,3,67,112,52,67,23,45,11,12,16,75,112,7,4,61,100,46,61,20,39,4,5,15,66,100
2012-07-09 00:00:00.000,Bastad Sweden ATP World Tour 250,CLAY,2,David Ferrer,Grigor Dimitrov,David Ferrer,6-3; 7-5,S,93,2,3,46,70,34,46,13,24,7,8,11,47,70,2,1,37,63,26,37,11,26,4,7,10,37,63
2012-07-09 00:00:00.000,Bastad Sweden ATP World Tour 250,CLAY,2,Nicolas Almagro,Jan Hajek,Nicolas Almagro,6-4; 6-3,S,68,8,0,36,55,32,36,10,19,0,0,10,42,55,2,1,33,55,22,33,11,22,4,6,9,33,55
2012-07-09 00:00:00.000,Bastad Sweden ATP World Tour 250,CLAY,2,David Ferrer,Nicolas Almagro,David Ferrer,6-2; 6-2,F,67,2,2,42,58,30,42,9,16,1,1,8,39,58,1,2,23,45,12,23,10,22,2,6,8,22,45
2012-07-09 00:00:00.000,Newport RI; U.S.A. ATP World Tour 250,GRASS,2,John Isner,Sergei Bubka,John Isner,7-6(3); 4-6; 6-3,R32,116,20,4,78,111,62,78,15,33,4,5,16,77,111,9,3,55,86,41,55,23,31,3,4,15,64,86
2012-07-09 00:00:00.000,Newport RI; U.S.A. ATP World Tour 250,GRASS,2,Nicolas Mahut,Marco Chiudinelli,Nicolas Mahut,6-0; 7-6(2),R32,78,10,2,27,52,23,27,18,25,0,0,9,41,52,1,7,34,62,23,34,12,28,2,5,9,35,62
2012-07-09 00:00:00.000,Newport RI; U.S.A. ATP World Tour 250,GRASS,2,Jack Sock,Igor Kunitsyn,Jack Sock,7-5; 1-6; 6-4,R32,127,13,8,52,94,38,52,18,42,5,10,15,56,94,3,1,37,83,28,37,24,46,3,7,14,52,83
2012-07-09 00:00:00.000,Newport RI; U.S.A. ATP World Tour 250,GRASS,2,Izak Van der Merwe,Gilles Muller,Izak Van der Merwe,7-6(5); 6-7(3); 6-4,R32,140,7,5,59,105,48,59,28,46,2,3,17,76,105,14,6,56,100,50,56,22,44,3,5,17,72,100
2012-07-09 00:00:00.000,Newport RI; U.S.A. ATP World Tour 250,GRASS,2,Milos Raonic,Matthew Ebden,Milos Raonic,3-6; 6-3; 7-5,R32,114,26,7,47,91,39,47,26,44,4,5,15,65,91,6,7,64,105,50,64,18,41,7,9,15,68,105
2012-07-09 00:00:00.000,Newport RI; U.S.A. ATP World Tour 250,GRASS,2,Benjamin Becker,David Goffin,Benjamin Becker,6-4; 6-3,R32,70,6,0,30,53,24,30,14,23,5,6,10,38,53,3,9,29,58,23,29,10,29,2,5,9,33,58
2012-07-09 00:00:00.000,Newport RI; U.S.A. ATP World Tour 250,GRASS,2,Jesse Levine,Marinko Matosevic,Jesse Levine,6-2; 7-6(8),R32,100,4,0,38,73,29,38,22,35,3,3,10,51,73,7,5,50,80,35,50,12,30,8,10,10,47,80
2012-07-09 00:00:00.000,Newport RI; U.S.A. ATP World Tour 250,GRASS,2,Ryan Harrison,Ruben Bemelmans,Ryan Harrison,7-6(8); 6-7(5); 7-5,R32,169,6,5,75,128,49,75,30,53,9,12,18,79,128,3,7,66,133,48,66,31,67,9,13,18,79,133
2012-07-09 00:00:00.000,Newport RI; U.S.A. ATP World Tour 250,GRASS,2,Sam Querrey,Alex Bogomolov Jr.,Sam Querrey,7-5; 7-6(5),R32,95,11,4,40,71,33,40,18,31,0,0,12,51,71,4,3,58,84,40,58,13,26,3,4,12,53,84
2012-07-09 00:00:00.000,Newport RI; U.S.A. ATP World Tour 250,GRASS,2,Dudi Sela,Frank Dancevic,Dudi Sela,6-0; 6-2,R32,51,6,2,24,45,20,24,12,21,4,4,7,32,45,2,4,26,50,15,26,6,24,4,9,7,21,50
2012-07-09 00:00:00.000,Newport RI; U.S.A. ATP World Tour 250,GRASS,2,Lleyton Hewitt,Vasek Pospisil,Lleyton Hewitt,6-1; 6-1,R32,49,4,4,24,41,18,24,10,17,2,3,7,28,41,3,7,15,41,7,15,6,26,1,7,7,13,41
2012-07-09 00:00:00.000,Newport RI; U.S.A. ATP World Tour 250,GRASS,2,Tim Smyczek,Denis Istomin,Tim Smyczek,6-3; 6-3,R32,56,6,0,29,45,23,29,11,16,2,3,9,34,45,7,2,39,62,23,39,9,23,10,14,9,32,62
2012-07-09 00:00:00.000,Newport RI; U.S.A. ATP World Tour 250,GRASS,2,Michael Russell,Donald Young,Michael Russell,1-6; 6-1; 6-4,R32,98,1,5,42,84,28,42,22,42,2,5,12,50,84,4,5,36,66,23,36,17,30,5,9,12,40,66
2012-07-09 00:00:00.000,Newport RI; U.S.A. ATP World Tour 250,GRASS,2,Rajeev Ram,Grega Zemlja,Rajeev Ram,6-3; 6-1,R32,58,5,2,22,47,19,22,15,25,2,2,8,34,47,5,7,29,47,18,29,6,18,2,6,8,24,47
2012-07-09 00:00:00.000,Newport RI; U.S.A. ATP World Tour 250,GRASS,2,Olivier Rochus,Go Soeda,Olivier Rochus,6-4; 3-6; 6-3,R32,115,5,2,60,86,41,60,16,26,6,8,14,57,86,8,5,37,84,35,37,18,47,4,7,14,53,84
2012-07-09 00:00:00.000,Newport RI; U.S.A. ATP World Tour 250,GRASS,2,Kei Nishikori,Igor Sijsling,Kei Nishikori,6-4; 6-4,R32,71,0,3,39,63,27,39,13,24,6,8,10,40,63,5,3,36,60,25,36,8,24,2,6,10,33,60
2012-07-09 00:00:00.000,Newport RI; U.S.A. ATP World Tour 250,GRASS,2,John Isner,Nicolas Mahut,John Isner,6-2; 7-6(2),R16,78,13,2,40,56,33,40,11,16,1,1,10,44,56,5,7,31,70,22,31,20,39,6,8,10,42,70
2012-07-09 00:00:00.000,Newport RI; U.S.A. ATP World Tour 250,GRASS,2,Izak Van der Merwe,Jack Sock,Izak Van der Merwe,6-4; 6-4,R16,96,9,2,27,53,25,27,16,26,2,2,10,41,53,5,6,38,78,25,38,22,40,7,9,10,47,78
2012-07-09 00:00:00.000,Newport RI; U.S.A. ATP World Tour 250,GRASS,2,Benjamin Becker,Milos Raonic,Benjamin Becker,6-3; 6-3,R16,63,7,4,35,63,31,35,11,28,2,2,9,42,63,5,1,26,52,17,26,15,26,1,4,9,32,52
2012-07-09 00:00:00.000,Newport RI; U.S.A. ATP World Tour 250,GRASS,2,Ryan Harrison,Jesse Levine,Ryan Harrison,6-3; 6-4,R16,71,7,2,39,59,30,39,13,20,3,3,10,43,59,2,2,24,50,18,24,16,26,2,4,9,34,50
2012-07-09 00:00:00.000,Newport RI; U.S.A. ATP World Tour 250,GRASS,2,Dudi Sela,Sam Querrey,Dudi Sela,5-7; 7-6(6); 6-2,R16,125,5,4,59,101,41,59,21,42,4,8,16,62,101,12,10,53,99,38,53,20,46,1,6,16,58,99
2012-07-09 00:00:00.000,Newport RI; U.S.A. ATP World Tour 250,GRASS,2,Lleyton Hewitt,Tim Smyczek,Lleyton Hewitt,6-4; 2-6; 6-1,R16,103,2,4,40,73,26,40,18,33,5,9,12,44,73,4,5,63,97,39,63,12,34,3,9,13,51,97
2012-07-09 00:00:00.000,Newport RI; U.S.A. ATP World Tour 250,GRASS,2,Rajeev Ram,Michael Russell,Rajeev Ram,7-6(6); 6-3,R16,98,14,4,46,65,38,46,11,19,0,0,11,49,65,6,5,34,64,24,34,18,30,0,1,10,42,64
2012-07-09 00:00:00.000,Newport RI; U.S.A. ATP World Tour 250,GRASS,2,Kei Nishikori,Olivier Rochus,Kei Nishikori,6-7(6); 6-4; 6-2,R16,144,9,2,59,89,41,59,18,30,1,4,15,59,89,2,2,54,98,34,54,22,44,6,12,15,56,98
2012-07-09 00:00:00.000,Newport RI; U.S.A. ATP World Tour 250,GRASS,2,John Isner,Izak Van der Merwe,John Isner,6-4; 7-6(2),Q,83,12,2,48,67,41,48,10,19,2,2,11,51,67,6,4,39,63,32,39,14,24,1,2,11,46,63
2012-07-09 00:00:00.000,Newport RI; U.S.A. ATP World Tour 250,GRASS,2,Ryan Harrison,Benjamin Becker,Ryan Harrison,6-4; 3-0 RET,Q,58,5,1,23,42,17,23,12,19,7,7,6,29,42,2,2,15,39,7,15,13,24,2,5,7,20,39
2012-07-09 00:00:00.000,Newport RI; U.S.A. ATP World Tour 250,GRASS,2,Lleyton Hewitt,Dudi Sela,Lleyton Hewitt,6-4; 6-3,Q,79,5,2,31,62,26,31,13,31,6,8,9,39,62,1,5,26,59,14,26,16,33,6,11,10,30,59
2012-07-09 00:00:00.000,Newport RI; U.S.A. ATP World Tour 250,GRASS,2,Rajeev Ram,Kei Nishikori,Rajeev Ram,7-6(6); 6-3,Q,99,6,2,43,75,35,43,18,32,4,5,11,53,75,1,2,43,67,33,43,10,24,2,4,10,43,67
2012-07-09 00:00:00.000,Newport RI; U.S.A. ATP World Tour 250,GRASS,2,John Isner,Ryan Harrison,John Isner,7-6(4); 6-3,S,86,11,2,36,53,33,36,11,17,0,0,10,44,53,4,3,50,82,34,50,15,32,5,7,11,49,82
2012-07-09 00:00:00.000,Newport RI; U.S.A. ATP World Tour 250,GRASS,2,Lleyton Hewitt,Rajeev Ram,Lleyton Hewitt,6-4; 5-7; 6-2,S,141,3,7,46,95,34,46,27,49,4,7,15,61,95,9,12,56,112,37,56,23,56,10,15,15,60,112
2012-07-09 00:00:00.000,Newport RI; U.S.A. ATP World Tour 250,GRASS,2,John Isner,Lleyton Hewitt,John Isner,7-6(1); 6-4,F,92,16,1,48,68,38,48,12,20,1,1,11,50,68,8,3,43,71,31,43,14,28,2,3,11,45,71
2012-07-09 00:00:00.000,Stuttgart Germany ATP World Tour 250,CLAY,2,Janko Tipsarevic,N/A Bye,Janko Tipsarevic,,R32,0,0,0,0,0,0,0,0,0,0,0,0,0,0,0,0,0,0,0,0,0,0,0,0,0,0,0
2012-07-09 00:00:00.000,Stuttgart Germany ATP World Tour 250,CLAY,2,Steve Darcis,Albert Montanes,Steve Darcis,6-2; 6-4,R32,69,5,1,29,55,20,29,18,26,2,3,9,38,55,1,3,27,52,17,27,9,25,2,6,9,26,52
2012-07-09 00:00:00.000,Stuttgart Germany ATP World Tour 250,CLAY,2,Bjorn Phau,Martin Fischer,Bjorn Phau,6-3; 6-3,R32,89,1,1,30,60,22,30,16,30,3,4,9,38,60,2,3,32,62,15,32,18,30,6,10,9,33,62
2012-07-09 00:00:00.000,Stuttgart Germany ATP World Tour 250,CLAY,2,Lukas Rosol,Robin Haase,Lukas Rosol,6-4; 7-5,R32,78,12,1,35,65,32,35,17,30,4,4,11,49,65,8,2,29,59,22,29,18,30,1,3,11,40,59
2012-07-09 00:00:00.000,Stuttgart Germany ATP World Tour 250,CLAY,2,Bernard Tomic,N/A Bye,Bernard Tomic,,R32,0,0,0,0,0,0,0,0,0,0,0,0,0,0,0,0,0,0,0,0,0,0,0,0,0,0,0
2012-07-09 00:00:00.000,Stuttgart Germany ATP World Tour 250,CLAY,2,Thomaz Bellucci,Robin Kern,Thomaz Bellucci,7-6(3); 6-2,R32,87,5,3,35,64,24,35,18,29,3,5,10,42,64,4,6,37,73,24,37,17,36,7,11,10,41,73
2012-07-09 00:00:00.000,Stuttgart Germany ATP World Tour 250,CLAY,2,Jeremy Chardy,Julian Reister,Jeremy Chardy,6-2; 6-4,R32,79,6,1,35,59,29,35,12,24,0,0,9,41,59,2,3,35,59,22,35,10,24,6,9,9,32,59
2012-07-09 00:00:00.000,Stuttgart Germany ATP World Tour 250,CLAY,2,Cedrik-Marcel Stebe,Lukasz Kubot,Cedrik-Marcel Stebe,6-2; 0-6; 6-3,R32,102,4,2,46,70,31,46,11,24,4,7,11,42,70,5,10,42,77,31,42,11,35,4,8,12,42,77
2012-07-09 00:00:00.000,Stuttgart Germany ATP World Tour 250,CLAY,2,Dustin Brown,Nikolay Davydenko,Dustin Brown,7-5; 3-6; 7-6(7),R32,124,13,9,65,119,50,65,23,54,7,11,16,73,119,1,4,89,108,59,89,11,19,4,8,17,70,108
2012-07-09 00:00:00.000,Stuttgart Germany ATP World Tour 250,CLAY,2,Benoit Paire,Eduardo Schwank,Benoit Paire,7-6(5); 6-4,R32,98,7,10,40,73,33,40,13,33,3,6,11,46,73,2,4,61,87,37,61,12,26,3,7,11,49,87
2012-07-09 00:00:00.000,Stuttgart Germany ATP World Tour 250,CLAY,2,Guillermo Garcia-Lopez,Ruben Ramirez Hidalgo,Guillermo Garcia-Lopez,6-2; 6-3,R32,90,7,3,29,52,22,29,13,23,3,4,8,35,52,2,1,35,61,16,35,13,26,4,9,9,29,61
2012-07-09 00:00:00.000,Stuttgart Germany ATP World Tour 250,CLAY,2,Pablo Andujar,N/A Bye,Pablo Andujar,,R32,0,0,0,0,0,0,0,0,0,0,0,0,0,0,0,0,0,0,0,0,0,0,0,0,0,0,0
2012-07-09 00:00:00.000,Stuttgart Germany ATP World Tour 250,CLAY,2,Tommy Haas,Igor Andreev,Tommy Haas,4-6; 6-2; 6-2,R32,97,8,5,30,70,26,30,24,40,0,1,13,50,70,4,5,50,80,35,50,13,30,3,7,13,48,80
2012-07-09 00:00:00.000,Stuttgart Germany ATP World Tour 250,CLAY,2,Pavol Cervenak,Sergiy Stakhovsky,Pavol Cervenak,6-1; 4-6; 6-1,R32,110,1,3,48,76,32,48,15,28,5,7,12,47,76,3,4,45,66,25,45,7,21,6,12,12,32,66
2012-07-09 00:00:00.000,Stuttgart Germany ATP World Tour 250,CLAY,2,Tobias Kamke,Flavio Cipolla,Tobias Kamke,6-3; 6-4,R32,82,0,7,33,58,26,33,12,25,4,5,9,38,58,1,3,39,58,24,39,8,19,3,7,10,32,58
2012-07-09 00:00:00.000,Stuttgart Germany ATP World Tour 250,CLAY,2,Juan Monaco,N/A Bye,Juan Monaco,,R32,0,0,0,0,0,0,0,0,0,0,0,0,0,0,0,0,0,0,0,0,0,0,0,0,0,0,0
2012-07-09 00:00:00.000,Stuttgart Germany ATP World Tour 250,CLAY,2,Janko Tipsarevic,Steve Darcis,Janko Tipsarevic,6-4; 6-2,R16,79,5,3,38,60,30,38,10,22,3,4,9,40,60,3,1,29,54,17,29,11,25,2,6,9,28,54
2012-07-09 00:00:00.000,Stuttgart Germany ATP World Tour 250,CLAY,2,Bjorn Phau,Lukas Rosol,Bjorn Phau,7-6(3); 7-6(2),R16,123,7,3,47,96,38,47,28,49,5,6,12,66,96,10,9,51,103,38,51,25,52,5,6,12,63,103
2012-07-09 00:00:00.000,Stuttgart Germany ATP World Tour 250,CLAY,2,Thomaz Bellucci,Bernard Tomic,Thomaz Bellucci,7-6(6); 6-3,R16,108,9,3,47,82,34,47,18,35,8,10,11,52,82,4,0,45,74,34,45,11,29,5,8,10,45,74
2012-07-09 00:00:00.000,Stuttgart Germany ATP World Tour 250,CLAY,2,Cedrik-Marcel Stebe,Jeremy Chardy,Cedrik-Marcel Stebe,4-6; 7-6(8); 6-3,R16,168,6,6,71,123,49,71,26,52,15,18,15,75,123,10,12,67,118,45,67,25,51,8,12,16,70,118
2012-07-09 00:00:00.000,Stuttgart Germany ATP World Tour 250,CLAY,2,Dustin Brown,Benoit Paire,Dustin Brown,7-6(4); 4-6; 6-1,R16,98,19,3,58,109,45,58,27,51,9,11,15,72,109,5,3,40,88,27,40,29,48,1,4,14,56,88
2012-07-09 00:00:00.000,Stuttgart Germany ATP World Tour 250,CLAY,2,Guillermo Garcia-Lopez,Pablo Andujar,Guillermo Garcia-Lopez,6-1; 4-6; 6-1,R16,127,1,5,36,73,27,36,17,37,3,6,12,44,73,1,10,40,79,22,40,16,39,8,15,12,38,79
2012-07-09 00:00:00.000,Stuttgart Germany ATP World Tour 250,CLAY,2,Pavol Cervenak,Tommy Haas,Pavol Cervenak,6-4; 6-4,R16,93,2,2,47,74,30,47,16,27,8,9,10,46,74,2,7,28,54,20,28,12,26,2,5,10,32,54
2012-07-09 00:00:00.000,Stuttgart Germany ATP World Tour 250,CLAY,2,Juan Monaco,Tobias Kamke,Juan Monaco,6-2; 6-3,R16,84,3,1,40,63,30,40,12,23,7,8,9,42,63,0,4,24,48,14,24,10,24,4,8,8,24,48
2012-07-09 00:00:00.000,Stuttgart Germany ATP World Tour 250,CLAY,2,Janko Tipsarevic,Bjorn Phau,Janko Tipsarevic,6-7(6); 7-6(2); 6-4,Q,177,7,2,63,118,41,63,31,55,8,12,17,72,118,5,10,69,132,44,69,31,63,11,16,17,75,132
2012-07-09 00:00:00.000,Stuttgart Germany ATP World Tour 250,CLAY,2,Thomaz Bellucci,Cedrik-Marcel Stebe,Thomaz Bellucci,6-4; 6-1,Q,70,1,2,25,48,17,25,15,23,0,1,8,32,48,1,3,30,54,17,30,9,24,4,9,9,26,54
2012-07-09 00:00:00.000,Stuttgart Germany ATP World Tour 250,CLAY,2,Guillermo Garcia-Lopez,Dustin Brown,Guillermo Garcia-Lopez,6-0; 6-3,Q,58,2,2,31,46,25,31,10,15,3,3,8,35,46,2,1,19,43,12,19,9,24,4,8,7,21,43
2012-07-09 00:00:00.000,Stuttgart Germany ATP World Tour 250,CLAY,2,Juan Monaco,Pavol Cervenak,Juan Monaco,6-1; 7-5,Q,96,2,3,37,58,25,37,8,21,3,7,10,33,58,3,7,31,61,16,31,8,30,3,10,9,24,61
2012-07-09 00:00:00.000,Stuttgart Germany ATP World Tour 250,CLAY,2,Janko Tipsarevic,Thomaz Bellucci,Janko Tipsarevic,6-4; 2-6; 6-4,S,123,3,5,42,85,32,42,20,43,4,7,14,52,85,9,6,40,72,34,40,17,32,3,6,14,51,72
2012-07-09 00:00:00.000,Stuttgart Germany ATP World Tour 250,CLAY,2,Juan Monaco,Guillermo Garcia-Lopez,Juan Monaco,6-3; 3-6; 7-5,S,160,1,1,57,94,37,57,21,37,0,3,15,58,94,0,6,56,106,40,56,23,50,9,13,15,63,106
2012-07-09 00:00:00.000,Stuttgart Germany ATP World Tour 250,CLAY,2,Janko Tipsarevic,Juan Monaco,Janko Tipsarevic,6-4; 5-7; 6-3,F,156,3,1,41,75,28,41,16,34,0,5,15,44,75,0,1,74,102,41,74,16,28,7,14,16,57,102
2012-07-09 00:00:00.000,Umag Croatia ATP World Tour 250,CLAY,2,Fernando Verdasco,N/A Bye,Fernando Verdasco,,R32,0,0,0,0,0,0,0,0,0,0,0,0,0,0,0,0,0,0,0,0,0,0,0,0,0,0,0
2012-07-09 00:00:00.000,Umag Croatia ATP World Tour 250,CLAY,2,Ernests Gulbis,Gorka Fraile,Ernests Gulbis,6-1; 6-3,R32,64,14,5,32,52,29,32,7,20,2,2,8,36,52,0,1,40,53,25,40,3,13,4,8,8,28,53
2012-07-09 00:00:00.000,Umag Croatia ATP World Tour 250,CLAY,2,Andrey Kuznetsov,Daniel Munoz-De La Nava,Andrey Kuznetsov,6-3; 5-7; 7-6(5),R32,177,7,8,71,111,51,71,17,40,2,6,17,68,111,0,9,75,133,49,75,28,58,17,21,16,77,133
2012-07-09 00:00:00.000,Umag Croatia ATP World Tour 250,CLAY,2,Mate Pavic,Juan Carlos Ferrero,Mate Pavic,6-2; 6-2,R32,61,5,3,34,55,25,34,12,21,4,4,8,37,55,0,2,19,42,12,19,8,23,2,6,8,20,42
2012-07-09 00:00:00.000,Umag Croatia ATP World Tour 250,CLAY,2,Marcel Granollers,N/A Bye,Marcel Granollers,,R32,0,0,0,0,0,0,0,0,0,0,0,0,0,0,0,0,0,0,0,0,0,0,0,0,0,0,0
2012-07-09 00:00:00.000,Umag Croatia ATP World Tour 250,CLAY,2,Potito Starace,Ivo Klec,Potito Starace,6-3; 7-6(6),R32,102,3,1,47,63,34,47,13,16,1,2,11,47,63,0,2,48,78,36,48,10,30,7,9,10,46,78
2012-07-09 00:00:00.000,Umag Croatia ATP World Tour 250,CLAY,2,Matthias Bachinger,Joao Sousa,Matthias Bachinger,6-7(5); 6-1; 7-6(6),R32,162,11,4,52,109,40,52,25,57,10,14,15,65,109,2,6,79,113,48,79,13,34,5,12,16,61,113
2012-07-09 00:00:00.000,Umag Croatia ATP World Tour 250,CLAY,2,Martin Klizan,Aljaz Bedene,Martin Klizan,6-2; 6-2,R32,77,2,3,23,47,18,23,14,24,1,2,8,32,47,1,6,27,55,18,27,7,28,4,9,8,25,55
2012-07-09 00:00:00.000,Umag Croatia ATP World Tour 250,CLAY,2,Carlos Berlocq,Ivan Dodig,Carlos Berlocq,6-4; 6-0,R32,85,1,1,30,39,25,30,7,9,0,0,8,32,39,3,1,29,54,16,29,11,25,2,6,8,27,54
2012-07-09 00:00:00.000,Umag Croatia ATP World Tour 250,CLAY,2,Marco Trungelliti,Paolo Lorenzi,Marco Trungelliti,7-5; 6-4,R32,127,1,5,44,77,27,44,18,33,5,8,11,45,77,2,1,44,67,24,44,13,23,6,11,11,37,67
2012-07-09 00:00:00.000,Umag Croatia ATP World Tour 250,CLAY,2,Fabio Fognini,Karol Beck,Fabio Fognini,6-3; 6-1,R32,61,1,2,26,40,22,26,10,14,0,0,8,32,40,0,7,31,59,16,31,13,28,4,8,8,29,59
2012-07-09 00:00:00.000,Umag Croatia ATP World Tour 250,CLAY,2,Alexandr Dolgopolov,N/A Bye,Alexandr Dolgopolov,,R32,0,0,0,0,0,0,0,0,0,0,0,0,0,0,0,0,0,0,0,0,0,0,0,0,0,0,0
2012-07-09 00:00:00.000,Umag Croatia ATP World Tour 250,CLAY,2,Wayne Odesnik,Edouard Roger-Vasselin,Wayne Odesnik,6-7(4); 6-2; 7-5,R32,173,6,5,66,110,45,66,27,44,7,9,16,72,110,4,5,59,106,40,59,25,47,3,8,16,65,106
2012-07-09 00:00:00.000,Umag Croatia ATP World Tour 250,CLAY,2,Blaz Kavcic,Antonio Veic,Blaz Kavcic,6-2; 6-2,R32,75,0,1,26,40,19,26,10,14,0,1,8,29,40,0,2,27,44,13,27,6,17,2,7,8,19,44
2012-07-09 00:00:00.000,Umag Croatia ATP World Tour 250,CLAY,2,Daniel Brands,Walter Trusendi,Daniel Brands,6-1; 7-6(8),R32,107,3,3,39,67,28,39,13,28,2,4,9,41,67,4,5,52,75,31,52,7,23,5,10,10,38,75
2012-07-09 00:00:00.000,Umag Croatia ATP World Tour 250,CLAY,2,Marin Cilic,N/A Bye,Marin Cilic,,R32,0,0,0,0,0,0,0,0,0,0,0,0,0,0,0,0,0,0,0,0,0,0,0,0,0,0,0
2012-07-09 00:00:00.000,Umag Croatia ATP World Tour 250,CLAY,2,Fernando Verdasco,Ernests Gulbis,Fernando Verdasco,6-2; 3-6; 6-1,R16,126,4,6,48,75,40,48,11,27,4,6,12,51,75,8,9,47,91,31,47,19,44,13,18,12,50,91
2012-07-09 00:00:00.000,Umag Croatia ATP World Tour 250,CLAY,2,Andrey Kuznetsov,Mate Pavic,Andrey Kuznetsov,7-6(0); 6-1,R16,89,2,3,31,60,25,31,18,29,2,3,10,43,60,6,2,44,70,28,44,9,26,4,7,9,37,70
2012-07-09 00:00:00.000,Umag Croatia ATP World Tour 250,CLAY,2,Marcel Granollers,Potito Starace,Marcel Granollers,6-4; 3-6; 6-3,R16,146,3,2,55,82,42,55,10,27,5,8,14,52,82,0,1,64,98,39,64,17,34,12,16,14,56,98
2012-07-09 00:00:00.000,Umag Croatia ATP World Tour 250,CLAY,2,Matthias Bachinger,Martin Klizan,Matthias Bachinger,6-0; 2-6; 6-4,R16,114,8,1,39,75,28,39,16,36,5,8,12,44,75,3,5,46,80,28,46,14,34,8,13,12,42,80
2012-07-09 00:00:00.000,Umag Croatia ATP World Tour 250,CLAY,2,Carlos Berlocq,Marco Trungelliti,Carlos Berlocq,7-6(4); 4-6; 6-1,R16,187,2,5,68,103,41,68,14,35,6,12,14,55,103,2,4,34,89,20,34,24,55,6,14,15,44,89
2012-07-09 00:00:00.000,Umag Croatia ATP World Tour 250,CLAY,2,Alexandr Dolgopolov,Fabio Fognini,Alexandr Dolgopolov,6-2; 6-4,R16,76,1,0,30,56,24,30,15,26,2,2,9,39,56,1,2,43,62,27,43,9,19,3,6,9,36,62
2012-07-09 00:00:00.000,Umag Croatia ATP World Tour 250,CLAY,2,Wayne Odesnik,Blaz Kavcic,Wayne Odesnik,3-6; 7-5; 7-6(3),R16,188,2,7,70,120,42,70,21,50,11,19,17,63,120,3,3,54,96,33,54,18,42,3,10,16,51,96
2012-07-09 00:00:00.000,Umag Croatia ATP World Tour 250,CLAY,2,Marin Cilic,Daniel Brands,Marin Cilic,6-3; 6-2,R16,65,6,0,29,52,21,29,14,23,2,3,9,35,52,2,2,28,42,16,28,5,14,1,5,8,21,42
2012-07-09 00:00:00.000,Umag Croatia ATP World Tour 250,CLAY,2,Fernando Verdasco,Andrey Kuznetsov,Fernando Verdasco,6-2; 6-2,Q,85,2,3,45,61,36,45,6,16,6,6,8,42,61,2,5,40,62,24,40,7,22,3,7,8,31,62
2012-07-09 00:00:00.000,Umag Croatia ATP World Tour 250,CLAY,2,Marcel Granollers,Matthias Bachinger,Marcel Granollers,1-6; 6-3; 7-5,Q,137,0,2,50,79,39,50,16,29,7,10,14,55,79,3,4,51,96,42,51,17,45,10,13,14,59,96
2012-07-09 00:00:00.000,Umag Croatia ATP World Tour 250,CLAY,2,Alexandr Dolgopolov,Carlos Berlocq,Alexandr Dolgopolov,6-4; 6-4,Q,84,4,2,28,60,24,28,18,32,4,5,10,42,60,4,2,45,64,28,45,10,19,1,4,10,38,64
2012-07-09 00:00:00.000,Umag Croatia ATP World Tour 250,CLAY,2,Marin Cilic,Wayne Odesnik,Marin Cilic,6-4; 6-0,Q,92,8,2,39,65,29,39,11,26,5,6,8,40,65,0,3,34,53,16,34,7,19,3,8,8,23,53
2012-07-09 00:00:00.000,Umag Croatia ATP World Tour 250,CLAY,2,Marcel Granollers,Fernando Verdasco,Marcel Granollers,6-2; 6-7(5); 6-1,S,172,5,2,58,94,37,58,23,36,0,2,14,60,94,3,5,71,100,38,71,17,29,9,15,13,55,100
2012-07-09 00:00:00.000,Umag Croatia ATP World Tour 250,CLAY,2,Marin Cilic,Alexandr Dolgopolov,Marin Cilic,7-5; 6-2,S,81,1,2,26,59,17,26,21,33,0,2,10,38,59,1,4,25,55,15,25,13,30,4,9,10,28,55
2012-07-09 00:00:00.000,Umag Croatia ATP World Tour 250,CLAY,2,Marin Cilic,Marcel Granollers,Marin Cilic,6-4; 6-2,F,92,0,1,32,53,22,32,12,21,1,3,9,34,53,1,2,28,49,17,28,7,21,2,7,9,24,49
2012-07-16 00:00:00.000,Atlanta GA; USA ATP World Tour 250,HARD,2,John Isner,N/A Bye,John Isner,,R32,0,0,0,0,0,0,0,0,0,0,0,0,0,0,0,0,0,0,0,0,0,0,0,0,0,0,0
2012-07-16 00:00:00.000,Atlanta GA; USA ATP World Tour 250,HARD,2,Ruben Bemelmans,Rajeev Ram,Ruben Bemelmans,6-1; 6-3,R32,62,0,2,23,48,17,23,16,25,3,4,8,33,48,1,4,22,46,15,22,6,24,6,11,8,21,46
2012-07-16 00:00:00.000,Atlanta GA; USA ATP World Tour 250,HARD,2,Steve Johnson,Donald Young,Steve Johnson,6-3; 3-6; 6-3,R32,129,10,9,57,108,42,57,23,51,10,12,14,65,108,5,7,46,83,32,46,19,37,3,6,13,51,83
2012-07-16 00:00:00.000,Atlanta GA; USA ATP World Tour 250,HARD,2,Jack Sock,Alex Bogomolov Jr.,Jack Sock,6-2; 4-6; 6-4,R32,135,8,8,51,98,38,51,24,47,10,12,14,62,98,3,2,64,86,41,64,12,22,7,11,14,53,86
2012-07-16 00:00:00.000,Atlanta GA; USA ATP World Tour 250,HARD,2,Andy Roddick,N/A Bye,Andy Roddick,,R32,0,0,0,0,0,0,0,0,0,0,0,0,0,0,0,0,0,0,0,0,0,0,0,0,0,0,0
2012-07-16 00:00:00.000,Atlanta GA; USA ATP World Tour 250,HARD,2,Nicolas Mahut,Paul Capdeville,Nicolas Mahut,6-3; 3-6; 6-4,R32,120,12,3,42,78,32,42,16,36,3,7,14,48,78,6,7,59,107,40,59,18,48,13,18,14,58,107
2012-07-16 00:00:00.000,Atlanta GA; USA ATP World Tour 250,HARD,2,Michael Russell,Alex Kuznetsov,Michael Russell,2-6; 6-4; 7-6(4),R32,139,1,4,52,87,37,52,20,35,2,6,15,57,87,14,4,68,99,51,68,13,31,9,12,15,64,99
2012-07-16 00:00:00.000,Atlanta GA; USA ATP World Tour 250,HARD,2,Kevin Anderson,Paolo Lorenzi,Kevin Anderson,6-4; 6-3,R32,84,7,2,37,58,28,37,16,21,3,3,10,44,58,2,2,29,56,21,29,15,27,3,5,9,36,56
2012-07-16 00:00:00.000,Atlanta GA; USA ATP World Tour 250,HARD,2,Go Soeda,Xavier Malisse,Go Soeda,4-6; 7-5; 6-4,R32,152,9,2,61,108,47,61,25,47,2,3,16,72,108,14,2,48,98,35,48,32,50,7,9,16,67,98
2012-07-16 00:00:00.000,Atlanta GA; USA ATP World Tour 250,HARD,2,Igor Kunitsyn,Brian Baker,Igor Kunitsyn,6-4; 6-7(3); 6-3,R32,141,7,4,54,106,39,54,27,52,4,6,16,66,106,6,4,67,101,44,67,17,34,4,8,15,61,101
2012-07-16 00:00:00.000,Atlanta GA; USA ATP World Tour 250,HARD,2,Ricardas Berankis,Dmitry Tursunov,Ricardas Berankis,6-3; 6-2,R32,76,6,5,25,55,20,25,15,30,1,2,8,35,55,3,4,27,62,20,27,11,35,6,11,9,31,62
2012-07-16 00:00:00.000,Atlanta GA; USA ATP World Tour 250,HARD,2,Kei Nishikori,N/A Bye,Kei Nishikori,,R32,0,0,0,0,0,0,0,0,0,0,0,0,0,0,0,0,0,0,0,0,0,0,0,0,0,0,0
2012-07-16 00:00:00.000,Atlanta GA; USA ATP World Tour 250,HARD,2,James Blake,Ryan Harrison,James Blake,1-6; 6-3; 7-5,R32,106,0,3,55,91,37,55,17,36,2,6,14,54,91,5,3,43,86,29,43,22,43,5,9,14,51,86
2012-07-16 00:00:00.000,Atlanta GA; USA ATP World Tour 250,HARD,2,Matthew Ebden,Sergei Bubka,Matthew Ebden,5-7; 6-1; 6-1,R32,92,8,4,48,74,34,48,15,26,0,2,13,49,74,4,5,44,81,31,44,10,37,4,10,13,41,81
2012-07-16 00:00:00.000,Atlanta GA; USA ATP World Tour 250,HARD,2,Gilles Muller,Marinko Matosevic,Gilles Muller,7-6(5); 6-4,R32,112,14,2,48,73,37,48,11,25,7,9,11,48,73,5,0,48,77,34,48,10,29,5,8,11,44,77
2012-07-16 00:00:00.000,Atlanta GA; USA ATP World Tour 250,HARD,2,Mardy Fish,N/A Bye,Mardy Fish,,R32,0,0,0,0,0,0,0,0,0,0,0,0,0,0,0,0,0,0,0,0,0,0,0,0,0,0,0
2012-07-16 00:00:00.000,Atlanta GA; USA ATP World Tour 250,HARD,2,John Isner,Ruben Bemelmans,John Isner,4-6; 6-3; 6-4,R16,115,16,5,51,86,43,51,17,35,1,2,15,60,86,1,4,50,84,36,50,19,34,2,4,14,55,84
2012-07-16 00:00:00.000,Atlanta GA; USA ATP World Tour 250,HARD,2,Jack Sock,Steve Johnson,Jack Sock,7-6(5); 7-6(5),R16,119,11,4,38,77,33,38,29,39,2,2,12,62,77,8,5,57,93,49,57,17,36,3,3,12,66,93
2012-07-16 00:00:00.000,Atlanta GA; USA ATP World Tour 250,HARD,2,Andy Roddick,Nicolas Mahut,Andy Roddick,7-6(4); 6-3,R16,98,10,1,50,75,38,50,14,25,4,5,11,52,75,15,1,38,63,31,38,11,25,2,4,10,42,63
2012-07-16 00:00:00.000,Atlanta GA; USA ATP World Tour 250,HARD,2,Michael Russell,Kevin Anderson,Michael Russell,6-7(5); 6-4; 6-4,R16,162,2,2,58,105,46,58,23,47,2,3,16,69,105,10,5,65,100,46,65,19,35,4,7,16,65,100
2012-07-16 00:00:00.000,Atlanta GA; USA ATP World Tour 250,HARD,2,Go Soeda,Igor Kunitsyn,Go Soeda,6-1; 7-5,R16,91,6,3,28,59,22,28,15,31,0,2,10,37,59,2,1,28,67,17,28,17,39,8,13,9,34,67
2012-07-16 00:00:00.000,Atlanta GA; USA ATP World Tour 250,HARD,2,Kei Nishikori,Ricardas Berankis,Kei Nishikori,6-4; 6-7(7); 6-4,R16,163,4,4,64,102,43,64,22,38,4,7,16,65,102,4,8,81,135,51,81,25,54,8,13,16,76,135
2012-07-16 00:00:00.000,Atlanta GA; USA ATP World Tour 250,HARD,2,Matthew Ebden,James Blake,Matthew Ebden,6-7(6); 6-4; 6-4,R16,126,20,6,49,89,43,49,22,40,0,2,16,65,89,8,4,67,117,52,67,19,50,3,7,16,71,117
2012-07-16 00:00:00.000,Atlanta GA; USA ATP World Tour 250,HARD,2,Gilles Muller,Mardy Fish,Gilles Muller,4-6; 2-3 RET,R16,79,9,1,21,37,18,21,6,16,0,2,7,24,37,4,1,23,54,17,23,17,31,6,7,8,34,54
2012-07-16 00:00:00.000,Atlanta GA; USA ATP World Tour 250,HARD,2,John Isner,Jack Sock,John Isner,7-6(7); 6-4,Q,135,12,1,47,79,37,47,18,32,3,4,11,55,79,7,7,45,87,31,45,23,42,8,10,11,54,87
2012-07-16 00:00:00.000,Atlanta GA; USA ATP World Tour 250,HARD,2,Andy Roddick,Michael Russell,Andy Roddick,6-3; 6-4,Q,73,12,1,37,51,32,37,10,14,1,1,10,42,51,8,1,26,44,20,26,11,18,2,4,9,31,44
2012-07-16 00:00:00.000,Atlanta GA; USA ATP World Tour 250,HARD,2,Go Soeda,Kei Nishikori,Go Soeda,6-2; 6-1,Q,73,1,0,27,61,21,27,19,34,7,7,8,40,61,2,1,23,35,10,23,6,12,0,4,7,16,35
2012-07-16 00:00:00.000,Atlanta GA; USA ATP World Tour 250,HARD,2,Gilles Muller,Matthew Ebden,Gilles Muller,6-4; 6-4,Q,72,12,4,35,54,32,35,9,19,0,0,10,41,54,11,1,45,58,32,45,5,13,3,5,10,37,58
2012-07-16 00:00:00.000,Atlanta GA; USA ATP World Tour 250,HARD,2,Andy Roddick,John Isner,Andy Roddick,6-4; 6-7(5); 6-4,S,148,7,1,60,92,53,60,19,32,2,2,16,72,92,26,0,63,99,51,63,19,36,5,7,16,70,99
2012-07-16 00:00:00.000,Atlanta GA; USA ATP World Tour 250,HARD,2,Gilles Muller,Go Soeda,Gilles Muller,6-4; 6-3,S,73,17,1,35,47,33,35,7,12,0,0,10,40,47,2,4,31,56,21,31,12,25,3,5,9,33,56
2012-07-16 00:00:00.000,Atlanta GA; USA ATP World Tour 250,HARD,2,Andy Roddick,Gilles Muller,Andy Roddick,1-6; 7-6(2); 6-2,F,134,18,4,52,86,39,52,19,34,1,3,13,58,86,20,10,48,84,42,48,15,36,4,6,14,57,84
2012-07-16 00:00:00.000,Gstaad Switzerland ATP World Tour 250,CLAY,2,Janko Tipsarevic,N/A Bye,Janko Tipsarevic,,R32,0,0,0,0,0,0,0,0,0,0,0,0,0,0,0,0,0,0,0,0,0,0,0,0,0,0,0
2012-07-16 00:00:00.000,Gstaad Switzerland ATP World Tour 250,CLAY,2,Martin Fischer,Sandro Ehrat,Martin Fischer,6-2; 6-4,R32,75,0,0,22,54,16,22,19,32,1,3,9,35,54,3,2,19,46,11,19,11,27,1,6,9,22,46
2012-07-16 00:00:00.000,Gstaad Switzerland ATP World Tour 250,CLAY,2,Jan Hernych,Matteo Viola,Jan Hernych,6-3; 2-6; 6-3,R32,119,2,5,54,95,36,54,18,41,10,14,13,54,95,2,5,50,89,28,50,20,39,5,10,13,48,89
2012-07-16 00:00:00.000,Gstaad Switzerland ATP World Tour 250,CLAY,2,Santiago Giraldo,Henri Laaksonen,Santiago Giraldo,6-2; 6-2,R32,69,1,0,36,50,28,36,7,14,5,5,8,35,50,4,4,17,54,13,17,13,37,3,7,8,26,54
2012-07-16 00:00:00.000,Gstaad Switzerland ATP World Tour 250,CLAY,2,Stan Wawrinka,N/A Bye,Stan Wawrinka,,R32,0,0,0,0,0,0,0,0,0,0,0,0,0,0,0,0,0,0,0,0,0,0,0,0,0,0,0
2012-07-16 00:00:00.000,Gstaad Switzerland ATP World Tour 250,CLAY,2,Paul-Henri Mathieu,Igor Andreev,Paul-Henri Mathieu,6-3; 7-6(4),R32,132,6,10,64,112,48,64,22,48,7,7,11,70,112,4,1,51,78,36,51,13,27,1,2,10,49,78
2012-07-16 00:00:00.000,Gstaad Switzerland ATP World Tour 250,CLAY,2,Ernests Gulbis,Filippo Volandri,Ernests Gulbis,7-6(2); 4-6; 6-3,R32,110,18,7,57,99,46,57,20,42,3,6,15,66,99,0,6,67,102,46,67,17,35,6,10,16,63,102
2012-07-16 00:00:00.000,Gstaad Switzerland ATP World Tour 250,CLAY,2,Benoit Paire,Bernard Tomic,Benoit Paire,6-0; 6-4,R32,60,4,3,23,53,14,23,19,30,2,3,8,33,53,2,3,37,61,20,37,8,24,3,8,8,28,61
2012-07-16 00:00:00.000,Gstaad Switzerland ATP World Tour 250,CLAY,2,Feliciano Lopez,Adrian Ungur,Feliciano Lopez,2-6; 6-4; 7-6(7),R32,124,14,2,52,92,45,52,19,40,3,5,15,64,92,6,3,48,93,36,48,26,45,2,3,15,62,93
2012-07-16 00:00:00.000,Gstaad Switzerland ATP World Tour 250,CLAY,2,Jan Hajek,Edouard Roger-Vasselin,Jan Hajek,4-1 RET,R32,24,0,0,5,8,5,5,3,3,0,0,2,8,8,1,5,16,31,10,16,4,15,3,5,3,14,31
2012-07-16 00:00:00.000,Gstaad Switzerland ATP World Tour 250,CLAY,2,Thomaz Bellucci,Blaz Kavcic,Thomaz Bellucci,6-1; 6-1,R32,60,3,1,19,36,17,19,11,17,0,0,7,28,36,2,2,28,49,11,28,10,21,4,9,7,21,49
2012-07-16 00:00:00.000,Gstaad Switzerland ATP World Tour 250,CLAY,2,Mikhail Youzhny,N/A Bye,Mikhail Youzhny,,R32,0,0,0,0,0,0,0,0,0,0,0,0,0,0,0,0,0,0,0,0,0,0,0,0,0,0,0
2012-07-16 00:00:00.000,Gstaad Switzerland ATP World Tour 250,CLAY,2,Grigor Dimitrov,Julien Benneteau,Grigor Dimitrov,3-6; 6-4; 6-1,R32,104,9,4,44,75,33,44,19,31,4,6,13,52,75,4,2,52,87,35,52,15,35,5,9,13,50,87
2012-07-16 00:00:00.000,Gstaad Switzerland ATP World Tour 250,CLAY,2,Dustin Brown,Sergiy Stakhovsky,Dustin Brown,3-6; 6-4; 7-6(8),R32,123,10,5,58,112,41,58,28,54,8,12,15,69,112,11,6,56,101,39,56,25,45,3,7,16,64,101
2012-07-16 00:00:00.000,Gstaad Switzerland ATP World Tour 250,CLAY,2,Lukasz Kubot,Ivan Dodig,Lukasz Kubot,3-6; 6-3; 6-4,R32,131,1,0,52,80,39,52,10,28,3,7,14,49,80,6,5,48,85,35,48,12,37,5,10,14,47,85
2012-07-16 00:00:00.000,Gstaad Switzerland ATP World Tour 250,CLAY,2,Marcel Granollers,N/A Bye,Marcel Granollers,,R32,0,0,0,0,0,0,0,0,0,0,0,0,0,0,0,0,0,0,0,0,0,0,0,0,0,0,0
2012-07-16 00:00:00.000,Gstaad Switzerland ATP World Tour 250,CLAY,2,Janko Tipsarevic,Martin Fischer,Janko Tipsarevic,4-6; 7-6(1); 6-3,R16,158,8,2,43,97,30,43,34,54,7,11,16,64,97,2,4,65,120,44,65,26,55,12,16,15,70,120
2012-07-16 00:00:00.000,Gstaad Switzerland ATP World Tour 250,CLAY,2,Jan Hernych,Santiago Giraldo,Jan Hernych,6-3; 2-6; 6-4,R16,112,3,4,63,103,35,63,24,40,15,19,14,59,103,5,0,52,84,30,52,20,32,4,8,13,50,84
2012-07-16 00:00:00.000,Gstaad Switzerland ATP World Tour 250,CLAY,2,Paul-Henri Mathieu,Stan Wawrinka,Paul-Henri Mathieu,7-6(3); 7-6(8),R16,124,2,3,50,90,38,50,20,40,7,9,12,58,90,10,3,45,87,34,45,19,42,4,6,12,53,87
2012-07-16 00:00:00.000,Gstaad Switzerland ATP World Tour 250,CLAY,2,Ernests Gulbis,Benoit Paire,Ernests Gulbis,5-7; 7-6(3); 6-4,R16,129,11,6,68,120,49,68,27,52,15,17,17,76,120,7,2,46,96,37,46,28,50,1,3,17,65,96
2012-07-16 00:00:00.000,Gstaad Switzerland ATP World Tour 250,CLAY,2,Feliciano Lopez,Jan Hajek,Feliciano Lopez,6-7(3); 6-1; 6-4,R16,109,12,3,52,87,45,52,19,35,4,5,15,64,87,10,4,65,90,46,65,10,25,1,5,14,56,90
2012-07-16 00:00:00.000,Gstaad Switzerland ATP World Tour 250,CLAY,2,Thomaz Bellucci,Mikhail Youzhny,Thomaz Bellucci,4-6; 6-2; 6-4,R16,129,8,9,51,89,40,51,18,38,4,6,14,58,89,6,7,59,93,44,59,10,34,9,13,14,54,93
2012-07-16 00:00:00.000,Gstaad Switzerland ATP World Tour 250,CLAY,2,Grigor Dimitrov,Dustin Brown,Grigor Dimitrov,7-6(3); 3-6; 6-2,R16,95,6,3,52,85,44,52,19,33,1,2,14,63,85,9,2,46,87,37,46,21,41,1,3,15,58,87
2012-07-16 00:00:00.000,Gstaad Switzerland ATP World Tour 250,CLAY,2,Lukasz Kubot,Marcel Granollers,Lukasz Kubot,6-4; 6-2,R16,96,1,4,36,55,27,36,11,19,2,3,9,38,55,1,0,38,54,21,38,7,16,5,9,9,28,54
2012-07-16 00:00:00.000,Gstaad Switzerland ATP World Tour 250,CLAY,2,Janko Tipsarevic,Jan Hernych,Janko Tipsarevic,6-2; 6-1,Q,63,7,0,34,53,25,34,11,19,2,2,7,36,53,2,3,28,55,15,28,10,27,4,9,8,25,55
2012-07-16 00:00:00.000,Gstaad Switzerland ATP World Tour 250,CLAY,2,Paul-Henri Mathieu,Ernests Gulbis,Paul-Henri Mathieu,4-6; 6-1; 6-4,Q,106,3,4,44,88,35,44,25,44,1,2,14,60,88,10,2,40,71,30,40,15,31,2,5,13,45,71
2012-07-16 00:00:00.000,Gstaad Switzerland ATP World Tour 250,CLAY,2,Thomaz Bellucci,Feliciano Lopez,Thomaz Bellucci,6-3; 6-3,Q,86,10,1,35,66,27,35,14,31,1,2,9,41,66,5,7,36,66,26,36,7,30,4,8,9,33,66
2012-07-16 00:00:00.000,Gstaad Switzerland ATP World Tour 250,CLAY,2,Grigor Dimitrov,Lukasz Kubot,Grigor Dimitrov,6-3; 6-2,Q,62,5,1,31,47,25,31,12,16,1,1,9,37,47,0,2,42,53,27,42,2,11,5,8,8,29,53
2012-07-16 00:00:00.000,Gstaad Switzerland ATP World Tour 250,CLAY,2,Janko Tipsarevic,Paul-Henri Mathieu,Janko Tipsarevic,7-6(10); 6-3,S,124,8,1,47,83,34,47,22,36,2,3,11,56,83,5,2,47,85,34,47,16,38,6,8,10,50,85
2012-07-16 00:00:00.000,Gstaad Switzerland ATP World Tour 250,CLAY,2,Thomaz Bellucci,Grigor Dimitrov,Thomaz Bellucci,7-6(3); 7-6(5),S,115,4,2,56,90,46,56,16,34,5,7,12,62,90,4,3,54,81,42,54,12,27,4,6,12,54,81
2012-07-16 00:00:00.000,Gstaad Switzerland ATP World Tour 250,CLAY,2,Thomaz Bellucci,Janko Tipsarevic,Thomaz Bellucci,6-7(6); 6-4; 6-2,F,145,10,1,51,93,41,51,20,42,0,2,15,61,93,4,2,58,100,40,58,19,42,6,11,15,59,100
2012-07-16 00:00:00.000,Hamburg Germany ATP World Tour 500,CLAY,2,Nicolas Almagro,Tobias Kamke,Nicolas Almagro,6-4; 6-1,R32,73,2,4,28,64,17,28,19,36,6,8,8,36,64,1,2,30,49,11,30,7,19,4,10,9,18,49
2012-07-16 00:00:00.000,Hamburg Germany ATP World Tour 500,CLAY,2,Nikolay Davydenko,Jarkko Nieminen,Nikolay Davydenko,5-7; 6-4; 6-0,R32,118,6,3,63,85,40,63,13,22,7,11,14,53,85,4,2,69,100,38,69,12,31,7,14,14,50,100
2012-07-16 00:00:00.000,Hamburg Germany ATP World Tour 500,CLAY,2,Fabio Fognini,Marsel Ilhan,Fabio Fognini,7-5; 6-2,R32,94,2,1,46,62,35,46,7,16,2,3,10,42,62,3,3,52,84,36,52,8,32,9,13,10,44,84
2012-07-16 00:00:00.000,Hamburg Germany ATP World Tour 500,CLAY,2,Philipp Kohlschreiber,Bjorn Phau,Philipp Kohlschreiber,4-6; 6-2; 6-3,R32,109,8,2,62,91,44,62,15,29,1,3,14,59,91,2,1,41,78,27,41,21,37,2,6,13,48,78
2012-07-16 00:00:00.000,Hamburg Germany ATP World Tour 500,CLAY,2,Juan Monaco,Cedrik-Marcel Stebe,Juan Monaco,6-4; 3-6; 7-5,R32,162,2,0,59,87,39,59,13,28,7,12,15,52,87,2,2,63,99,36,63,19,36,6,12,16,55,99
2012-07-16 00:00:00.000,Hamburg Germany ATP World Tour 500,CLAY,2,Daniel Munoz-De La Nava,Ruben Ramirez Hidalgo,Daniel Munoz-De La Nava,1-6; 6-4; 6-3,R32,153,2,1,56,86,39,56,13,30,4,7,13,52,86,3,2,68,110,43,68,20,42,13,16,13,63,110
2012-07-16 00:00:00.000,Hamburg Germany ATP World Tour 500,CLAY,2,Jeremy Chardy,Albert Montanes,Jeremy Chardy,6-4; 6-2,R32,68,4,3,31,47,23,31,11,16,0,1,9,34,47,2,4,28,52,18,28,12,24,5,9,9,30,52
2012-07-16 00:00:00.000,Hamburg Germany ATP World Tour 500,CLAY,2,Julian Reister,Fernando Verdasco,Julian Reister,6-2; 6-3,R32,65,5,2,28,49,24,28,14,21,0,0,9,38,49,2,6,34,50,21,34,6,16,3,6,8,27,50
2012-07-16 00:00:00.000,Hamburg Germany ATP World Tour 500,CLAY,2,Lukas Rosol,Viktor Troicki,Lukas Rosol,5-7; 6-3; 6-4,R32,117,6,1,67,103,49,67,16,36,5,8,16,65,103,9,2,53,98,42,53,16,45,2,6,15,58,98
2012-07-16 00:00:00.000,Hamburg Germany ATP World Tour 500,CLAY,2,Albert Ramos-Vinolas,Pablo Andujar,Albert Ramos-Vinolas,6-1; 6-4,R32,90,0,4,33,57,18,33,13,24,6,9,8,31,57,1,6,27,54,10,27,10,27,2,9,9,20,54
2012-07-16 00:00:00.000,Hamburg Germany ATP World Tour 500,CLAY,2,Federico Delbonis,Tommy Robredo,Federico Delbonis,5-7; 6-0; 6-1,R32,106,4,5,51,78,35,51,17,27,2,4,13,52,78,1,1,43,65,21,43,13,22,1,7,12,34,65
2012-07-16 00:00:00.000,Hamburg Germany ATP World Tour 500,CLAY,2,Marin Cilic,Flavio Cipolla,Marin Cilic,6-3; 6-4,R32,90,1,1,33,54,23,33,13,21,3,5,10,36,54,0,5,46,66,29,46,6,20,5,9,9,35,66
2012-07-16 00:00:00.000,Hamburg Germany ATP World Tour 500,CLAY,2,Florian Mayer,Horacio Zeballos,Florian Mayer,7-6(7); 7-5,R32,117,5,1,60,87,36,60,12,27,3,8,12,48,87,2,5,52,88,31,52,12,36,7,13,12,43,88
2012-07-16 00:00:00.000,Hamburg Germany ATP World Tour 500,CLAY,2,Robin Haase,Matthias Bachinger,Robin Haase,6-4; 6-2,R32,64,5,0,32,46,27,32,9,14,0,0,9,36,46,4,3,30,56,24,30,9,26,1,4,9,33,56
2012-07-16 00:00:00.000,Hamburg Germany ATP World Tour 500,CLAY,2,Tommy Haas,Martin Klizan,Tommy Haas,6-2; 6-1,R32,69,4,0,33,50,26,33,9,17,1,1,8,35,50,1,2,19,43,11,19,10,24,2,6,7,21,43
2012-07-16 00:00:00.000,Hamburg Germany ATP World Tour 500,CLAY,2,Gilles Simon,Carlos Berlocq,Gilles Simon,4-6; 7-6(5); 6-1,R32,172,0,0,57,102,39,57,22,45,10,14,14,61,102,0,2,79,105,44,79,14,26,8,14,15,58,105
2012-07-16 00:00:00.000,Hamburg Germany ATP World Tour 500,CLAY,2,Nicolas Almagro,Nikolay Davydenko,Nicolas Almagro,6-4; 6-3,R16,78,2,3,35,59,29,35,9,24,1,3,10,38,59,1,4,38,61,24,38,9,23,6,10,9,33,61
2012-07-16 00:00:00.000,Hamburg Germany ATP World Tour 500,CLAY,2,Philipp Kohlschreiber,Fabio Fognini,Philipp Kohlschreiber,7-5; 6-2,R16,83,2,2,26,52,23,26,14,26,0,2,10,37,52,1,1,44,71,25,44,10,27,6,11,10,35,71
2012-07-16 00:00:00.000,Hamburg Germany ATP World Tour 500,CLAY,2,Juan Monaco,Daniel Munoz-De La Nava,Juan Monaco,7-6(4); 6-3,R16,117,1,1,47,67,29,47,6,20,3,8,10,35,67,2,2,46,75,26,46,8,29,5,12,11,34,75
2012-07-16 00:00:00.000,Hamburg Germany ATP World Tour 500,CLAY,2,Jeremy Chardy,Julian Reister,Jeremy Chardy,7-5; 6-4,R16,97,3,0,49,76,37,49,15,27,5,6,11,52,76,2,1,46,64,27,46,11,18,1,4,11,38,64
2012-07-16 00:00:00.000,Hamburg Germany ATP World Tour 500,CLAY,2,Albert Ramos-Vinolas,Lukas Rosol,Albert Ramos-Vinolas,7-6(8); 4-6; 6-3,R16,151,5,5,66,99,51,66,16,33,4,6,16,67,99,7,2,72,112,51,72,21,40,4,6,15,72,112
2012-07-16 00:00:00.000,Hamburg Germany ATP World Tour 500,CLAY,2,Marin Cilic,Federico Delbonis,Marin Cilic,6-3; 6-2,R16,81,3,0,32,63,26,32,16,31,1,1,9,42,63,2,1,30,44,19,30,5,14,1,4,8,24,44
2012-07-16 00:00:00.000,Hamburg Germany ATP World Tour 500,CLAY,2,Florian Mayer,Robin Haase,Florian Mayer,6-2; 6-1,R16,56,3,1,21,34,19,21,9,13,0,0,7,28,34,2,4,41,60,23,41,4,19,1,6,8,27,60
2012-07-16 00:00:00.000,Hamburg Germany ATP World Tour 500,CLAY,2,Tommy Haas,Gilles Simon,Tommy Haas,4-6; 6-3; 6-4,R16,126,3,2,53,85,36,53,17,32,3,7,15,53,85,3,4,45,84,28,45,19,39,2,7,14,47,84
2012-07-16 00:00:00.000,Hamburg Germany ATP World Tour 500,CLAY,2,Nicolas Almagro,Philipp Kohlschreiber,Nicolas Almagro,7-5; 7-5,Q,97,5,3,27,60,20,27,21,33,1,4,12,41,60,3,3,36,81,24,36,20,45,5,10,12,44,81
2012-07-16 00:00:00.000,Hamburg Germany ATP World Tour 500,CLAY,2,Juan Monaco,Jeremy Chardy,Juan Monaco,6-3; 7-5,Q,97,0,1,42,55,30,42,7,13,2,4,10,37,55,4,3,44,76,27,44,12,32,4,9,11,39,76
2012-07-16 00:00:00.000,Hamburg Germany ATP World Tour 500,CLAY,2,Marin Cilic,Albert Ramos-Vinolas,Marin Cilic,6-4; 7-6(5),Q,117,8,2,41,70,29,41,13,29,2,5,11,42,70,0,3,44,73,25,44,13,29,3,7,11,38,73
2012-07-16 00:00:00.000,Hamburg Germany ATP World Tour 500,CLAY,2,Tommy Haas,Florian Mayer,Tommy Haas,6-1; 6-4,Q,71,4,1,36,59,27,36,14,23,3,3,9,41,59,4,1,31,47,22,31,6,16,4,7,8,28,47
2012-07-16 00:00:00.000,Hamburg Germany ATP World Tour 500,CLAY,2,Juan Monaco,Nicolas Almagro,Juan Monaco,3-6; 6-3; 6-4,S,123,2,1,52,72,33,52,12,20,1,5,14,45,72,2,2,41,81,26,41,17,40,3,8,14,43,81
2012-07-16 00:00:00.000,Hamburg Germany ATP World Tour 500,CLAY,2,Tommy Haas,Marin Cilic,Tommy Haas,7-6(7); 6-0,S,117,1,4,34,66,23,34,20,32,1,2,9,43,66,4,2,40,77,23,40,18,37,7,11,9,41,77
2012-07-16 00:00:00.000,Hamburg Germany ATP World Tour 500,CLAY,2,Juan Monaco,Tommy Haas,Juan Monaco,7-5; 6-4,F,121,1,2,60,75,38,60,6,15,5,8,11,44,75,3,1,47,73,30,47,10,26,4,9,11,40,73
2012-07-22 00:00:00.000,Kitzbnhel Austria ATP World Tour 250,CLAY,2,Philipp Kohlschreiber,N/A Bye,Philipp Kohlschreiber,,R32,0,0,0,0,0,0,0,0,0,0,0,0,0,0,0,0,0,0,0,0,0,0,0,0,0,0,0
2012-07-22 00:00:00.000,Kitzbnhel Austria ATP World Tour 250,CLAY,2,Attila Balazs,Martin Fischer,Attila Balazs,6-3; 1-6; 7-6(2),R32,123,5,7,50,81,32,50,18,31,1,5,14,50,81,4,6,53,98,36,53,25,45,5,8,14,61,98
2012-07-22 00:00:00.000,Kitzbnhel Austria ATP World Tour 250,CLAY,2,Lukas Rosol,Teymuraz Gabashvili,Lukas Rosol,7-6(4); 6-1,R32,104,3,3,39,67,29,39,14,28,4,6,10,43,67,1,2,35,67,20,35,16,32,7,11,9,36,67
2012-07-22 00:00:00.000,Kitzbnhel Austria ATP World Tour 250,CLAY,2,Antonio Veic,Blaz Kavcic,Antonio Veic,6-1; 6-2,R32,68,2,1,27,45,19,27,14,18,1,1,8,33,45,1,6,18,46,9,18,12,28,2,6,7,21,46
2012-07-22 00:00:00.000,Kitzbnhel Austria ATP World Tour 250,CLAY,2,Albert Ramos-Vinolas,N/A Bye,Albert Ramos-Vinolas,,R32,0,0,0,0,0,0,0,0,0,0,0,0,0,0,0,0,0,0,0,0,0,0,0,0,0,0,0
2012-07-22 00:00:00.000,Kitzbnhel Austria ATP World Tour 250,CLAY,2,Filippo Volandri,Alessandro Giannessi,Filippo Volandri,1-6; 6-4; 6-3,R32,109,0,1,58,81,34,58,13,23,5,10,13,47,81,2,6,42,77,26,42,15,35,4,9,13,41,77
2012-07-22 00:00:00.000,Kitzbnhel Austria ATP World Tour 250,CLAY,2,Rogerio Dutra Silva,Jan Hajek,Rogerio Dutra Silva,4-1,R32,26,0,0,5,10,5,5,3,5,0,0,2,8,10,0,1,17,21,6,17,2,4,2,4,3,8,21
2012-07-22 00:00:00.000,Kitzbnhel Austria ATP World Tour 250,CLAY,2,Ernests Gulbis,Andreas Haider-Maurer,Ernests Gulbis,2-6; 7-5; 6-1,R32,123,11,7,43,84,33,43,17,41,4,7,13,50,84,12,8,52,98,37,52,19,46,7,12,14,56,98
2012-07-22 00:00:00.000,Kitzbnhel Austria ATP World Tour 250,CLAY,2,Jurgen Zopp,Guillermo Garcia-Lopez,Jurgen Zopp,6-1; 6-3,R32,79,2,2,51,70,30,51,9,19,3,5,8,39,70,0,5,32,56,18,32,5,24,7,13,8,23,56
2012-07-22 00:00:00.000,Kitzbnhel Austria ATP World Tour 250,CLAY,2,Wayne Odesnik,Joao Souza,Wayne Odesnik,5-7; 6-4; 6-3,R32,162,6,6,53,105,39,53,26,52,7,10,16,65,105,9,5,50,95,35,50,18,45,3,7,15,53,95
2012-07-22 00:00:00.000,Kitzbnhel Austria ATP World Tour 250,CLAY,2,Philipp Oswald,Daniel Brands,Philipp Oswald,4-6; 6-2; 6-3,R32,105,13,7,53,78,43,53,14,25,2,3,14,57,78,5,8,36,72,28,36,19,36,1,4,13,47,72
2012-07-22 00:00:00.000,Kitzbnhel Austria ATP World Tour 250,CLAY,2,Robin Haase,N/A Bye,Robin Haase,,R32,0,0,0,0,0,0,0,0,0,0,0,0,0,0,0,0,0,0,0,0,0,0,0,0,0,0,0
2012-07-22 00:00:00.000,Kitzbnhel Austria ATP World Tour 250,CLAY,2,Martin Klizan,Dominic Thiem,Martin Klizan,6-1; 3-6; 7-5,R32,130,3,3,42,80,34,42,23,38,1,3,14,57,80,4,7,48,96,36,48,20,48,5,9,14,56,96
2012-07-22 00:00:00.000,Kitzbnhel Austria ATP World Tour 250,CLAY,2,Pavol Cervenak,Ruben Ramirez Hidalgo,Pavol Cervenak,4-6; 7-6(1); 6-3,R32,152,0,12,57,103,41,57,25,46,8,12,16,66,103,3,7,42,82,33,42,18,40,0,4,15,51,82
2012-07-22 00:00:00.000,Kitzbnhel Austria ATP World Tour 250,CLAY,2,Simone Bolelli,Horacio Zeballos,Simone Bolelli,7-5; 7-5,R32,104,1,5,41,70,32,41,15,29,1,3,12,47,70,6,5,39,70,23,39,17,31,2,6,12,40,70
2012-07-22 00:00:00.000,Kitzbnhel Austria ATP World Tour 250,CLAY,2,Florian Mayer,N/A Bye,Florian Mayer,,R32,0,0,0,0,0,0,0,0,0,0,0,0,0,0,0,0,0,0,0,0,0,0,0,0,0,0,0
2012-07-22 00:00:00.000,Kitzbnhel Austria ATP World Tour 250,CLAY,2,Philipp Kohlschreiber,Attila Balazs,Philipp Kohlschreiber,6-4; 6-1,R16,71,4,6,28,46,23,28,9,18,3,4,8,32,46,2,4,28,63,14,28,16,35,3,8,9,30,63
2012-07-22 00:00:00.000,Kitzbnhel Austria ATP World Tour 250,CLAY,2,Lukas Rosol,Antonio Veic,Lukas Rosol,6-3; 5-7; 6-3,R16,110,8,6,39,94,26,39,34,55,6,9,15,60,94,0,7,63,88,38,63,11,25,3,8,15,49,88
2012-07-22 00:00:00.000,Kitzbnhel Austria ATP World Tour 250,CLAY,2,Filippo Volandri,Albert Ramos-Vinolas,Filippo Volandri,6-4; 6-4,R16,95,0,0,43,62,29,43,12,19,2,3,10,41,62,0,5,28,63,16,28,19,35,4,7,10,35,63
2012-07-22 00:00:00.000,Kitzbnhel Austria ATP World Tour 250,CLAY,2,Rogerio Dutra Silva,Ernests Gulbis,Rogerio Dutra Silva,6-4; 6-4,R16,79,2,4,30,57,25,30,16,27,4,5,10,41,57,1,4,29,53,20,29,15,24,4,7,10,35,53
2012-07-22 00:00:00.000,Kitzbnhel Austria ATP World Tour 250,CLAY,2,Wayne Odesnik,Jurgen Zopp,Wayne Odesnik,5-7; 7-5; 6-3,R16,147,3,6,61,110,44,61,23,49,5,8,17,67,110,8,2,58,97,37,58,22,39,6,10,16,59,97
2012-07-22 00:00:00.000,Kitzbnhel Austria ATP World Tour 250,CLAY,2,Robin Haase,Philipp Oswald,Robin Haase,6-4; 3-6; 6-2,R16,131,4,3,49,77,32,49,19,28,1,3,13,51,77,10,9,54,98,37,54,23,44,10,14,14,60,98
2012-07-22 00:00:00.000,Kitzbnhel Austria ATP World Tour 250,CLAY,2,Martin Klizan,Pavol Cervenak,Martin Klizan,6-4; 6-4,R16,91,2,1,33,60,27,33,12,27,2,3,10,39,60,5,2,28,58,18,28,16,30,2,5,10,34,58
2012-07-22 00:00:00.000,Kitzbnhel Austria ATP World Tour 250,CLAY,2,Simone Bolelli,Florian Mayer,Simone Bolelli,6-2; 7-6(4),R16,99,1,2,43,65,31,43,13,22,3,4,10,44,65,5,0,43,77,29,43,14,34,5,8,10,43,77
2012-07-22 00:00:00.000,Kitzbnhel Austria ATP World Tour 250,CLAY,2,Philipp Kohlschreiber,Lukas Rosol,Philipp Kohlschreiber,6-4; 2-6; 6-4,Q,104,13,2,39,72,30,39,21,33,3,5,14,51,72,8,8,53,94,41,53,21,41,3,5,14,62,94
2012-07-22 00:00:00.000,Kitzbnhel Austria ATP World Tour 250,CLAY,2,Filippo Volandri,Rogerio Dutra Silva,Filippo Volandri,6-4; 6-4,Q,83,0,0,43,58,29,43,6,15,2,4,10,35,58,1,3,35,54,23,35,8,19,2,6,10,31,54
2012-07-22 00:00:00.000,Kitzbnhel Austria ATP World Tour 250,CLAY,2,Robin Haase,Wayne Odesnik,Robin Haase,6-2; 6-4,Q,78,9,3,32,56,26,32,10,24,1,2,9,36,56,4,1,32,52,22,32,4,20,5,9,9,26,52
2012-07-22 00:00:00.000,Kitzbnhel Austria ATP World Tour 250,CLAY,2,Martin Klizan,Simone Bolelli,Martin Klizan,1-6; 7-5; 6-1,Q,121,6,1,41,78,28,41,20,37,5,9,13,48,78,6,0,50,81,32,50,13,31,3,8,13,45,81
2012-07-22 00:00:00.000,Kitzbnhel Austria ATP World Tour 250,CLAY,2,Philipp Kohlschreiber,Filippo Volandri,Philipp Kohlschreiber,6-7(6); 6-2; 6-2,S,108,8,5,47,83,38,47,23,36,2,3,14,61,83,0,2,56,87,35,56,13,31,4,9,14,48,87
2012-07-22 00:00:00.000,Kitzbnhel Austria ATP World Tour 250,CLAY,2,Robin Haase,Martin Klizan,Robin Haase,6-3; 6-3,S,82,1,6,27,51,26,27,9,24,2,4,9,35,51,1,3,27,62,17,27,12,35,3,8,9,29,62
2012-07-22 00:00:00.000,Kitzbnhel Austria ATP World Tour 250,CLAY,2,Robin Haase,Philipp Kohlschreiber,Robin Haase,6-7(2); 6-3; 6-2,F,128,3,6,57,100,43,57,20,43,13,14,14,63,100,5,3,69,103,46,69,11,34,6,11,15,57,103
2012-07-23 00:00:00.000,Los Angeles CA; U.S.A. ATP World Tour 250,HARD,2,Benoit Paire,N/A Bye,Benoit Paire,,R32,0,0,0,0,0,0,0,0,0,0,0,0,0,0,0,0,0,0,0,0,0,0,0,0,0,0,0
2012-07-23 00:00:00.000,Los Angeles CA; U.S.A. ATP World Tour 250,HARD,2,Michael Russell,Jesse Levine,Michael Russell,6-3; 6-4,R32,77,3,2,38,56,31,38,11,18,1,1,10,42,56,6,3,36,54,24,36,11,18,1,3,9,35,54
2012-07-23 00:00:00.000,Los Angeles CA; U.S.A. ATP World Tour 250,HARD,2,Tobias Kamke,James Blake,Tobias Kamke,6-2; 5-7; 7-6(4),R32,137,3,5,54,108,33,54,29,54,4,10,16,62,108,3,6,69,117,44,69,17,48,6,13,16,61,117
2012-07-23 00:00:00.000,Los Angeles CA; U.S.A. ATP World Tour 250,HARD,2,Marinko Matosevic,Chris Guccione,Marinko Matosevic,3-6; 6-3; 6-3,R32,95,2,1,46,72,34,46,14,26,3,5,13,48,72,7,6,48,89,33,48,18,41,1,5,14,51,89
2012-07-23 00:00:00.000,Los Angeles CA; U.S.A. ATP World Tour 250,HARD,2,Nicolas Mahut,N/A Bye,Nicolas Mahut,,R32,0,0,0,0,0,0,0,0,0,0,0,0,0,0,0,0,0,0,0,0,0,0,0,0,0,0,0
2012-07-23 00:00:00.000,Los Angeles CA; U.S.A. ATP World Tour 250,HARD,2,Paolo Lorenzi,Bradley Klahn,Paolo Lorenzi,6-4; 3-6; 6-0,R32,121,1,7,60,83,39,60,9,23,2,6,13,48,83,4,5,60,91,38,60,9,31,16,22,12,47,91
2012-07-23 00:00:00.000,Los Angeles CA; U.S.A. ATP World Tour 250,HARD,2,Igor Andreev,Dudi Sela,Igor Andreev,7-6(4); 6-4,R32,86,6,2,40,65,29,40,18,25,0,1,11,47,65,0,2,47,77,30,47,17,30,2,4,11,47,77
2012-07-23 00:00:00.000,Los Angeles CA; U.S.A. ATP World Tour 250,HARD,2,Ricardas Berankis,Bjorn Phau,Ricardas Berankis,7-6(8); 6-4,R32,92,2,3,37,78,30,37,25,41,4,5,11,55,78,4,4,42,78,33,42,17,36,2,4,11,50,78
2012-07-23 00:00:00.000,Los Angeles CA; U.S.A. ATP World Tour 250,HARD,2,Rajeev Ram,Brian Baker,Rajeev Ram,7-6(3); 7-5,R32,102,4,1,35,69,28,35,17,34,2,5,12,45,69,4,2,59,78,37,59,7,19,5,9,12,44,78
2012-07-23 00:00:00.000,Los Angeles CA; U.S.A. ATP World Tour 250,HARD,2,Paul Capdeville,Igor Kunitsyn,Paul Capdeville,6-4; 7-6(5),R32,111,9,5,47,77,35,47,14,30,5,7,11,49,77,4,0,48,82,30,48,18,34,3,6,11,48,82
2012-07-23 00:00:00.000,Los Angeles CA; U.S.A. ATP World Tour 250,HARD,2,Flavio Cipolla,Jack Sock,Flavio Cipolla,6-3; 6-1,R32,69,0,2,35,46,24,35,6,11,3,4,8,30,46,3,3,26,45,14,26,6,19,3,8,8,20,45
2012-07-23 00:00:00.000,Los Angeles CA; U.S.A. ATP World Tour 250,HARD,2,Leonardo Mayer,N/A Bye,Leonardo Mayer,,R32,0,0,0,0,0,0,0,0,0,0,0,0,0,0,0,0,0,0,0,0,0,0,0,0,0,0,0
2012-07-23 00:00:00.000,Los Angeles CA; U.S.A. ATP World Tour 250,HARD,2,Xavier Malisse,Nicolas Meister,Xavier Malisse,6-4; 6-1,R32,89,7,2,26,57,21,26,14,31,4,5,8,35,57,2,4,42,74,23,42,14,32,8,13,9,37,74
2012-07-23 00:00:00.000,Los Angeles CA; U.S.A. ATP World Tour 250,HARD,2,Matthew Ebden,Michael Berrer,Matthew Ebden,4-6; 6-2; 7-6(4),R32,129,4,8,62,102,48,62,20,40,6,8,15,68,102,5,2,64,103,47,64,18,39,10,13,15,65,103
2012-07-23 00:00:00.000,Los Angeles CA; U.S.A. ATP World Tour 250,HARD,2,Igor Sijsling,Steve Johnson,Igor Sijsling,7-6(4); 6-3,R32,68,5,1,42,59,39,42,11,17,0,0,11,50,59,6,2,33,60,23,33,20,27,0,1,10,43,60
2012-07-23 00:00:00.000,Los Angeles CA; U.S.A. ATP World Tour 250,HARD,2,Sam Querrey,N/A Bye,Sam Querrey,,R32,0,0,0,0,0,0,0,0,0,0,0,0,0,0,0,0,0,0,0,0,0,0,0,0,0,0,0
2012-07-23 00:00:00.000,Los Angeles CA; U.S.A. ATP World Tour 250,HARD,2,Michael Russell,Benoit Paire,Michael Russell,7-5; 6-4,R16,100,3,3,65,82,37,65,7,17,5,9,11,44,82,5,8,29,66,24,29,8,37,1,7,11,32,66
2012-07-23 00:00:00.000,Los Angeles CA; U.S.A. ATP World Tour 250,HARD,2,Marinko Matosevic,Tobias Kamke,Marinko Matosevic,6-3; 1-6; 6-0,R16,95,2,3,39,62,29,39,8,23,4,7,11,37,62,0,5,30,74,19,30,18,44,3,8,11,37,74
2012-07-23 00:00:00.000,Los Angeles CA; U.S.A. ATP World Tour 250,HARD,2,Nicolas Mahut,Paolo Lorenzi,Nicolas Mahut,7-5; 7-6(7),R16,113,8,3,55,77,46,55,10,22,3,3,12,56,77,4,1,39,82,26,39,28,43,1,2,12,54,82
2012-07-23 00:00:00.000,Los Angeles CA; U.S.A. ATP World Tour 250,HARD,2,Ricardas Berankis,Igor Andreev,Ricardas Berankis,6-4; 7-5,R16,75,3,3,34,65,25,34,20,31,4,5,11,45,65,5,3,38,58,27,38,8,20,0,3,11,35,58
2012-07-23 00:00:00.000,Los Angeles CA; U.S.A. ATP World Tour 250,HARD,2,Rajeev Ram,Paul Capdeville,Rajeev Ram,6-3; 6-1,R16,65,10,0,26,42,22,26,11,16,0,0,8,33,42,4,2,27,52,15,27,12,25,5,9,8,27,52
2012-07-23 00:00:00.000,Los Angeles CA; U.S.A. ATP World Tour 250,HARD,2,Leonardo Mayer,Flavio Cipolla,Leonardo Mayer,6-0; 4-0 RET,R16,56,5,0,15,24,12,15,8,9,0,0,5,20,24,0,3,43,58,20,43,3,15,6,11,5,23,58
2012-07-23 00:00:00.000,Los Angeles CA; U.S.A. ATP World Tour 250,HARD,2,Xavier Malisse,Matthew Ebden,Xavier Malisse,6-4; 6-3,R16,74,8,2,33,51,30,33,9,18,1,1,9,39,51,3,2,35,64,21,35,16,29,3,6,10,37,64
2012-07-23 00:00:00.000,Los Angeles CA; U.S.A. ATP World Tour 250,HARD,2,Sam Querrey,Igor Sijsling,Sam Querrey,6-2; 6-2,R16,54,9,2,27,44,23,27,10,17,0,0,8,33,44,5,3,32,55,22,32,6,23,5,9,8,28,55
2012-07-23 00:00:00.000,Los Angeles CA; U.S.A. ATP World Tour 250,HARD,2,Marinko Matosevic,Michael Russell,Marinko Matosevic,6-2; 6-3,Q,91,3,3,44,68,30,44,12,24,8,9,9,42,68,2,5,33,50,18,33,8,17,6,10,8,26,50
2012-07-23 00:00:00.000,Los Angeles CA; U.S.A. ATP World Tour 250,HARD,2,Ricardas Berankis,Nicolas Mahut,Ricardas Berankis,6-4; 6-4,Q,90,3,3,28,62,22,28,22,34,3,3,10,44,62,7,1,53,74,37,53,10,21,8,10,10,47,74
2012-07-23 00:00:00.000,Los Angeles CA; U.S.A. ATP World Tour 250,HARD,2,Rajeev Ram,Leonardo Mayer,Rajeev Ram,7-6(3); 6-3,Q,97,3,0,50,70,37,50,15,20,2,3,11,52,70,3,4,39,63,29,39,13,24,1,3,10,42,63
2012-07-23 00:00:00.000,Los Angeles CA; U.S.A. ATP World Tour 250,HARD,2,Sam Querrey,Xavier Malisse,Sam Querrey,6-2; 3-1 RET,Q,37,4,2,20,29,19,20,5,9,0,0,6,24,29,0,0,18,32,11,18,5,14,1,4,6,16,32
2012-07-23 00:00:00.000,Los Angeles CA; U.S.A. ATP World Tour 250,HARD,2,Ricardas Berankis,Marinko Matosevic,Ricardas Berankis,7-5; 6-1,S,71,3,2,26,50,24,26,14,24,0,0,9,38,50,4,1,44,61,26,44,6,17,5,9,10,32,61
2012-07-23 00:00:00.000,Los Angeles CA; U.S.A. ATP World Tour 250,HARD,2,Sam Querrey,Rajeev Ram,Sam Querrey,6-3; 7-6(4),S,96,11,2,42,72,35,42,15,30,1,2,11,50,72,4,1,46,78,33,46,16,32,5,7,10,49,78
2012-07-23 00:00:00.000,Los Angeles CA; U.S.A. ATP World Tour 250,HARD,2,Sam Querrey,Ricardas Berankis,Sam Querrey,6-0; 6-2,F,52,8,2,30,49,23,30,10,19,3,3,7,33,49,0,2,18,40,9,18,6,22,2,7,7,15,40
2012-07-25 00:00:00.000,London Olympics Great Britain ATP World Tour,GRASS,2,Roger Federer,Alejandro Falla,Roger Federer,6-3; 5-7; 6-3,R64,107,9,1,55,87,40,55,16,32,3,6,15,56,87,3,0,67,93,45,67,8,26,8,13,15,53,93
2012-07-25 00:00:00.000,London Olympics Great Britain ATP World Tour,GRASS,2,Julien Benneteau,Mikhail Youzhny,Julien Benneteau,7-5; 6-3,R64,91,6,0,47,75,35,47,15,28,9,9,10,50,75,4,1,36,61,23,36,13,25,2,5,11,36,61
2012-07-25 00:00:00.000,London Olympics Great Britain ATP World Tour,GRASS,2,Gilles Muller,Adrian Ungur,Gilles Muller,6-3; 6-3,R64,53,7,0,23,44,19,23,17,21,0,0,9,36,44,6,4,24,46,19,24,10,22,1,4,9,29,46
2012-07-25 00:00:00.000,London Olympics Great Britain ATP World Tour,GRASS,2,Denis Istomin,Fernando Verdasco,Denis Istomin,6-4; 7-6(9),R64,95,5,0,49,72,39,49,17,23,2,2,11,56,72,7,3,52,81,39,52,17,29,3,4,11,56,81
2012-07-25 00:00:00.000,London Olympics Great Britain ATP World Tour,GRASS,2,John Isner,Olivier Rochus,John Isner,7-6(1); 6-4,R64,74,24,3,48,66,41,48,11,18,2,2,11,52,66,1,1,37,61,27,37,15,24,0,1,11,42,61
2012-07-25 00:00:00.000,London Olympics Great Britain ATP World Tour,GRASS,2,Malek Jaziri,Yen-Hsun Lu,Malek Jaziri,7-6(10); 4-6; 6-3,R64,135,14,4,67,109,55,67,17,42,0,2,16,72,109,11,3,50,84,39,50,21,34,0,2,15,60,84
2012-07-25 00:00:00.000,London Olympics Great Britain ATP World Tour,GRASS,2,Philipp Petzschner,Lukas Lacko,Philipp Petzschner,7-6(5); 6-1,R64,73,8,3,45,74,31,45,19,29,5,5,10,50,74,4,2,33,55,24,33,11,22,0,2,9,35,55
2012-07-25 00:00:00.000,London Olympics Great Britain ATP World Tour,GRASS,2,Janko Tipsarevic,David Nalbandian,Janko Tipsarevic,6-3; 6-4,R64,83,16,0,36,57,29,36,11,21,0,1,10,40,57,4,0,31,50,21,31,10,19,2,5,9,31,50
2012-07-25 00:00:00.000,London Olympics Great Britain ATP World Tour,GRASS,2,David Ferrer,Vasek Pospisil,David Ferrer,6-4; 6-4,R64,82,4,0,43,57,31,43,8,14,3,5,10,39,57,7,6,35,69,27,35,10,34,4,8,10,37,69
2012-07-25 00:00:00.000,London Olympics Great Britain ATP World Tour,GRASS,2,Blaz Kavcic,Vishnu Vardhan,Blaz Kavcic,6-3; 6-2,R64,72,7,1,21,42,20,21,13,21,0,0,8,33,42,5,1,32,65,26,32,9,33,3,7,9,35,65
2012-07-25 00:00:00.000,London Olympics Great Britain ATP World Tour,GRASS,2,Nikolay Davydenko,Radek Stepanek,Nikolay Davydenko,6-4; 6-3,R64,98,1,3,47,63,34,47,9,16,5,5,9,43,63,6,1,47,70,27,47,14,23,5,8,10,41,70
2012-07-25 00:00:00.000,London Olympics Great Britain ATP World Tour,GRASS,2,Kei Nishikori,Bernard Tomic,Kei Nishikori,7-6(4); 7-6(4),R64,90,12,0,61,83,46,61,13,22,5,6,12,59,83,11,1,63,78,47,63,7,15,1,2,12,54,78
2012-07-25 00:00:00.000,London Olympics Great Britain ATP World Tour,GRASS,2,Gilles Simon,Mikhail Kukushkin,Gilles Simon,6-4; 6-2,R64,74,12,1,26,42,24,26,12,16,0,0,9,36,42,1,1,41,76,23,41,19,35,11,13,9,42,76
2012-07-25 00:00:00.000,London Olympics Great Britain ATP World Tour,GRASS,2,Grigor Dimitrov,Lukasz Kubot,Grigor Dimitrov,6-3; 7-6(4),R64,79,9,3,49,75,39,49,15,26,7,8,11,54,75,4,1,44,57,33,44,8,13,3,5,10,41,57
2012-07-25 00:00:00.000,London Olympics Great Britain ATP World Tour,GRASS,2,Andreas Seppi,Donald Young,Andreas Seppi,6-4; 6-4,R64,76,8,0,40,58,30,40,15,18,1,1,10,45,58,5,3,53,77,33,53,12,24,6,8,10,45,77
2012-07-25 00:00:00.000,London Olympics Great Britain ATP World Tour,GRASS,2,Juan Martin Del Potro,Ivan Dodig,Juan Martin Del Potro,6-4; 6-1,R64,68,4,1,26,45,23,26,11,19,2,2,8,34,45,9,0,31,55,20,31,10,24,4,8,9,30,55
2012-07-25 00:00:00.000,London Olympics Great Britain ATP World Tour,GRASS,2,Steve Darcis,Tomas Berdych,Steve Darcis,6-4; 6-4,R64,86,4,0,39,59,31,39,10,20,3,4,10,41,59,4,0,39,60,26,39,11,21,3,6,10,37,60
2012-07-25 00:00:00.000,London Olympics Great Britain ATP World Tour,GRASS,2,Santiago Giraldo,Ryan Harrison,Santiago Giraldo,7-5; 6-3,R64,64,0,0,41,52,34,41,7,11,1,1,10,41,52,7,2,44,61,33,44,6,17,2,5,11,39,61
2012-07-25 00:00:00.000,London Olympics Great Britain ATP World Tour,GRASS,2,Alex Bogomolov Jr.,Carlos Berlocq,Alex Bogomolov Jr.,7-5; 7-6(5),R64,105,3,4,51,78,37,51,18,27,4,5,12,55,78,5,6,44,84,35,44,18,40,2,4,12,53,84
2012-07-25 00:00:00.000,London Olympics Great Britain ATP World Tour,GRASS,2,Nicolas Almagro,Viktor Troicki,Nicolas Almagro,6-4; 7-6(3),R64,78,9,3,43,71,34,43,16,28,3,4,11,50,71,13,2,47,72,35,47,10,25,3,5,11,45,72
2012-07-25 00:00:00.000,London Olympics Great Britain ATP World Tour,GRASS,2,Richard Gasquet,Robin Haase,Richard Gasquet,6-3; 6-3,R64,67,9,1,41,61,31,41,11,20,2,2,9,42,61,8,2,31,53,23,31,9,22,2,5,9,32,53
2012-07-25 00:00:00.000,London Olympics Great Britain ATP World Tour,GRASS,2,Marcos Baghdatis,Go Soeda,Marcos Baghdatis,6-7(6); 7-6(5); 6-2,R64,146,13,9,62,115,49,62,26,53,5,7,16,75,115,1,3,55,102,35,55,28,47,4,8,16,63,102
2012-07-25 00:00:00.000,London Olympics Great Britain ATP World Tour,GRASS,2,Jarkko Nieminen,Somdev Devvarman,Jarkko Nieminen,6-3; 6-1,R64,73,2,0,32,41,23,32,4,9,0,2,8,27,41,3,3,44,65,19,44,8,21,7,12,8,27,65
2012-07-25 00:00:00.000,London Olympics Great Britain ATP World Tour,GRASS,2,Andy Murray,Stan Wawrinka,Andy Murray,6-3; 6-3,R64,89,8,3,33,58,29,33,13,25,2,2,9,42,58,5,4,35,77,24,35,20,42,10,13,9,44,77
2012-07-25 00:00:00.000,London Olympics Great Britain ATP World Tour,GRASS,2,Jo-Wilfried Tsonga,Thomaz Bellucci,Jo-Wilfried Tsonga,6-7(5); 6-4; 6-4,R64,119,12,0,63,93,52,63,20,30,3,3,16,72,93,4,4,74,100,50,74,18,26,6,8,16,68,100
2012-07-25 00:00:00.000,London Olympics Great Britain ATP World Tour,GRASS,2,Milos Raonic,Tatsuma Ito,Milos Raonic,6-3; 6-4,R64,68,10,3,35,60,30,35,14,25,1,1,10,44,60,1,3,26,47,16,26,13,21,1,3,9,29,47
2012-07-25 00:00:00.000,London Olympics Great Britain ATP World Tour,GRASS,2,Feliciano Lopez,Dmitry Tursunov,Feliciano Lopez,6-7(5); 6-2; 9-7,R64,136,24,5,68,106,58,68,21,38,1,1,18,79,106,10,2,76,108,54,76,19,32,9,12,18,73,108
2012-07-25 00:00:00.000,London Olympics Great Britain ATP World Tour,GRASS,2,Juan Monaco,David Goffin,Juan Monaco,6-4; 6-1,R64,78,1,2,38,60,26,38,11,22,4,6,9,37,60,1,2,24,44,14,24,6,20,4,9,8,20,44
2012-07-25 00:00:00.000,London Olympics Great Britain ATP World Tour,GRASS,2,Marin Cilic,Jurgen Melzer,Marin Cilic,7-6(5); 6-2,R64,96,7,2,36,76,25,36,24,40,2,3,10,49,76,4,0,54,74,35,54,7,20,7,10,10,42,74
2012-07-25 00:00:00.000,London Olympics Great Britain ATP World Tour,GRASS,2,Lleyton Hewitt,Sergiy Stakhovsky,Lleyton Hewitt,6-3; 4-6; 6-3,R64,104,6,0,43,72,36,43,20,29,1,2,14,56,72,11,4,50,95,35,50,23,45,4,7,14,58,95
2012-07-25 00:00:00.000,London Olympics Great Britain ATP World Tour,GRASS,2,Andy Roddick,Martin Klizan,Andy Roddick,7-5; 6-4,R64,99,5,0,42,53,38,42,6,11,0,0,11,44,53,2,2,56,90,35,56,19,34,11,13,11,54,90
2012-07-25 00:00:00.000,London Olympics Great Britain ATP World Tour,GRASS,2,Novak Djokovic,Fabio Fognini,Novak Djokovic,6-7(7); 6-2; 6-2,R64,112,11,1,57,86,46,57,17,29,1,2,14,63,86,4,3,68,102,44,68,14,34,5,10,14,58,102
2012-07-25 00:00:00.000,London Olympics Great Britain ATP World Tour,GRASS,2,Roger Federer,Julien Benneteau,Roger Federer,6-2; 6-2,R32,58,7,0,31,47,25,31,9,16,0,0,8,34,47,3,4,34,54,22,34,6,20,4,8,8,28,54
2012-07-25 00:00:00.000,London Olympics Great Britain ATP World Tour,GRASS,2,Denis Istomin,Gilles Muller,Denis Istomin,6-7(4); 7-6(3); 7-5,R32,157,11,1,78,110,61,78,20,32,5,6,18,81,110,14,3,77,116,58,77,21,39,3,5,18,79,116
2012-07-25 00:00:00.000,London Olympics Great Britain ATP World Tour,GRASS,2,John Isner,Malek Jaziri,John Isner,7-6(1); 6-2,R32,85,16,2,46,66,36,46,14,20,5,5,10,50,66,5,3,38,74,25,38,19,36,7,9,10,44,74
2012-07-25 00:00:00.000,London Olympics Great Britain ATP World Tour,GRASS,2,Janko Tipsarevic,Philipp Petzschner,Janko Tipsarevic,3-6; 6-3; 6-4,R32,106,7,1,47,77,38,47,19,30,3,4,14,57,77,9,3,47,88,32,47,27,41,8,10,14,59,88
2012-07-25 00:00:00.000,London Olympics Great Britain ATP World Tour,GRASS,2,David Ferrer,Blaz Kavcic,David Ferrer,6-2; 6-2,R32,81,2,1,23,42,20,23,13,19,0,0,8,33,42,2,2,39,69,26,39,9,30,6,10,8,35,69
2012-07-25 00:00:00.000,London Olympics Great Britain ATP World Tour,GRASS,2,Kei Nishikori,Nikolay Davydenko,Kei Nishikori,4-6; 6-4; 6-1,R32,125,3,1,53,74,37,53,11,21,2,4,13,48,74,3,7,71,110,44,71,15,39,12,17,14,59,110
2012-07-25 00:00:00.000,London Olympics Great Britain ATP World Tour,GRASS,2,Gilles Simon,Grigor Dimitrov,Gilles Simon,6-3; 6-3,R32,60,7,2,36,52,31,36,5,16,1,2,9,36,52,2,1,24,45,14,24,10,21,2,6,9,24,45
2012-07-25 00:00:00.000,London Olympics Great Britain ATP World Tour,GRASS,2,Juan Martin Del Potro,Andreas Seppi,Juan Martin Del Potro,6-3; 7-6(2),R32,102,6,2,54,76,38,54,14,22,10,11,11,52,76,6,2,55,76,33,55,13,21,3,5,10,46,76
2012-07-25 00:00:00.000,London Olympics Great Britain ATP World Tour,GRASS,2,Steve Darcis,Santiago Giraldo,Steve Darcis,6-7(4); 6-4; 6-4,R32,147,4,0,73,98,56,73,15,25,0,0,16,71,98,3,1,96,129,58,96,21,33,8,10,16,79,129
2012-07-25 00:00:00.000,London Olympics Great Britain ATP World Tour,GRASS,2,Nicolas Almagro,Alex Bogomolov Jr.,Nicolas Almagro,6-2; 6-2,R32,46,14,4,22,40,21,22,11,18,0,0,8,32,40,2,2,34,46,21,34,4,12,1,5,8,25,46
2012-07-25 00:00:00.000,London Olympics Great Britain ATP World Tour,GRASS,2,Marcos Baghdatis,Richard Gasquet,Marcos Baghdatis,6-4; 6-4,R32,74,14,3,31,57,26,31,16,26,0,0,10,42,57,5,1,42,60,34,42,6,18,5,7,10,40,60
2012-07-25 00:00:00.000,London Olympics Great Britain ATP World Tour,GRASS,2,Andy Murray,Jarkko Nieminen,Andy Murray,6-2; 6-4,R32,61,5,0,31,47,24,31,13,16,2,2,9,37,47,1,2,32,56,21,32,11,24,5,8,9,32,56
2012-07-25 00:00:00.000,London Olympics Great Britain ATP World Tour,GRASS,2,Jo-Wilfried Tsonga,Milos Raonic,Jo-Wilfried Tsonga,6-3; 3-6; 25-23,R32,237,17,6,116,191,95,116,46,75,7,8,33,141,191,23,7,116,167,101,116,29,51,3,5,33,130,167
2012-07-25 00:00:00.000,London Olympics Great Britain ATP World Tour,GRASS,2,Feliciano Lopez,Juan Monaco,Feliciano Lopez,6-4; 6-4,R32,71,7,0,28,48,23,28,13,20,0,1,10,36,48,4,3,36,63,22,36,14,27,1,4,10,36,63
2012-07-25 00:00:00.000,London Olympics Great Britain ATP World Tour,GRASS,2,Lleyton Hewitt,Marin Cilic,Lleyton Hewitt,6-4; 7-5,R32,96,4,0,48,76,35,48,17,28,4,4,11,52,76,9,2,40,68,29,40,15,28,5,7,11,44,68
2012-07-25 00:00:00.000,London Olympics Great Britain ATP World Tour,GRASS,2,Novak Djokovic,Andy Roddick,Novak Djokovic,6-2; 6-1,R32,54,14,0,29,43,25,29,8,14,0,0,8,33,43,5,1,24,40,13,24,7,16,0,4,7,20,40
2012-07-25 00:00:00.000,London Olympics Great Britain ATP World Tour,GRASS,2,Roger Federer,Denis Istomin,Roger Federer,7-5; 6-3,R16,81,3,0,50,68,38,50,10,18,4,5,11,48,68,7,1,34,60,25,34,12,26,1,4,10,37,60
2012-07-25 00:00:00.000,London Olympics Great Britain ATP World Tour,GRASS,2,John Isner,Janko Tipsarevic,John Isner,7-5; 7-6(14),R16,90,22,0,60,72,55,60,6,12,0,0,12,61,72,6,3,56,73,46,56,10,17,0,1,12,56,73
2012-07-25 00:00:00.000,London Olympics Great Britain ATP World Tour,GRASS,2,Kei Nishikori,David Ferrer,Kei Nishikori,6-0; 3-6; 6-4,R16,116,2,1,56,75,40,56,9,19,2,4,12,49,75,5,1,51,83,32,51,14,32,4,9,13,46,83
2012-07-25 00:00:00.000,London Olympics Great Britain ATP World Tour,GRASS,2,Juan Martin Del Potro,Gilles Simon,Juan Martin Del Potro,6-1; 4-6; 6-3,R16,111,6,1,54,80,39,54,14,26,0,1,13,53,80,7,1,46,76,33,46,12,30,2,6,13,45,76
2012-07-25 00:00:00.000,London Olympics Great Britain ATP World Tour,GRASS,2,Nicolas Almagro,Steve Darcis,Nicolas Almagro,7-5; 6-3,R16,81,13,5,44,68,38,44,9,24,0,0,11,47,68,8,0,43,65,32,43,6,22,2,5,10,38,65
2012-07-25 00:00:00.000,London Olympics Great Britain ATP World Tour,GRASS,2,Andy Murray,Marcos Baghdatis,Andy Murray,4-6; 6-1; 6-4,R16,118,13,1,45,72,34,45,17,27,2,4,14,51,72,6,4,66,101,42,66,14,35,4,8,13,56,101
2012-07-25 00:00:00.000,London Olympics Great Britain ATP World Tour,GRASS,2,Jo-Wilfried Tsonga,Feliciano Lopez,Jo-Wilfried Tsonga,7-6(5); 6-4,R16,69,13,2,39,57,37,39,13,18,0,0,11,50,57,17,4,45,67,37,45,11,22,2,3,11,48,67
2012-07-25 00:00:00.000,London Olympics Great Britain ATP World Tour,GRASS,2,Novak Djokovic,Lleyton Hewitt,Novak Djokovic,4-6; 7-5; 6-1,R16,116,16,3,55,85,44,55,14,30,2,4,15,58,85,5,1,47,78,35,47,14,31,3,7,14,49,78
2012-07-25 00:00:00.000,London Olympics Great Britain ATP World Tour,GRASS,2,Roger Federer,John Isner,Roger Federer,6-4; 7-6(5),Q,85,3,1,46,73,36,46,17,27,1,1,11,53,73,8,1,49,68,37,49,12,19,3,4,11,49,68
2012-07-25 00:00:00.000,London Olympics Great Britain ATP World Tour,GRASS,2,Juan Martin Del Potro,Kei Nishikori,Juan Martin Del Potro,6-4; 7-6(4),Q,115,2,3,41,67,28,41,17,26,3,6,11,45,67,2,2,50,72,32,50,8,22,2,6,11,40,72
2012-07-25 00:00:00.000,London Olympics Great Britain ATP World Tour,GRASS,2,Andy Murray,Nicolas Almagro,Andy Murray,6-4; 6-1,Q,59,15,2,30,37,28,30,4,7,0,0,8,32,37,1,3,32,54,15,32,10,22,1,5,9,25,54
2012-07-25 00:00:00.000,London Olympics Great Britain ATP World Tour,GRASS,2,Novak Djokovic,Jo-Wilfried Tsonga,Novak Djokovic,6-1; 7-5,Q,80,4,0,43,57,34,43,7,14,4,5,10,41,57,4,0,47,72,26,47,12,25,9,13,9,38,72
2012-07-25 00:00:00.000,London Olympics Great Britain ATP World Tour,GRASS,2,Roger Federer,Juan Martin Del Potro,Roger Federer,3-6; 7-6(5); 19-17,S,266,23,2,118,174,88,118,35,56,5,7,28,123,174,11,5,135,192,97,135,32,57,11,13,29,129,192
2012-07-25 00:00:00.000,London Olympics Great Britain ATP World Tour,GRASS,2,Andy Murray,Novak Djokovic,Andy Murray,7-5; 7-5,S,120,6,0,55,87,42,55,17,32,4,4,12,59,87,3,1,40,65,29,40,14,25,2,4,12,43,65
2012-07-25 00:00:00.000,London Olympics Great Britain ATP World Tour,GRASS,2,Andy Murray,Roger Federer,Andy Murray,6-2; 6-1; 6-4,F,116,5,1,44,87,35,44,27,43,9,9,13,62,87,9,1,51,78,33,51,10,27,5,10,12,43,78
2012-07-30 00:00:00.000,Washington DC; USA ATP World Tour 500,HARD,2,Mardy Fish,Bjorn Phau,Mardy Fish,4-6; 6-1; 6-2,R32,113,15,3,49,82,34,49,22,33,6,7,13,56,82,5,5,47,81,31,47,15,34,5,9,12,46,81
2012-07-30 00:00:00.000,Washington DC; USA ATP World Tour 500,HARD,2,Ricardas Berankis,Nicolas Mahut,Ricardas Berankis,6-4; 7-5,R32,102,10,5,33,68,28,33,20,35,0,0,11,48,68,10,1,55,90,39,55,15,35,11,13,11,54,90
2012-07-30 00:00:00.000,Washington DC; USA ATP World Tour 500,HARD,2,Xavier Malisse,Paul-Henri Mathieu,Xavier Malisse,4-6; 6-2; 6-1,R32,105,12,3,35,70,30,35,16,35,1,4,12,46,70,4,5,43,87,26,43,17,44,12,19,13,43,87
2012-07-30 00:00:00.000,Washington DC; USA ATP World Tour 500,HARD,2,Jeremy Chardy,Edouard Roger-Vasselin,Jeremy Chardy,3-6; 7-6(3); 6-4,R32,131,19,5,64,102,50,64,19,38,5,6,15,69,102,9,7,68,103,57,68,14,35,3,4,16,71,103
2012-07-30 00:00:00.000,Washington DC; USA ATP World Tour 500,HARD,2,Tommy Haas,Michael Russell,Tommy Haas,6-4; 6-2,R32,75,5,3,27,45,23,27,13,18,0,0,9,36,45,5,3,41,61,28,41,8,20,4,7,9,36,61
2012-07-30 00:00:00.000,Washington DC; USA ATP World Tour 500,HARD,2,Leonardo Mayer,Guillermo Garcia-Lopez,Leonardo Mayer,7-6(5); 7-6(8),R32,119,6,4,48,77,39,48,18,29,0,0,12,57,77,8,5,40,78,30,40,25,38,0,0,12,55,78
2012-07-30 00:00:00.000,Washington DC; USA ATP World Tour 500,HARD,2,Marinko Matosevic,Jesse Levine,Marinko Matosevic,3-6; 7-6(5); 6-3,R32,134,5,1,62,95,43,62,20,33,3,6,16,63,95,5,3,60,87,42,60,15,27,3,5,14,57,87
2012-07-30 00:00:00.000,Washington DC; USA ATP World Tour 500,HARD,2,Tobias Kamke,Benoit Paire,Tobias Kamke,6-3; 7-5,R32,71,0,4,33,60,22,33,8,27,2,7,10,30,60,5,3,35,65,20,35,5,30,1,9,11,25,65
2012-07-30 00:00:00.000,Washington DC; USA ATP World Tour 500,HARD,2,Sam Querrey,Igor Andreev,Sam Querrey,7-6(2); 6-7(2); 7-6(3),R32,133,18,10,61,113,51,61,29,52,4,6,18,80,113,8,1,70,112,56,70,23,42,1,3,18,79,112
2012-07-30 00:00:00.000,Washington DC; USA ATP World Tour 500,HARD,2,Benjamin Becker,Steve Johnson,Benjamin Becker,6-4; 6-3,R32,73,7,2,28,59,20,28,18,31,3,4,9,38,59,7,3,30,57,21,30,11,27,5,9,10,32,57
2012-07-30 00:00:00.000,Washington DC; USA ATP World Tour 500,HARD,2,Florent Serra,Brian Baker,Florent Serra,4-6; 6-3; 6-4,R32,131,4,6,60,119,40,60,30,59,13,16,15,70,119,5,5,48,79,31,48,17,31,4,8,14,48,79
2012-07-30 00:00:00.000,Washington DC; USA ATP World Tour 500,HARD,2,Kevin Anderson,Jurgen Zopp,Kevin Anderson,6-3; 6-2,R32,68,13,1,36,55,30,36,11,19,5,5,9,41,55,3,3,25,46,18,25,8,21,4,7,8,26,46
2012-07-30 00:00:00.000,Washington DC; USA ATP World Tour 500,HARD,2,James Blake,Pablo Andujar,James Blake,4-6; 6-2; 6-2,R32,103,9,0,42,78,34,42,18,36,3,5,13,52,78,3,5,62,88,38,62,10,26,5,10,13,48,88
2012-07-30 00:00:00.000,Washington DC; USA ATP World Tour 500,HARD,2,Marco Chiudinelli,Horacio Zeballos,Marco Chiudinelli,7-5; 7-5,R32,153,5,3,53,81,40,53,14,28,7,8,12,54,81,7,2,55,94,36,55,17,39,6,9,12,53,94
2012-07-30 00:00:00.000,Washington DC; USA ATP World Tour 500,HARD,2,Ruben Ramirez Hidalgo,Matthew Ebden,Ruben Ramirez Hidalgo,6-3; 6-2,R32,95,3,5,26,54,20,26,14,28,3,5,9,34,54,7,6,48,74,25,48,9,26,5,10,8,34,74
2012-07-30 00:00:00.000,Washington DC; USA ATP World Tour 500,HARD,2,Alexandr Dolgopolov,Flavio Cipolla,Alexandr Dolgopolov,6-1; 6-3,R32,59,5,1,21,43,18,21,15,22,0,0,8,33,43,1,1,30,52,17,30,11,22,4,8,8,28,52
2012-07-30 00:00:00.000,Washington DC; USA ATP World Tour 500,HARD,2,Mardy Fish,Ricardas Berankis,Mardy Fish,6-3; 6-1,R16,61,10,2,31,49,25,31,11,18,2,2,8,36,49,4,6,20,43,12,20,9,23,1,5,8,21,43
2012-07-30 00:00:00.000,Washington DC; USA ATP World Tour 500,HARD,2,Xavier Malisse,Jeremy Chardy,Xavier Malisse,6-3; 6-2,R16,62,8,2,32,47,26,32,11,15,0,0,9,37,47,5,5,28,47,18,28,8,19,2,5,8,26,47
2012-07-30 00:00:00.000,Washington DC; USA ATP World Tour 500,HARD,2,Tommy Haas,Leonardo Mayer,Tommy Haas,6-4; 7-5,R16,100,8,3,35,56,29,35,13,21,2,3,11,42,56,7,2,47,69,32,47,9,22,5,8,11,41,69
2012-07-30 00:00:00.000,Washington DC; USA ATP World Tour 500,HARD,2,Tobias Kamke,Marinko Matosevic,Tobias Kamke,6-4; 6-3,R16,91,2,3,27,52,21,27,13,25,0,1,9,34,52,6,1,49,77,26,49,14,28,13,17,10,40,77
2012-07-30 00:00:00.000,Washington DC; USA ATP World Tour 500,HARD,2,Sam Querrey,Benjamin Becker,Sam Querrey,6-4; 6-3,R16,77,9,4,24,51,24,24,14,27,1,2,10,38,51,8,4,32,65,25,32,11,33,8,11,9,36,65
2012-07-30 00:00:00.000,Washington DC; USA ATP World Tour 500,HARD,2,Kevin Anderson,Florent Serra,Kevin Anderson,6-4; 6-4,R16,82,12,3,33,57,28,33,13,24,1,2,10,41,57,2,2,44,64,28,44,10,20,4,7,10,38,64
2012-07-30 00:00:00.000,Washington DC; USA ATP World Tour 500,HARD,2,James Blake,Marco Chiudinelli,James Blake,6-2; 6-4,R16,76,9,3,35,62,25,35,17,27,3,3,9,42,62,2,2,38,62,23,38,11,24,3,6,9,34,62
2012-07-30 00:00:00.000,Washington DC; USA ATP World Tour 500,HARD,2,Alexandr Dolgopolov,Ruben Ramirez Hidalgo,Alexandr Dolgopolov,6-1; 6-3,R16,55,15,0,29,44,26,29,8,15,0,0,8,34,44,3,4,32,51,18,32,7,19,3,7,8,25,51
2012-07-30 00:00:00.000,Washington DC; USA ATP World Tour 500,HARD,2,Mardy Fish,Xavier Malisse,Mardy Fish,6-3; 6-4,Q,81,10,2,27,65,20,27,25,38,2,2,10,45,65,2,3,30,50,23,30,9,20,0,2,9,32,50
2012-07-30 00:00:00.000,Washington DC; USA ATP World Tour 500,HARD,2,Tommy Haas,Tobias Kamke,Tommy Haas,6-1; 6-2,Q,67,4,6,19,43,16,19,16,24,0,0,8,32,43,3,3,23,44,10,23,10,21,1,5,7,20,44
2012-07-30 00:00:00.000,Washington DC; USA ATP World Tour 500,HARD,2,Sam Querrey,Kevin Anderson,Sam Querrey,6-4; 6-4,Q,81,7,2,26,55,22,26,20,29,0,0,10,42,55,11,5,33,56,22,33,14,23,0,2,10,36,56
2012-07-30 00:00:00.000,Washington DC; USA ATP World Tour 500,HARD,2,Alexandr Dolgopolov,James Blake,Alexandr Dolgopolov,7-6(3); 6-4,Q,83,7,3,41,64,31,41,11,23,4,7,11,42,64,8,3,45,81,29,45,16,36,5,9,11,45,81
2012-07-30 00:00:00.000,Washington DC; USA ATP World Tour 500,HARD,2,Tommy Haas,Mardy Fish,Tommy Haas,6-3; 7-5,S,93,8,1,30,57,28,30,18,27,3,3,11,46,57,11,4,24,59,22,24,16,35,1,3,10,38,59
2012-07-30 00:00:00.000,Washington DC; USA ATP World Tour 500,HARD,2,Alexandr Dolgopolov,Sam Querrey,Alexandr Dolgopolov,6-4; 6-4,S,75,8,1,36,62,31,36,14,26,5,5,10,45,62,6,6,29,61,24,29,15,32,1,3,10,39,61
2012-07-30 00:00:00.000,Washington DC; USA ATP World Tour 500,HARD,2,Alexandr Dolgopolov,Tommy Haas,Alexandr Dolgopolov,6-7(7); 6-4; 6-1,F,136,11,0,52,99,41,52,26,47,2,3,15,67,99,9,11,66,102,48,66,14,36,4,8,14,62,102
2012-08-06 00:00:00.000,ATP World Tour Masters 1000 Canada Toronto; Ontario ATP World Tour Masters 1000,HARD,2,Novak Djokovic,N/A Bye,Novak Djokovic,,R64,0,0,0,0,0,0,0,0,0,0,0,0,0,0,0,0,0,0,0,0,0,0,0,0,0,0,0
2012-08-06 00:00:00.000,ATP World Tour Masters 1000 Canada Toronto; Ontario ATP World Tour Masters 1000,HARD,2,Bernard Tomic,Michael Berrer,Bernard Tomic,6-3; 3-6; 6-3,R64,124,5,2,57,96,42,57,22,39,5,6,14,64,96,7,4,52,86,38,52,18,34,3,5,13,56,86
2012-08-06 00:00:00.000,ATP World Tour Masters 1000 Canada Toronto; Ontario ATP World Tour Masters 1000,HARD,2,Sam Querrey,Jurgen Melzer,Sam Querrey,6-3; 6-2,R64,58,11,3,28,47,24,28,14,19,1,1,9,38,47,2,1,22,45,14,22,12,23,3,6,8,26,45
2012-08-06 00:00:00.000,ATP World Tour Masters 1000 Canada Toronto; Ontario ATP World Tour Masters 1000,HARD,2,Kei Nishikori,N/A Bye,Kei Nishikori,,R64,0,0,0,0,0,0,0,0,0,0,0,0,0,0,0,0,0,0,0,0,0,0,0,0,0,0,0
2012-08-06 00:00:00.000,ATP World Tour Masters 1000 Canada Toronto; Ontario ATP World Tour Masters 1000,HARD,2,Gilles Simon,N/A Bye,Gilles Simon,,R64,0,0,0,0,0,0,0,0,0,0,0,0,0,0,0,0,0,0,0,0,0,0,0,0,0,0,0
2012-08-06 00:00:00.000,ATP World Tour Masters 1000 Canada Toronto; Ontario ATP World Tour Masters 1000,HARD,2,Tommy Haas,David Nalbandian,Tommy Haas,6-2; 6-7(11); 6-3,R64,143,7,6,53,98,45,53,23,45,4,5,14,68,98,4,7,56,103,38,56,23,47,6,11,15,61,103
2012-08-06 00:00:00.000,ATP World Tour Masters 1000 Canada Toronto; Ontario ATP World Tour Masters 1000,HARD,2,Radek Stepanek,Alexandr Dolgopolov,Radek Stepanek,6-3; 6-1,R64,66,4,1,26,48,22,26,14,22,3,3,8,36,48,4,1,29,58,16,29,13,29,5,9,8,29,58
2012-08-06 00:00:00.000,ATP World Tour Masters 1000 Canada Toronto; Ontario ATP World Tour Masters 1000,HARD,2,Juan Martin Del Potro,N/A Bye,Juan Martin Del Potro,,R64,0,0,0,0,0,0,0,0,0,0,0,0,0,0,0,0,0,0,0,0,0,0,0,0,0,0,0
2012-08-06 00:00:00.000,ATP World Tour Masters 1000 Canada Toronto; Ontario ATP World Tour Masters 1000,HARD,2,Jo-Wilfried Tsonga,N/A Bye,Jo-Wilfried Tsonga,,R64,0,0,0,0,0,0,0,0,0,0,0,0,0,0,0,0,0,0,0,0,0,0,0,0,0,0,0
2012-08-06 00:00:00.000,ATP World Tour Masters 1000 Canada Toronto; Ontario ATP World Tour Masters 1000,HARD,2,Jeremy Chardy,Donald Young,Jeremy Chardy,3-6; 7-6(4); 6-0,R64,132,7,6,55,83,41,55,11,28,4,8,13,52,83,1,4,67,114,45,67,15,47,6,12,14,60,114
2012-08-06 00:00:00.000,ATP World Tour Masters 1000 Canada Toronto; Ontario ATP World Tour Masters 1000,HARD,2,Marcel Granollers,Sergiy Stakhovsky,Marcel Granollers,4-6; 6-4; 6-3,R64,128,8,2,39,68,33,39,21,29,0,1,14,54,68,4,4,57,114,36,57,32,57,13,16,15,68,114
2012-08-06 00:00:00.000,ATP World Tour Masters 1000 Canada Toronto; Ontario ATP World Tour Masters 1000,HARD,2,Florian Mayer,N/A Bye,Florian Mayer,,R64,0,0,0,0,0,0,0,0,0,0,0,0,0,0,0,0,0,0,0,0,0,0,0,0,0,0,0
2012-08-06 00:00:00.000,ATP World Tour Masters 1000 Canada Toronto; Ontario ATP World Tour Masters 1000,HARD,2,Marin Cilic,N/A Bye,Marin Cilic,,R64,0,0,0,0,0,0,0,0,0,0,0,0,0,0,0,0,0,0,0,0,0,0,0,0,0,0,0
2012-08-06 00:00:00.000,ATP World Tour Masters 1000 Canada Toronto; Ontario ATP World Tour Masters 1000,HARD,2,Marcos Baghdatis,Carlos Berlocq,Marcos Baghdatis,6-4; 6-3,R64,97,3,4,34,63,23,34,19,29,1,2,10,42,63,3,2,26,64,17,26,19,38,7,10,9,36,64
2012-08-06 00:00:00.000,ATP World Tour Masters 1000 Canada Toronto; Ontario ATP World Tour Masters 1000,HARD,2,Mikhail Youzhny,Kevin Anderson,Mikhail Youzhny,6-1; 7-6(3),R64,91,6,1,39,65,28,39,14,26,3,5,10,42,65,10,3,34,58,20,34,10,24,1,5,9,30,58
2012-08-06 00:00:00.000,ATP World Tour Masters 1000 Canada Toronto; Ontario ATP World Tour Masters 1000,HARD,2,Janko Tipsarevic,N/A Bye,Janko Tipsarevic,,R64,0,0,0,0,0,0,0,0,0,0,0,0,0,0,0,0,0,0,0,0,0,0,0,0,0,0,0
2012-08-06 00:00:00.000,ATP World Tour Masters 1000 Canada Toronto; Ontario ATP World Tour Masters 1000,HARD,2,Juan Monaco,N/A Bye,Juan Monaco,,R64,0,0,0,0,0,0,0,0,0,0,0,0,0,0,0,0,0,0,0,0,0,0,0,0,0,0,0
2012-08-06 00:00:00.000,ATP World Tour Masters 1000 Canada Toronto; Ontario ATP World Tour Masters 1000,HARD,2,Vasek Pospisil,Andreas Seppi,Vasek Pospisil,4-6; 6-4; 7-6(6),R64,155,10,3,52,106,42,52,28,54,4,7,16,70,106,5,6,71,113,48,71,23,42,6,9,16,71,113
2012-08-06 00:00:00.000,ATP World Tour Masters 1000 Canada Toronto; Ontario ATP World Tour Masters 1000,HARD,2,Matthew Ebden,Peter Polansky,Matthew Ebden,0-6; 6-4; 6-3,R64,111,2,6,41,77,29,41,10,36,9,15,13,39,77,1,2,41,75,23,41,17,34,5,10,12,40,75
2012-08-06 00:00:00.000,ATP World Tour Masters 1000 Canada Toronto; Ontario ATP World Tour Masters 1000,HARD,2,Mardy Fish,N/A Bye,Mardy Fish,,R64,0,0,0,0,0,0,0,0,0,0,0,0,0,0,0,0,0,0,0,0,0,0,0,0,0,0,0
2012-08-06 00:00:00.000,ATP World Tour Masters 1000 Canada Toronto; Ontario ATP World Tour Masters 1000,HARD,2,Richard Gasquet,N/A Bye,Richard Gasquet,,R64,0,0,0,0,0,0,0,0,0,0,0,0,0,0,0,0,0,0,0,0,0,0,0,0,0,0,0
2012-08-06 00:00:00.000,ATP World Tour Masters 1000 Canada Toronto; Ontario ATP World Tour Masters 1000,HARD,2,Mikhail Kukushkin,Frank Dancevic,Mikhail Kukushkin,6-3; 7-5,R64,86,7,0,34,59,30,34,14,25,0,0,11,44,59,6,5,38,68,27,38,14,30,2,4,10,41,68
2012-08-06 00:00:00.000,ATP World Tour Masters 1000 Canada Toronto; Ontario ATP World Tour Masters 1000,HARD,2,Julien Benneteau,Wayne Odesnik,Julien Benneteau,6-4; 6-4,R64,90,8,3,38,61,33,38,11,23,1,1,10,44,61,4,2,38,65,29,38,12,27,7,9,10,41,65
2012-08-06 00:00:00.000,ATP World Tour Masters 1000 Canada Toronto; Ontario ATP World Tour Masters 1000,HARD,2,Tomas Berdych,N/A Bye,Tomas Berdych,,R64,0,0,0,0,0,0,0,0,0,0,0,0,0,0,0,0,0,0,0,0,0,0,0,0,0,0,0
2012-08-06 00:00:00.000,ATP World Tour Masters 1000 Canada Toronto; Ontario ATP World Tour Masters 1000,HARD,2,John Isner,N/A Bye,John Isner,,R64,0,0,0,0,0,0,0,0,0,0,0,0,0,0,0,0,0,0,0,0,0,0,0,0,0,0,0
2012-08-06 00:00:00.000,ATP World Tour Masters 1000 Canada Toronto; Ontario ATP World Tour Masters 1000,HARD,2,Pablo Andujar,Lukas Lacko,Pablo Andujar,6-2; 4-6; 6-2,R64,128,3,7,54,90,36,54,18,36,7,10,13,54,90,4,3,41,84,28,41,16,43,8,14,13,44,84
2012-08-06 00:00:00.000,ATP World Tour Masters 1000 Canada Toronto; Ontario ATP World Tour Masters 1000,HARD,2,Fabio Fognini,Yen-Hsun Lu,Fabio Fognini,7-6(7); 5-7; 7-6(5),R64,178,5,9,86,141,62,86,24,55,7,11,18,86,141,4,5,58,110,43,58,30,52,3,6,18,73,110
2012-08-06 00:00:00.000,ATP World Tour Masters 1000 Canada Toronto; Ontario ATP World Tour Masters 1000,HARD,2,Philipp Kohlschreiber,N/A Bye,Philipp Kohlschreiber,,R64,0,0,0,0,0,0,0,0,0,0,0,0,0,0,0,0,0,0,0,0,0,0,0,0,0,0,0
2012-08-06 00:00:00.000,ATP World Tour Masters 1000 Canada Toronto; Ontario ATP World Tour Masters 1000,HARD,2,Milos Raonic,N/A Bye,Milos Raonic,,R64,0,0,0,0,0,0,0,0,0,0,0,0,0,0,0,0,0,0,0,0,0,0,0,0,0,0,0
2012-08-06 00:00:00.000,ATP World Tour Masters 1000 Canada Toronto; Ontario ATP World Tour Masters 1000,HARD,2,Viktor Troicki,Alex Bogomolov Jr.,Viktor Troicki,6-4; 7-6(5),R64,110,16,3,49,75,35,49,9,26,4,7,11,44,75,0,4,53,85,34,53,11,32,6,10,11,45,85
2012-08-06 00:00:00.000,ATP World Tour Masters 1000 Canada Toronto; Ontario ATP World Tour Masters 1000,HARD,2,Flavio Cipolla,Jurgen Zopp,Flavio Cipolla,6-1; 6-2,R64,77,1,1,50,58,35,50,4,8,6,6,8,39,58,0,1,26,45,15,26,6,19,1,5,7,21,45
2012-08-06 00:00:00.000,ATP World Tour Masters 1000 Canada Toronto; Ontario ATP World Tour Masters 1000,HARD,2,Andy Murray,N/A Bye,Andy Murray,,R64,0,0,0,0,0,0,0,0,0,0,0,0,0,0,0,0,0,0,0,0,0,0,0,0,0,0,0
2012-08-06 00:00:00.000,ATP World Tour Masters 1000 Canada Toronto; Ontario ATP World Tour Masters 1000,HARD,2,Novak Djokovic,Bernard Tomic,Novak Djokovic,6-2; 6-3,R32,71,7,1,36,54,29,36,11,18,6,6,9,40,54,4,1,39,60,25,39,8,21,6,9,8,33,60
2012-08-06 00:00:00.000,ATP World Tour Masters 1000 Canada Toronto; Ontario ATP World Tour Masters 1000,HARD,2,Sam Querrey,Kei Nishikori,Sam Querrey,6-2; 6-3,R32,72,12,3,33,66,29,33,16,33,9,9,9,45,66,1,2,28,48,20,28,8,20,4,7,8,28,48
2012-08-06 00:00:00.000,ATP World Tour Masters 1000 Canada Toronto; Ontario ATP World Tour Masters 1000,HARD,2,Tommy Haas,Gilles Simon,Tommy Haas,6-2; 6-3,R32,78,7,0,31,42,27,31,7,11,1,1,8,34,42,3,2,29,69,19,29,17,40,7,11,9,36,69
2012-08-06 00:00:00.000,ATP World Tour Masters 1000 Canada Toronto; Ontario ATP World Tour Masters 1000,HARD,2,Radek Stepanek,Juan Martin Del Potro,Radek Stepanek,6-4; 7-6(5),R32,111,9,0,46,76,34,46,14,30,3,6,11,48,76,4,5,38,73,26,38,13,35,5,9,11,39,73
2012-08-06 00:00:00.000,ATP World Tour Masters 1000 Canada Toronto; Ontario ATP World Tour Masters 1000,HARD,2,Jeremy Chardy,Jo-Wilfried Tsonga,Jeremy Chardy,6-4; 7-6(4),R32,88,10,6,42,77,34,42,21,35,3,3,11,55,77,8,4,48,66,40,48,8,18,0,1,11,48,66
2012-08-06 00:00:00.000,ATP World Tour Masters 1000 Canada Toronto; Ontario ATP World Tour Masters 1000,HARD,2,Marcel Granollers,Florian Mayer,Marcel Granollers,6-3; 6-4,R32,80,9,2,39,64,31,39,13,25,4,5,10,44,64,0,1,29,50,19,29,10,21,2,5,9,29,50
2012-08-06 00:00:00.000,ATP World Tour Masters 1000 Canada Toronto; Ontario ATP World Tour Masters 1000,HARD,2,Marin Cilic,Marcos Baghdatis,Marin Cilic,7-5; 6-3,R32,82,7,3,39,64,28,39,13,25,3,5,11,41,64,10,1,34,57,27,34,5,23,2,6,10,32,57
2012-08-06 00:00:00.000,ATP World Tour Masters 1000 Canada Toronto; Ontario ATP World Tour Masters 1000,HARD,2,Janko Tipsarevic,Mikhail Youzhny,Janko Tipsarevic,7-6(2); 6-4,R32,103,5,2,35,62,29,35,15,27,1,3,11,44,62,2,3,37,65,28,37,14,28,2,5,11,42,65
2012-08-06 00:00:00.000,ATP World Tour Masters 1000 Canada Toronto; Ontario ATP World Tour Masters 1000,HARD,2,Juan Monaco,Vasek Pospisil,Juan Monaco,7-5; 6-4,R32,110,4,4,40,70,25,40,15,30,4,8,11,40,70,7,4,37,75,22,37,15,38,6,12,11,37,75
2012-08-06 00:00:00.000,ATP World Tour Masters 1000 Canada Toronto; Ontario ATP World Tour Masters 1000,HARD,2,Mardy Fish,Matthew Ebden,Mardy Fish,6-2; 6-0,R32,53,4,5,16,35,16,16,12,19,0,0,7,28,35,1,2,19,38,10,19,6,19,2,7,7,16,38
2012-08-06 00:00:00.000,ATP World Tour Masters 1000 Canada Toronto; Ontario ATP World Tour Masters 1000,HARD,2,Richard Gasquet,Mikhail Kukushkin,Richard Gasquet,6-3; 7-5,R32,86,6,3,37,56,29,37,13,19,0,1,11,42,56,6,2,35,69,22,35,19,34,5,8,10,41,69
2012-08-06 00:00:00.000,ATP World Tour Masters 1000 Canada Toronto; Ontario ATP World Tour Masters 1000,HARD,2,Tomas Berdych,Julien Benneteau,Tomas Berdych,6-7(10); 6-4; 6-4,R32,184,20,3,55,95,48,55,25,40,0,0,16,73,95,9,5,78,139,57,78,31,61,11,13,16,88,139
2012-08-06 00:00:00.000,ATP World Tour Masters 1000 Canada Toronto; Ontario ATP World Tour Masters 1000,HARD,2,John Isner,Pablo Andujar,John Isner,7-6(5); 7-5,R32,109,17,4,46,80,35,46,21,34,1,2,12,56,80,1,3,48,74,36,48,14,26,1,3,12,50,74
2012-08-06 00:00:00.000,ATP World Tour Masters 1000 Canada Toronto; Ontario ATP World Tour Masters 1000,HARD,2,Philipp Kohlschreiber,Fabio Fognini,Philipp Kohlschreiber,6-2; 6-2,R32,60,1,0,34,52,25,34,11,18,5,5,8,36,52,0,1,26,43,12,26,9,17,2,6,8,21,43
2012-08-06 00:00:00.000,ATP World Tour Masters 1000 Canada Toronto; Ontario ATP World Tour Masters 1000,HARD,2,Milos Raonic,Viktor Troicki,Milos Raonic,6-3; 6-4,R32,69,7,3,28,53,24,28,18,25,0,0,10,42,53,2,1,31,53,21,31,13,22,0,2,9,34,53
2012-08-06 00:00:00.000,ATP World Tour Masters 1000 Canada Toronto; Ontario ATP World Tour Masters 1000,HARD,2,Andy Murray,Flavio Cipolla,Andy Murray,6-1; 6-3,R32,82,4,1,30,60,19,30,20,30,6,6,8,39,60,0,4,36,55,23,36,5,19,5,9,8,28,55
2012-08-06 00:00:00.000,ATP World Tour Masters 1000 Canada Toronto; Ontario ATP World Tour Masters 1000,HARD,2,Novak Djokovic,Sam Querrey,Novak Djokovic,6-4; 6-4,R16,75,5,3,39,63,31,39,13,24,1,1,10,44,63,3,3,29,54,22,29,14,25,2,4,10,36,54
2012-08-06 00:00:00.000,ATP World Tour Masters 1000 Canada Toronto; Ontario ATP World Tour Masters 1000,HARD,2,Tommy Haas,Radek Stepanek,Tommy Haas,2-6; 6-4; 6-1,R16,124,6,2,45,74,32,45,17,29,5,7,13,49,74,5,1,40,78,29,40,20,38,6,9,12,49,78
2012-08-06 00:00:00.000,ATP World Tour Masters 1000 Canada Toronto; Ontario ATP World Tour Masters 1000,HARD,2,Marcel Granollers,Jeremy Chardy,Marcel Granollers,6-1; 6-4,R16,93,9,3,46,71,34,46,10,25,5,6,9,44,71,3,4,31,53,19,31,7,22,9,13,8,26,53
2012-08-06 00:00:00.000,ATP World Tour Masters 1000 Canada Toronto; Ontario ATP World Tour Masters 1000,HARD,2,Janko Tipsarevic,Marin Cilic,Janko Tipsarevic,6-2; 6-4,R16,74,1,2,30,54,24,30,14,24,4,4,9,38,54,4,1,33,52,20,33,10,19,1,4,9,30,52
2012-08-06 00:00:00.000,ATP World Tour Masters 1000 Canada Toronto; Ontario ATP World Tour Masters 1000,HARD,2,Mardy Fish,Juan Monaco,Mardy Fish,2-6; 6-1; 6-4,R16,135,5,7,42,89,35,42,22,47,6,8,13,57,89,1,1,44,75,28,44,15,31,4,7,12,43,75
2012-08-06 00:00:00.000,ATP World Tour Masters 1000 Canada Toronto; Ontario ATP World Tour Masters 1000,HARD,2,Richard Gasquet,Tomas Berdych,Richard Gasquet,6-4; 6-2,R16,84,6,2,30,50,25,30,8,20,1,2,9,33,50,5,5,31,61,21,31,13,30,7,11,9,34,61
2012-08-06 00:00:00.000,ATP World Tour Masters 1000 Canada Toronto; Ontario ATP World Tour Masters 1000,HARD,2,John Isner,Philipp Kohlschreiber,John Isner,6-7(3); 6-4; 6-4,R16,119,22,4,66,91,50,66,14,25,2,4,16,64,91,6,3,61,102,41,61,23,41,6,10,16,64,102
2012-08-06 00:00:00.000,ATP World Tour Masters 1000 Canada Toronto; Ontario ATP World Tour Masters 1000,HARD,2,Milos Raonic,Andy Murray,Milos Raonic,W/O,R16,0,0,0,0,0,0,0,0,0,0,0,0,0,0,0,0,0,0,0,0,0,0,0,0,0,0,0
2012-08-06 00:00:00.000,ATP World Tour Masters 1000 Canada Toronto; Ontario ATP World Tour Masters 1000,HARD,2,Novak Djokovic,Tommy Haas,Novak Djokovic,6-3; 3-6; 6-3,Q,153,4,2,53,96,39,53,26,43,7,8,14,65,96,3,6,56,99,37,56,24,43,8,10,13,61,99
2012-08-06 00:00:00.000,ATP World Tour Masters 1000 Canada Toronto; Ontario ATP World Tour Masters 1000,HARD,2,Janko Tipsarevic,Marcel Granollers,Janko Tipsarevic,6-4; 6-4,Q,98,5,1,32,53,24,32,17,21,3,3,10,41,53,1,1,34,68,22,34,19,34,3,5,10,41,68
2012-08-06 00:00:00.000,ATP World Tour Masters 1000 Canada Toronto; Ontario ATP World Tour Masters 1000,HARD,2,Richard Gasquet,Mardy Fish,Richard Gasquet,5-7; 6-1; 6-2,Q,127,10,2,46,86,35,46,19,40,5,8,14,54,86,5,1,35,80,21,35,21,45,9,15,13,42,80
2012-08-06 00:00:00.000,ATP World Tour Masters 1000 Canada Toronto; Ontario ATP World Tour Masters 1000,HARD,2,John Isner,Milos Raonic,John Isner,7-6(9); 6-4,Q,91,8,5,47,69,43,47,9,22,0,1,11,52,69,13,5,50,73,39,50,9,23,4,6,11,48,73
2012-08-06 00:00:00.000,ATP World Tour Masters 1000 Canada Toronto; Ontario ATP World Tour Masters 1000,HARD,2,Novak Djokovic,Janko Tipsarevic,Novak Djokovic,6-4; 6-1,S,106,3,3,33,62,30,33,14,29,7,7,9,44,62,2,1,34,69,19,34,18,35,3,6,8,37,69
2012-08-06 00:00:00.000,ATP World Tour Masters 1000 Canada Toronto; Ontario ATP World Tour Masters 1000,HARD,2,Richard Gasquet,John Isner,Richard Gasquet,7-6(3); 6-3,S,81,4,1,45,59,39,45,10,14,0,0,11,49,59,5,1,49,72,36,49,12,23,4,5,10,48,72
2012-08-06 00:00:00.000,ATP World Tour Masters 1000 Canada Toronto; Ontario ATP World Tour Masters 1000,HARD,2,Novak Djokovic,Richard Gasquet,Novak Djokovic,6-3; 6-2,F,62,5,0,31,46,26,31,12,15,4,4,9,38,46,3,1,25,42,19,25,5,17,0,3,8,24,42
2012-08-12 00:00:00.000,ATP World Tour Masters 1000 Cincinnati OH; U.S.A. ATP World Tour Masters 1000,HARD,2,Roger Federer,N/A Bye,Roger Federer,,R64,0,0,0,0,0,0,0,0,0,0,0,0,0,0,0,0,0,0,0,0,0,0,0,0,0,0,0
2012-08-12 00:00:00.000,ATP World Tour Masters 1000 Cincinnati OH; U.S.A. ATP World Tour Masters 1000,HARD,2,Alex Bogomolov Jr.,Jarkko Nieminen,Alex Bogomolov Jr.,6-4; 6-3,R64,69,2,2,40,58,30,40,10,18,3,3,9,40,58,4,0,35,51,25,35,7,16,1,4,10,32,51
2012-08-12 00:00:00.000,ATP World Tour Masters 1000 Cincinnati OH; U.S.A. ATP World Tour Masters 1000,HARD,2,Bernard Tomic,Ryan Harrison,Bernard Tomic,6-4; 7-6(5),R64,92,3,1,51,75,37,51,14,24,4,5,11,51,75,6,2,55,76,36,55,12,21,5,7,11,48,76
2012-08-12 00:00:00.000,ATP World Tour Masters 1000 Cincinnati OH; U.S.A. ATP World Tour Masters 1000,HARD,2,Brian Baker,Philipp Kohlschreiber,Brian Baker,7-6(7); 7-6(3),R64,106,6,5,53,81,42,53,14,28,0,1,12,56,81,10,0,47,81,33,47,23,34,2,3,12,56,81
2012-08-12 00:00:00.000,ATP World Tour Masters 1000 Cincinnati OH; U.S.A. ATP World Tour Masters 1000,HARD,2,Mardy Fish,Feliciano Lopez,Mardy Fish,6-2; 6-3,R64,83,11,1,38,67,30,38,15,29,3,3,9,45,67,5,5,24,57,14,24,17,33,8,11,8,31,57
2012-08-12 00:00:00.000,ATP World Tour Masters 1000 Cincinnati OH; U.S.A. ATP World Tour Masters 1000,HARD,2,Carlos Berlocq,Santiago Giraldo,Carlos Berlocq,7-5; 6-3,R64,91,9,0,40,64,27,40,14,24,3,5,11,41,64,0,1,26,54,19,26,12,28,2,6,10,31,54
2012-08-12 00:00:00.000,ATP World Tour Masters 1000 Cincinnati OH; U.S.A. ATP World Tour Masters 1000,HARD,2,Radek Stepanek,Albert Ramos-Vinolas,Radek Stepanek,6-2; 6-2,R64,62,3,2,26,39,20,26,10,13,0,1,8,30,39,0,4,32,51,17,32,5,19,3,8,8,22,51
2012-08-12 00:00:00.000,ATP World Tour Masters 1000 Cincinnati OH; U.S.A. ATP World Tour Masters 1000,HARD,2,Juan Monaco,N/A Bye,Juan Monaco,,R64,0,0,0,0,0,0,0,0,0,0,0,0,0,0,0,0,0,0,0,0,0,0,0,0,0,0,0
2012-08-12 00:00:00.000,ATP World Tour Masters 1000 Cincinnati OH; U.S.A. ATP World Tour Masters 1000,HARD,2,David Ferrer,N/A Bye,David Ferrer,,R64,0,0,0,0,0,0,0,0,0,0,0,0,0,0,0,0,0,0,0,0,0,0,0,0,0,0,0
2012-08-12 00:00:00.000,ATP World Tour Masters 1000 Cincinnati OH; U.S.A. ATP World Tour Masters 1000,HARD,2,Stan Wawrinka,Paul-Henri Mathieu,Stan Wawrinka,6-2; 3-6; 6-1,R64,105,8,3,38,81,25,38,27,43,8,10,12,52,81,3,6,48,78,30,48,12,30,9,14,12,42,78
2012-08-12 00:00:00.000,ATP World Tour Masters 1000 Cincinnati OH; U.S.A. ATP World Tour Masters 1000,HARD,2,James Blake,Kevin Anderson,James Blake,7-5; 6-4,R64,86,8,3,42,70,29,42,14,28,2,4,11,43,70,8,1,43,69,29,43,10,26,6,10,11,39,69
2012-08-12 00:00:00.000,ATP World Tour Masters 1000 Cincinnati OH; U.S.A. ATP World Tour Masters 1000,HARD,2,Kei Nishikori,Marcel Granollers,Kei Nishikori,6-1; 6-2,R64,65,4,4,30,51,25,30,11,21,5,5,8,36,51,2,0,26,43,15,26,5,17,4,8,7,20,43
2012-08-12 00:00:00.000,ATP World Tour Masters 1000 Cincinnati OH; U.S.A. ATP World Tour Masters 1000,HARD,2,Marcos Baghdatis,Alejandro Falla,Marcos Baghdatis,6-4; 6-1,R64,64,1,3,26,43,20,26,11,17,0,1,8,31,43,4,1,28,48,17,28,7,20,1,6,9,24,48
2012-08-12 00:00:00.000,ATP World Tour Masters 1000 Cincinnati OH; U.S.A. ATP World Tour Masters 1000,HARD,2,Milos Raonic,Richard Gasquet,Milos Raonic,7-6(4); 6-3,R64,90,12,2,40,69,33,40,17,29,4,4,11,50,69,4,2,43,66,32,43,10,23,3,4,10,42,66
2012-08-12 00:00:00.000,ATP World Tour Masters 1000 Cincinnati OH; U.S.A. ATP World Tour Masters 1000,HARD,2,Yen-Hsun Lu,Lukasz Kubot,Yen-Hsun Lu,6-3; 6-0,R64,87,3,3,36,52,27,36,8,16,3,3,7,35,52,4,7,35,62,21,35,8,27,9,14,8,29,62
2012-08-12 00:00:00.000,ATP World Tour Masters 1000 Cincinnati OH; U.S.A. ATP World Tour Masters 1000,HARD,2,Tomas Berdych,N/A Bye,Tomas Berdych,,R64,0,0,0,0,0,0,0,0,0,0,0,0,0,0,0,0,0,0,0,0,0,0,0,0,0,0,0
2012-08-12 00:00:00.000,ATP World Tour Masters 1000 Cincinnati OH; U.S.A. ATP World Tour Masters 1000,HARD,2,Juan Martin Del Potro,N/A Bye,Juan Martin Del Potro,,R64,0,0,0,0,0,0,0,0,0,0,0,0,0,0,0,0,0,0,0,0,0,0,0,0,0,0,0
2012-08-12 00:00:00.000,ATP World Tour Masters 1000 Cincinnati OH; U.S.A. ATP World Tour Masters 1000,HARD,2,Tommy Haas,David Nalbandian,Tommy Haas,6-7(0); 7-6(4); 6-3,R64,202,21,9,85,141,63,85,23,56,11,13,17,86,141,8,5,75,147,53,75,36,72,10,13,16,89,147
2012-08-12 00:00:00.000,ATP World Tour Masters 1000 Cincinnati OH; U.S.A. ATP World Tour Masters 1000,HARD,2,Lleyton Hewitt,Mikhail Youzhny,Lleyton Hewitt,6-4; 6-4,R64,87,3,4,30,61,24,30,18,31,7,8,10,42,61,2,3,31,62,23,31,14,31,3,6,10,37,62
2012-08-12 00:00:00.000,ATP World Tour Masters 1000 Cincinnati OH; U.S.A. ATP World Tour Masters 1000,HARD,2,Viktor Troicki,Ivan Dodig,Viktor Troicki,6-4; 7-5,R64,107,8,7,42,77,29,42,15,35,3,6,11,44,77,4,4,36,69,24,36,12,33,1,6,11,36,69
2012-08-12 00:00:00.000,ATP World Tour Masters 1000 Cincinnati OH; U.S.A. ATP World Tour Masters 1000,HARD,2,Jeremy Chardy,Andy Roddick,Jeremy Chardy,7-6(4); 6-3,R64,94,7,0,32,62,28,32,19,30,1,1,10,47,62,7,4,46,75,34,46,11,29,4,6,11,45,75
2012-08-12 00:00:00.000,ATP World Tour Masters 1000 Cincinnati OH; U.S.A. ATP World Tour Masters 1000,HARD,2,Denis Istomin,Julien Benneteau,Denis Istomin,6-3; 6-1,R64,62,11,1,33,46,27,33,7,13,0,0,8,34,46,5,4,30,50,17,30,8,20,1,5,8,25,50
2012-08-12 00:00:00.000,ATP World Tour Masters 1000 Cincinnati OH; U.S.A. ATP World Tour Masters 1000,HARD,2,Sam Querrey,Jurgen Melzer,Sam Querrey,4-6; 6-2; 6-4,R64,97,16,7,44,77,36,44,20,33,2,4,14,56,77,6,3,50,84,33,50,19,34,4,8,14,52,84
2012-08-12 00:00:00.000,ATP World Tour Masters 1000 Cincinnati OH; U.S.A. ATP World Tour Masters 1000,HARD,2,Andy Murray,N/A Bye,Andy Murray,,R64,0,0,0,0,0,0,0,0,0,0,0,0,0,0,0,0,0,0,0,0,0,0,0,0,0,0,0
2012-08-12 00:00:00.000,ATP World Tour Masters 1000 Cincinnati OH; U.S.A. ATP World Tour Masters 1000,HARD,2,Janko Tipsarevic,N/A Bye,Janko Tipsarevic,,R64,0,0,0,0,0,0,0,0,0,0,0,0,0,0,0,0,0,0,0,0,0,0,0,0,0,0,0
2012-08-12 00:00:00.000,ATP World Tour Masters 1000 Cincinnati OH; U.S.A. ATP World Tour Masters 1000,HARD,2,Pablo Andujar,Marinko Matosevic,Pablo Andujar,6-4; 6-3,R64,84,3,2,32,52,26,32,12,20,2,2,9,38,52,5,1,27,51,19,27,10,24,0,3,10,29,51
2012-08-12 00:00:00.000,ATP World Tour Masters 1000 Cincinnati OH; U.S.A. ATP World Tour Masters 1000,HARD,2,Jesse Levine,Donald Young,Jesse Levine,6-4; 7-6(2),R64,96,3,4,41,76,30,41,17,35,4,6,11,47,76,2,4,46,76,27,46,14,30,4,7,11,41,76
2012-08-12 00:00:00.000,ATP World Tour Masters 1000 Cincinnati OH; U.S.A. ATP World Tour Masters 1000,HARD,2,Marin Cilic,Sergiy Stakhovsky,Marin Cilic,6-3; 4-6; 6-4,R64,117,7,2,43,82,33,43,22,39,1,4,15,55,82,11,6,53,90,38,53,16,37,7,11,14,54,90
2012-08-12 00:00:00.000,ATP World Tour Masters 1000 Cincinnati OH; U.S.A. ATP World Tour Masters 1000,HARD,2,Nikolay Davydenko,Alexandr Dolgopolov,Nikolay Davydenko,6-1; 6-1,R64,53,0,1,23,36,20,23,8,13,0,0,7,28,36,3,4,29,53,18,29,5,24,5,10,7,23,53
2012-08-12 00:00:00.000,ATP World Tour Masters 1000 Cincinnati OH; U.S.A. ATP World Tour Masters 1000,HARD,2,Florian Mayer,Fabio Fognini,Florian Mayer,7-5; 6-2,R64,73,4,0,37,64,28,37,12,27,2,4,10,40,64,0,5,37,64,21,37,13,27,7,12,10,34,64
2012-08-12 00:00:00.000,ATP World Tour Masters 1000 Cincinnati OH; U.S.A. ATP World Tour Masters 1000,HARD,2,Andreas Seppi,Robin Haase,Andreas Seppi,6-4; 6-4,R64,78,2,0,42,59,30,42,10,17,2,3,10,40,59,10,4,37,67,27,37,12,30,0,3,10,39,67
2012-08-12 00:00:00.000,ATP World Tour Masters 1000 Cincinnati OH; U.S.A. ATP World Tour Masters 1000,HARD,2,Novak Djokovic,N/A Bye,Novak Djokovic,,R64,0,0,0,0,0,0,0,0,0,0,0,0,0,0,0,0,0,0,0,0,0,0,0,0,0,0,0
2012-08-12 00:00:00.000,ATP World Tour Masters 1000 Cincinnati OH; U.S.A. ATP World Tour Masters 1000,HARD,2,Roger Federer,Alex Bogomolov Jr.,Roger Federer,6-3; 6-2,R32,61,12,2,30,51,25,30,14,21,1,1,9,39,51,1,2,38,49,21,38,5,11,1,4,8,26,49
2012-08-12 00:00:00.000,ATP World Tour Masters 1000 Cincinnati OH; U.S.A. ATP World Tour Masters 1000,HARD,2,Bernard Tomic,Brian Baker,Bernard Tomic,6-4; 6-3,R32,76,7,2,48,76,38,48,13,28,6,6,10,51,76,2,3,26,51,18,26,14,25,2,4,9,32,51
2012-08-12 00:00:00.000,ATP World Tour Masters 1000 Cincinnati OH; U.S.A. ATP World Tour Masters 1000,HARD,2,Mardy Fish,Carlos Berlocq,Mardy Fish,6-3; 6-1,R32,77,5,1,22,48,17,22,16,26,3,4,8,33,48,1,5,32,48,15,32,7,16,4,9,8,22,48
2012-08-12 00:00:00.000,ATP World Tour Masters 1000 Cincinnati OH; U.S.A. ATP World Tour Masters 1000,HARD,2,Radek Stepanek,Juan Monaco,Radek Stepanek,7-6(2); 6-1,R32,94,6,5,32,63,23,32,16,31,0,3,10,39,63,0,4,37,64,17,37,12,27,1,6,9,29,64
2012-08-12 00:00:00.000,ATP World Tour Masters 1000 Cincinnati OH; U.S.A. ATP World Tour Masters 1000,HARD,2,Stan Wawrinka,David Ferrer,Stan Wawrinka,6-4; 6-1,R32,73,9,1,27,42,25,27,9,15,2,2,8,34,42,1,4,37,67,17,37,18,30,6,10,9,35,67
2012-08-12 00:00:00.000,ATP World Tour Masters 1000 Cincinnati OH; U.S.A. ATP World Tour Masters 1000,HARD,2,Kei Nishikori,James Blake,Kei Nishikori,2-6; 6-4; 6-4,R32,98,1,2,52,76,38,52,8,24,1,5,14,46,76,5,3,41,76,29,41,20,35,2,6,14,49,76
2012-08-12 00:00:00.000,ATP World Tour Masters 1000 Cincinnati OH; U.S.A. ATP World Tour Masters 1000,HARD,2,Milos Raonic,Marcos Baghdatis,Milos Raonic,6-7(6); 6-3; 6-4,R32,136,22,4,70,107,57,70,20,37,6,6,16,77,107,7,1,35,90,30,35,34,55,1,3,15,64,90
2012-08-12 00:00:00.000,ATP World Tour Masters 1000 Cincinnati OH; U.S.A. ATP World Tour Masters 1000,HARD,2,Tomas Berdych,Yen-Hsun Lu,Tomas Berdych,6-3; 6-4,R32,87,8,1,38,60,30,38,12,22,2,3,10,42,60,2,3,28,56,17,28,16,28,4,7,9,33,56
2012-08-12 00:00:00.000,ATP World Tour Masters 1000 Cincinnati OH; U.S.A. ATP World Tour Masters 1000,HARD,2,Juan Martin Del Potro,Tommy Haas,Juan Martin Del Potro,7-5; 6-2,R32,97,9,4,43,71,32,43,15,28,4,5,10,47,71,8,5,24,58,19,24,14,34,3,7,10,33,58
2012-08-12 00:00:00.000,ATP World Tour Masters 1000 Cincinnati OH; U.S.A. ATP World Tour Masters 1000,HARD,2,Viktor Troicki,Lleyton Hewitt,Viktor Troicki,6-2; 6-0,R32,62,5,3,30,49,25,30,8,19,3,3,7,33,49,0,2,21,48,10,21,10,27,5,10,7,20,48
2012-08-12 00:00:00.000,ATP World Tour Masters 1000 Cincinnati OH; U.S.A. ATP World Tour Masters 1000,HARD,2,Jeremy Chardy,Denis Istomin,Jeremy Chardy,6-4; 6-3,R32,83,3,3,24,53,20,24,17,29,2,2,9,37,53,2,3,43,71,26,43,14,28,8,11,10,40,71
2012-08-12 00:00:00.000,ATP World Tour Masters 1000 Cincinnati OH; U.S.A. ATP World Tour Masters 1000,HARD,2,Andy Murray,Sam Querrey,Andy Murray,6-2; 6-4,R32,76,7,0,28,52,21,28,18,24,2,2,9,39,52,9,2,45,68,30,45,9,23,5,8,9,39,68
2012-08-12 00:00:00.000,ATP World Tour Masters 1000 Cincinnati OH; U.S.A. ATP World Tour Masters 1000,HARD,2,Pablo Andujar,Janko Tipsarevic,Pablo Andujar,6-4; 4-1 RET,R32,71,1,3,28,44,23,28,8,16,2,3,8,31,44,5,2,22,44,19,22,7,22,3,6,7,26,44
2012-08-12 00:00:00.000,ATP World Tour Masters 1000 Cincinnati OH; U.S.A. ATP World Tour Masters 1000,HARD,2,Marin Cilic,Jesse Levine,Marin Cilic,7-5; 7-6(6),R32,101,7,5,38,70,30,38,17,32,3,5,12,47,70,3,2,43,73,31,43,14,30,3,6,12,45,73
2012-08-12 00:00:00.000,ATP World Tour Masters 1000 Cincinnati OH; U.S.A. ATP World Tour Masters 1000,HARD,2,Nikolay Davydenko,Florian Mayer,Nikolay Davydenko,6-3; 6-3,R32,71,1,1,41,54,29,41,9,13,2,2,9,38,54,0,1,39,64,26,39,11,25,7,10,9,37,64
2012-08-12 00:00:00.000,ATP World Tour Masters 1000 Cincinnati OH; U.S.A. ATP World Tour Masters 1000,HARD,2,Novak Djokovic,Andreas Seppi,Novak Djokovic,7-6(4); 6-2,R32,90,6,0,34,59,27,34,18,25,0,0,10,45,59,3,3,41,78,26,41,19,37,8,10,10,45,78
2012-08-12 00:00:00.000,ATP World Tour Masters 1000 Cincinnati OH; U.S.A. ATP World Tour Masters 1000,HARD,2,Roger Federer,Bernard Tomic,Roger Federer,6-2; 6-4,R16,62,7,1,28,50,23,28,14,22,0,0,9,37,50,7,1,43,64,28,43,10,21,3,6,9,38,64
2012-08-12 00:00:00.000,ATP World Tour Masters 1000 Cincinnati OH; U.S.A. ATP World Tour Masters 1000,HARD,2,Mardy Fish,Radek Stepanek,Mardy Fish,6-3; 6-3,R16,94,7,1,30,53,23,30,15,23,2,2,9,38,53,2,4,38,63,23,38,13,25,5,8,9,36,63
2012-08-12 00:00:00.000,ATP World Tour Masters 1000 Cincinnati OH; U.S.A. ATP World Tour Masters 1000,HARD,2,Stan Wawrinka,Kei Nishikori,Stan Wawrinka,6-3; 6-3,R16,74,9,1,26,50,24,26,13,24,1,2,9,37,50,0,2,31,52,18,31,12,21,1,5,9,30,52
2012-08-12 00:00:00.000,ATP World Tour Masters 1000 Cincinnati OH; U.S.A. ATP World Tour Masters 1000,HARD,2,Milos Raonic,Tomas Berdych,Milos Raonic,6-4; 2-6; 6-2,R16,113,20,4,43,66,36,43,11,23,3,5,13,47,66,5,5,39,80,28,39,22,41,5,8,13,50,80
2012-08-12 00:00:00.000,ATP World Tour Masters 1000 Cincinnati OH; U.S.A. ATP World Tour Masters 1000,HARD,2,Juan Martin Del Potro,Viktor Troicki,Juan Martin Del Potro,7-6(2); 2-6; 6-1,R16,137,4,3,59,91,40,59,15,32,4,9,14,55,91,5,3,48,86,35,48,12,38,4,9,13,47,86
2012-08-12 00:00:00.000,ATP World Tour Masters 1000 Cincinnati OH; U.S.A. ATP World Tour Masters 1000,HARD,2,Jeremy Chardy,Andy Murray,Jeremy Chardy,6-4; 6-4,R16,98,4,3,41,72,29,41,14,31,5,7,10,43,72,10,1,36,66,23,36,14,30,4,8,10,37,66
2012-08-12 00:00:00.000,ATP World Tour Masters 1000 Cincinnati OH; U.S.A. ATP World Tour Masters 1000,HARD,2,Marin Cilic,Pablo Andujar,Marin Cilic,7-6(4); 6-2,R16,131,6,4,30,69,21,30,21,39,1,4,10,42,69,1,8,48,89,29,48,14,41,4,9,10,43,89
2012-08-12 00:00:00.000,ATP World Tour Masters 1000 Cincinnati OH; U.S.A. ATP World Tour Masters 1000,HARD,2,Novak Djokovic,Nikolay Davydenko,Novak Djokovic,6-0 RET,R16,33,2,0,14,19,12,14,1,5,0,0,3,13,19,0,8,13,27,6,13,4,14,3,6,3,10,27
2012-08-12 00:00:00.000,ATP World Tour Masters 1000 Cincinnati OH; U.S.A. ATP World Tour Masters 1000,HARD,2,Roger Federer,Mardy Fish,Roger Federer,6-3; 7-6(4),Q,88,5,0,42,57,37,42,8,15,0,0,10,45,57,10,1,47,79,32,47,18,32,2,4,11,50,79
2012-08-12 00:00:00.000,ATP World Tour Masters 1000 Cincinnati OH; U.S.A. ATP World Tour Masters 1000,HARD,2,Stan Wawrinka,Milos Raonic,Stan Wawrinka,2-6; 7-6(5); 6-4,Q,141,8,2,51,100,38,51,28,49,4,6,15,66,100,17,8,51,93,42,51,21,42,0,1,15,63,93
2012-08-12 00:00:00.000,ATP World Tour Masters 1000 Cincinnati OH; U.S.A. ATP World Tour Masters 1000,HARD,2,Juan Martin Del Potro,Jeremy Chardy,Juan Martin Del Potro,6-1; 6-3,Q,76,8,2,29,47,24,29,11,18,3,3,8,35,47,4,4,44,64,30,44,3,20,13,17,8,33,64
2012-08-12 00:00:00.000,ATP World Tour Masters 1000 Cincinnati OH; U.S.A. ATP World Tour Masters 1000,HARD,2,Novak Djokovic,Marin Cilic,Novak Djokovic,6-3; 6-2,Q,82,7,2,37,54,31,37,9,17,4,4,9,40,54,2,0,29,54,17,29,11,25,4,7,8,28,54
2012-08-12 00:00:00.000,ATP World Tour Masters 1000 Cincinnati OH; U.S.A. ATP World Tour Masters 1000,HARD,2,Roger Federer,Stan Wawrinka,Roger Federer,7-6(4); 6-3,S,95,5,5,37,68,30,37,21,31,2,2,10,51,68,6,2,46,83,32,46,19,37,8,10,11,51,83
2012-08-12 00:00:00.000,ATP World Tour Masters 1000 Cincinnati OH; U.S.A. ATP World Tour Masters 1000,HARD,2,Novak Djokovic,Juan Martin Del Potro,Novak Djokovic,6-3; 6-2,S,88,6,1,39,61,28,39,14,22,6,6,9,42,61,3,2,28,48,17,28,9,20,3,6,8,26,48
2012-08-12 00:00:00.000,ATP World Tour Masters 1000 Cincinnati OH; U.S.A. ATP World Tour Masters 1000,HARD,2,Roger Federer,Novak Djokovic,Roger Federer,6-0; 7-6(7),F,80,8,1,33,56,27,33,15,23,0,0,9,42,56,2,5,35,61,23,35,13,26,1,4,9,36,61
2012-08-19 00:00:00.000,Winston-Salem NC; U.S.A. ATP World Tour 250,HARD,2,Jo-Wilfried Tsonga,N/A Bye,Jo-Wilfried Tsonga,,R64,0,0,0,0,0,0,0,0,0,0,0,0,0,0,0,0,0,0,0,0,0,0,0,0,0,0,0
2012-08-19 00:00:00.000,Winston-Salem NC; U.S.A. ATP World Tour 250,HARD,2,Thomaz Bellucci,Marcos Baghdatis,Thomaz Bellucci,7-5; 3-1 RET,R64,93,3,1,34,63,19,34,22,29,9,9,8,41,63,1,2,22,52,13,22,18,30,3,5,8,31,52
2012-08-19 00:00:00.000,Winston-Salem NC; U.S.A. ATP World Tour 250,HARD,2,Sergiy Stakhovsky,Gilles Muller,Sergiy Stakhovsky,7-6(4); 6-4,R64,110,13,2,41,72,35,41,18,31,8,8,11,53,72,15,2,43,79,32,43,20,36,8,9,11,52,79
2012-08-19 00:00:00.000,Winston-Salem NC; U.S.A. ATP World Tour 250,HARD,2,Pablo Andujar,N/A Bye,Pablo Andujar,,R64,0,0,0,0,0,0,0,0,0,0,0,0,0,0,0,0,0,0,0,0,0,0,0,0,0,0,0
2012-08-19 00:00:00.000,Winston-Salem NC; U.S.A. ATP World Tour 250,HARD,2,Kevin Anderson,N/A Bye,Kevin Anderson,,R64,0,0,0,0,0,0,0,0,0,0,0,0,0,0,0,0,0,0,0,0,0,0,0,0,0,0,0
2012-08-19 00:00:00.000,Winston-Salem NC; U.S.A. ATP World Tour 250,HARD,2,Ernests Gulbis,Carlos Berlocq,Ernests Gulbis,6-4; 7-5,R64,114,9,3,33,75,26,33,23,42,3,4,11,49,75,2,2,38,63,29,38,9,25,1,4,11,38,63
2012-08-19 00:00:00.000,Winston-Salem NC; U.S.A. ATP World Tour 250,HARD,2,Ryan Harrison,Go Soeda,Ryan Harrison,6-3; 7-5,R64,84,6,3,37,67,29,37,18,30,1,2,11,47,67,1,3,25,54,17,25,16,29,3,6,10,33,54
2012-08-19 00:00:00.000,Winston-Salem NC; U.S.A. ATP World Tour 250,HARD,2,Marcel Granollers,N/A Bye,Marcel Granollers,,R64,0,0,0,0,0,0,0,0,0,0,0,0,0,0,0,0,0,0,0,0,0,0,0,0,0,0,0
2012-08-19 00:00:00.000,Winston-Salem NC; U.S.A. ATP World Tour 250,HARD,2,John Isner,N/A Bye,John Isner,,R64,0,0,0,0,0,0,0,0,0,0,0,0,0,0,0,0,0,0,0,0,0,0,0,0,0,0,0
2012-08-19 00:00:00.000,Winston-Salem NC; U.S.A. ATP World Tour 250,HARD,2,Martin Klizan,Benoit Paire,Martin Klizan,6-2; 7-6(4),R64,78,4,2,38,62,33,38,9,24,3,5,10,42,62,4,8,31,71,18,31,22,40,2,6,10,40,71
2012-08-19 00:00:00.000,Winston-Salem NC; U.S.A. ATP World Tour 250,HARD,2,Michael McClune,Alejandro Falla,Michael McClune,6-1; 6-4,R64,62,7,1,34,53,27,34,11,19,1,1,9,38,53,2,3,37,59,24,37,9,22,2,5,8,33,59
2012-08-19 00:00:00.000,Winston-Salem NC; U.S.A. ATP World Tour 250,HARD,2,Jurgen Melzer,N/A Bye,Jurgen Melzer,,R64,0,0,0,0,0,0,0,0,0,0,0,0,0,0,0,0,0,0,0,0,0,0,0,0,0,0,0
2012-08-19 00:00:00.000,Winston-Salem NC; U.S.A. ATP World Tour 250,HARD,2,Viktor Troicki,N/A Bye,Viktor Troicki,,R64,0,0,0,0,0,0,0,0,0,0,0,0,0,0,0,0,0,0,0,0,0,0,0,0,0,0,0
2012-08-19 00:00:00.000,Winston-Salem NC; U.S.A. ATP World Tour 250,HARD,2,David Goffin,Nicolas Mahut,David Goffin,7-6(3); 6-1,R64,93,4,5,42,76,32,42,20,34,10,10,9,52,76,7,3,46,71,25,46,16,25,8,11,10,41,71
2012-08-19 00:00:00.000,Winston-Salem NC; U.S.A. ATP World Tour 250,HARD,2,Lukasz Kubot,Tommy Robredo,Lukasz Kubot,6-1; 2-6; 6-2,R64,108,7,5,38,73,27,38,21,35,2,4,12,48,73,8,1,47,74,31,47,12,27,7,11,11,43,74
2012-08-19 00:00:00.000,Winston-Salem NC; U.S.A. ATP World Tour 250,HARD,2,Julien Benneteau,N/A Bye,Julien Benneteau,,R64,0,0,0,0,0,0,0,0,0,0,0,0,0,0,0,0,0,0,0,0,0,0,0,0,0,0,0
2012-08-19 00:00:00.000,Winston-Salem NC; U.S.A. ATP World Tour 250,HARD,2,Sam Querrey,N/A Bye,Sam Querrey,,R64,0,0,0,0,0,0,0,0,0,0,0,0,0,0,0,0,0,0,0,0,0,0,0,0,0,0,0
2012-08-19 00:00:00.000,Winston-Salem NC; U.S.A. ATP World Tour 250,HARD,2,Santiago Giraldo,Edouard Roger-Vasselin,Santiago Giraldo,6-2; 2-6; 6-1,R64,127,6,4,56,99,38,56,17,43,12,15,11,55,99,1,2,40,79,27,40,15,39,11,17,12,42,79
2012-08-19 00:00:00.000,Winston-Salem NC; U.S.A. ATP World Tour 250,HARD,2,Donald Young,Leonardo Mayer,Donald Young,4-6; 6-3; 6-2,R64,111,3,3,57,86,48,57,11,29,2,3,14,59,86,7,3,51,79,39,51,13,28,2,5,13,52,79
2012-08-19 00:00:00.000,Winston-Salem NC; U.S.A. ATP World Tour 250,HARD,2,Feliciano Lopez,N/A Bye,Feliciano Lopez,,R64,0,0,0,0,0,0,0,0,0,0,0,0,0,0,0,0,0,0,0,0,0,0,0,0,0,0,0
2012-08-19 00:00:00.000,Winston-Salem NC; U.S.A. ATP World Tour 250,HARD,2,David Nalbandian,N/A Bye,David Nalbandian,,R64,0,0,0,0,0,0,0,0,0,0,0,0,0,0,0,0,0,0,0,0,0,0,0,0,0,0,0
2012-08-19 00:00:00.000,Winston-Salem NC; U.S.A. ATP World Tour 250,HARD,2,Robin Haase,Nikolay Davydenko,Robin Haase,6-2; 6-3,R64,73,4,1,29,50,24,29,12,21,1,1,8,36,50,0,4,48,69,28,48,8,21,5,9,9,36,69
2012-08-19 00:00:00.000,Winston-Salem NC; U.S.A. ATP World Tour 250,HARD,2,Yen-Hsun Lu,Lukas Lacko,Yen-Hsun Lu,6-3; 7-6(3),R64,101,3,2,36,69,29,36,19,33,1,2,11,48,69,1,4,42,70,29,42,13,28,2,4,10,42,70
2012-08-19 00:00:00.000,Winston-Salem NC; U.S.A. ATP World Tour 250,HARD,2,Alexandr Dolgopolov,N/A Bye,Alexandr Dolgopolov,,R64,0,0,0,0,0,0,0,0,0,0,0,0,0,0,0,0,0,0,0,0,0,0,0,0,0,0,0
2012-08-19 00:00:00.000,Winston-Salem NC; U.S.A. ATP World Tour 250,HARD,2,Andy Roddick,N/A Bye,Andy Roddick,,R64,0,0,0,0,0,0,0,0,0,0,0,0,0,0,0,0,0,0,0,0,0,0,0,0,0,0,0
2012-08-19 00:00:00.000,Winston-Salem NC; U.S.A. ATP World Tour 250,HARD,2,James Blake,Albert Ramos-Vinolas,James Blake,6-4; 6-3,R64,72,7,3,30,54,24,30,15,24,1,2,10,39,54,1,2,35,63,20,35,15,28,1,4,9,35,63
2012-08-19 00:00:00.000,Winston-Salem NC; U.S.A. ATP World Tour 250,HARD,2,Steve Darcis,Xavier Malisse,Steve Darcis,6-3; 6-0,R64,58,8,4,27,51,24,27,12,24,3,3,8,36,51,6,2,27,46,16,27,6,19,1,5,7,22,46
2012-08-19 00:00:00.000,Winston-Salem NC; U.S.A. ATP World Tour 250,HARD,2,Denis Istomin,N/A Bye,Denis Istomin,,R64,0,0,0,0,0,0,0,0,0,0,0,0,0,0,0,0,0,0,0,0,0,0,0,0,0,0,0
2012-08-19 00:00:00.000,Winston-Salem NC; U.S.A. ATP World Tour 250,HARD,2,Jarkko Nieminen,N/A Bye,Jarkko Nieminen,,R64,0,0,0,0,0,0,0,0,0,0,0,0,0,0,0,0,0,0,0,0,0,0,0,0,0,0,0
2012-08-19 00:00:00.000,Winston-Salem NC; U.S.A. ATP World Tour 250,HARD,2,Benjamin Becker,Tatsuma Ito,Benjamin Becker,6-3; 4-6; 6-2,R64,116,8,0,49,94,33,49,28,45,4,6,14,61,94,4,4,36,69,24,36,16,33,1,5,13,40,69
2012-08-19 00:00:00.000,Winston-Salem NC; U.S.A. ATP World Tour 250,HARD,2,Alex Bogomolov Jr.,Malek Jaziri,Alex Bogomolov Jr.,6-2; 6-2,R64,58,4,3,37,47,31,37,4,10,1,1,8,35,47,2,1,30,50,13,30,11,20,0,4,8,24,50
2012-08-19 00:00:00.000,Winston-Salem NC; U.S.A. ATP World Tour 250,HARD,2,Tomas Berdych,N/A Bye,Tomas Berdych,,R64,0,0,0,0,0,0,0,0,0,0,0,0,0,0,0,0,0,0,0,0,0,0,0,0,0,0,0
2012-08-19 00:00:00.000,Winston-Salem NC; U.S.A. ATP World Tour 250,HARD,2,Jo-Wilfried Tsonga,Thomaz Bellucci,Jo-Wilfried Tsonga,6-3; 7-6(3),R32,110,3,0,45,78,34,45,22,33,5,5,11,56,78,3,4,36,70,27,36,19,34,8,9,10,46,70
2012-08-19 00:00:00.000,Winston-Salem NC; U.S.A. ATP World Tour 250,HARD,2,Sergiy Stakhovsky,Pablo Andujar,Sergiy Stakhovsky,6-2; 6-3,R32,73,5,3,19,45,16,19,18,26,1,2,9,34,45,2,6,20,52,11,20,15,32,2,6,8,26,52
2012-08-19 00:00:00.000,Winston-Salem NC; U.S.A. ATP World Tour 250,HARD,2,Ernests Gulbis,Kevin Anderson,Ernests Gulbis,6-4; 7-6(2),R32,96,11,5,55,80,44,55,11,25,5,6,11,55,80,4,2,42,65,31,42,14,23,2,4,11,45,65
2012-08-19 00:00:00.000,Winston-Salem NC; U.S.A. ATP World Tour 250,HARD,2,Marcel Granollers,Ryan Harrison,Marcel Granollers,6-4; 6-2,R32,80,1,1,35,55,26,35,12,20,1,1,9,38,55,3,1,22,53,15,22,15,31,4,7,9,30,53
2012-08-19 00:00:00.000,Winston-Salem NC; U.S.A. ATP World Tour 250,HARD,2,John Isner,Martin Klizan,John Isner,4-6; 6-3; 7-5,R32,122,13,3,68,94,52,68,15,26,1,2,16,67,94,3,5,41,79,27,41,26,38,1,3,15,53,79
2012-08-19 00:00:00.000,Winston-Salem NC; U.S.A. ATP World Tour 250,HARD,2,Jurgen Melzer,Michael McClune,Jurgen Melzer,6-2; 2-6; 7-6(10),R32,122,5,2,63,90,45,63,16,27,1,3,14,61,90,13,1,70,105,52,70,16,35,5,7,14,68,105
2012-08-19 00:00:00.000,Winston-Salem NC; U.S.A. ATP World Tour 250,HARD,2,David Goffin,Viktor Troicki,David Goffin,3-6; 6-4; 7-5,R32,143,4,8,53,112,37,53,28,59,10,15,16,65,112,14,6,51,101,40,51,19,50,3,8,15,59,101
2012-08-19 00:00:00.000,Winston-Salem NC; U.S.A. ATP World Tour 250,HARD,2,Lukasz Kubot,Julien Benneteau,Lukasz Kubot,2-6; 7-5; 6-3,R32,162,9,4,54,102,35,54,23,48,8,13,15,58,102,15,8,50,94,37,50,17,44,7,12,14,54,94
2012-08-19 00:00:00.000,Winston-Salem NC; U.S.A. ATP World Tour 250,HARD,2,Sam Querrey,Santiago Giraldo,Sam Querrey,6-3; 6-2,R32,62,12,3,32,55,26,32,14,23,3,3,9,40,55,1,2,31,50,16,31,12,19,1,4,8,28,50
2012-08-19 00:00:00.000,Winston-Salem NC; U.S.A. ATP World Tour 250,HARD,2,Feliciano Lopez,Donald Young,Feliciano Lopez,6-2; 6-3,R32,72,9,4,28,56,21,28,15,28,8,9,8,36,56,1,5,37,57,22,37,7,20,2,7,9,29,57
2012-08-19 00:00:00.000,Winston-Salem NC; U.S.A. ATP World Tour 250,HARD,2,David Nalbandian,Robin Haase,David Nalbandian,6-2; 6-4,R32,84,2,2,30,66,23,30,23,36,8,8,9,46,66,8,5,35,66,22,35,16,31,6,9,9,38,66
2012-08-19 00:00:00.000,Winston-Salem NC; U.S.A. ATP World Tour 250,HARD,2,Alexandr Dolgopolov,Yen-Hsun Lu,Alexandr Dolgopolov,6-1; 6-3,R32,60,8,0,19,40,17,19,13,21,0,1,8,30,40,1,4,28,54,13,28,11,26,3,8,8,24,54
2012-08-19 00:00:00.000,Winston-Salem NC; U.S.A. ATP World Tour 250,HARD,2,Andy Roddick,James Blake,Andy Roddick,7-6(6); 7-6(6),R32,99,11,1,49,78,41,49,16,29,2,3,12,57,78,7,2,44,79,33,44,24,35,4,5,12,57,79
2012-08-19 00:00:00.000,Winston-Salem NC; U.S.A. ATP World Tour 250,HARD,2,Steve Darcis,Denis Istomin,Steve Darcis,6-2; 6-2,R32,63,9,0,23,40,21,23,11,17,0,0,8,32,40,3,3,31,57,20,31,8,26,6,10,8,28,57
2012-08-19 00:00:00.000,Winston-Salem NC; U.S.A. ATP World Tour 250,HARD,2,Jarkko Nieminen,Benjamin Becker,Jarkko Nieminen,6-3; 6-3,R32,52,2,1,34,46,30,34,6,12,0,0,9,36,46,4,4,24,46,18,24,9,22,1,4,9,27,46
2012-08-19 00:00:00.000,Winston-Salem NC; U.S.A. ATP World Tour 250,HARD,2,Tomas Berdych,Alex Bogomolov Jr.,Tomas Berdych,6-3; 7-5,R32,94,15,2,40,67,33,40,19,27,4,4,11,52,67,3,6,41,69,28,41,14,28,4,6,10,42,69
2012-08-19 00:00:00.000,Winston-Salem NC; U.S.A. ATP World Tour 250,HARD,2,Jo-Wilfried Tsonga,Sergiy Stakhovsky,Jo-Wilfried Tsonga,7-6(1); 6-4,R16,95,5,0,45,68,34,45,15,23,2,3,11,49,68,2,1,35,74,25,35,20,39,6,8,11,45,74
2012-08-19 00:00:00.000,Winston-Salem NC; U.S.A. ATP World Tour 250,HARD,2,Marcel Granollers,Ernests Gulbis,Marcel Granollers,4-6; 6-3; 6-2,R16,121,3,5,59,85,47,59,13,26,8,9,14,60,85,4,5,42,78,29,42,20,36,2,5,13,49,78
2012-08-19 00:00:00.000,Winston-Salem NC; U.S.A. ATP World Tour 250,HARD,2,John Isner,Jurgen Melzer,John Isner,6-4; 6-3,R16,71,14,1,33,52,28,33,12,19,0,0,10,40,52,3,5,47,70,31,47,11,23,7,9,9,42,70
2012-08-19 00:00:00.000,Winston-Salem NC; U.S.A. ATP World Tour 250,HARD,2,David Goffin,Lukasz Kubot,David Goffin,6-3; 1-6; 7-6(5),R16,156,1,9,56,105,38,56,27,49,4,6,14,65,105,8,6,58,100,42,58,21,42,5,6,14,63,100
2012-08-19 00:00:00.000,Winston-Salem NC; U.S.A. ATP World Tour 250,HARD,2,Sam Querrey,Feliciano Lopez,Sam Querrey,6-3; 6-4,R16,65,12,2,29,58,26,29,16,29,1,2,10,42,58,7,2,31,57,20,31,12,26,2,5,9,32,57
2012-08-19 00:00:00.000,Winston-Salem NC; U.S.A. ATP World Tour 250,HARD,2,Alexandr Dolgopolov,David Nalbandian,Alexandr Dolgopolov,6-3; 6-4,R16,75,8,3,31,58,25,31,16,27,1,2,10,41,58,5,5,35,64,23,35,14,29,4,7,9,37,64
2012-08-19 00:00:00.000,Winston-Salem NC; U.S.A. ATP World Tour 250,HARD,2,Steve Darcis,Andy Roddick,Steve Darcis,7-6(6); 7-6(3),R16,111,5,3,50,82,39,50,21,32,1,1,12,60,82,8,0,53,75,41,53,14,22,3,3,12,55,75
2012-08-19 00:00:00.000,Winston-Salem NC; U.S.A. ATP World Tour 250,HARD,2,Tomas Berdych,Jarkko Nieminen,Tomas Berdych,6-3; 6-2,R16,67,5,1,25,53,19,25,21,28,1,1,9,40,53,6,1,31,45,18,31,6,14,2,5,8,24,45
2012-08-19 00:00:00.000,Winston-Salem NC; U.S.A. ATP World Tour 250,HARD,2,Jo-Wilfried Tsonga,Marcel Granollers,Jo-Wilfried Tsonga,6-1; 6-2,Q,54,5,1,30,47,23,30,11,17,0,0,8,34,47,1,2,27,37,12,27,4,10,1,5,7,16,37
2012-08-19 00:00:00.000,Winston-Salem NC; U.S.A. ATP World Tour 250,HARD,2,John Isner,David Goffin,John Isner,7-6(5); 6-3,Q,94,21,0,38,55,33,38,13,17,0,0,10,46,55,3,4,50,86,35,50,18,36,6,8,11,53,86
2012-08-19 00:00:00.000,Winston-Salem NC; U.S.A. ATP World Tour 250,HARD,2,Sam Querrey,Alexandr Dolgopolov,Sam Querrey,7-5; 4-6; 7-6(3),Q,132,20,5,67,115,55,67,23,48,7,9,17,78,115,7,4,44,99,35,44,33,55,3,5,17,68,99
2012-08-19 00:00:00.000,Winston-Salem NC; U.S.A. ATP World Tour 250,HARD,2,Tomas Berdych,Steve Darcis,Tomas Berdych,4-6; 6-2; 6-0,Q,106,10,3,36,63,29,36,10,27,3,6,12,39,63,3,1,42,70,24,42,10,28,3,10,12,34,70
2012-08-19 00:00:00.000,Winston-Salem NC; U.S.A. ATP World Tour 250,HARD,2,John Isner,Jo-Wilfried Tsonga,John Isner,6-4; 3-6; 7-6(3),S,133,24,2,61,95,50,61,16,34,2,3,15,66,95,7,2,62,107,42,62,29,45,9,10,16,71,107
2012-08-19 00:00:00.000,Winston-Salem NC; U.S.A. ATP World Tour 250,HARD,2,Tomas Berdych,Sam Querrey,Tomas Berdych,6-4; 6-3,S,99,3,4,31,51,22,31,10,20,1,4,10,32,51,18,5,64,104,39,64,11,40,13,18,9,50,104
2012-08-19 00:00:00.000,Winston-Salem NC; U.S.A. ATP World Tour 250,HARD,2,John Isner,Tomas Berdych,John Isner,3-6; 6-4; 7-6(9),F,147,22,1,64,92,49,64,16,28,3,5,16,65,92,7,1,57,97,47,57,21,40,0,1,15,68,97
2012-08-27 00:00:00.000,US Open NY; U.S.A. Grand Slams,HARD,3,Roger Federer,Donald Young,Roger Federer,6-3; 6-2; 6-4,R128,94,7,2,54,76,45,54,13,22,1,2,14,58,76,0,3,55,79,31,55,11,24,4,9,13,42,79
2012-08-27 00:00:00.000,US Open NY; U.S.A. Grand Slams,HARD,3,Bjorn Phau,Maxime Authom,Bjorn Phau,6-2; 4-6; 6-4; 7-6(5),R128,163,12,3,59,116,46,59,35,57,5,8,20,81,116,9,7,81,142,59,81,23,61,8,13,20,82,142
2012-08-27 00:00:00.000,US Open NY; U.S.A. Grand Slams,HARD,3,Albert Ramos-Vinolas,Robby Ginepri,Albert Ramos-Vinolas,6-7(3); 7-5; 6-4; 6-0,R128,201,14,5,72,132,49,72,34,60,11,15,20,83,132,6,7,78,139,47,78,28,61,11,20,20,75,139
2012-08-27 00:00:00.000,US Open NY; U.S.A. Grand Slams,HARD,3,Fernando Verdasco,Rui Machado,Fernando Verdasco,6-1; 6-2; 6-4,R128,100,6,4,43,71,33,43,18,28,2,3,13,51,71,2,7,39,74,25,39,12,35,3,9,12,37,74
2012-08-27 00:00:00.000,US Open NY; U.S.A. Grand Slams,HARD,3,Mardy Fish,Go Soeda,Mardy Fish,7-6(3); 7-6(2); 6-3,R128,156,12,2,51,98,38,51,29,47,3,6,16,67,98,3,4,57,105,36,57,23,48,4,9,17,59,105
2012-08-27 00:00:00.000,US Open NY; U.S.A. Grand Slams,HARD,3,Nikolay Davydenko,Guido Pella,Nikolay Davydenko,7-5; 3-6; 6-4; 6-2,R128,160,1,10,71,113,45,71,23,42,7,12,19,68,113,2,6,84,129,51,84,17,45,6,14,20,68,129
2012-08-27 00:00:00.000,US Open NY; U.S.A. Grand Slams,HARD,3,Jimmy Wang,Ivo Karlovic,Jimmy Wang,7-6(4); 6-7(8); 6-1; 6-4,R128,183,7,3,80,124,68,80,29,44,3,3,21,97,124,32,6,75,126,58,75,28,51,2,5,20,86,126
2012-08-27 00:00:00.000,US Open NY; U.S.A. Grand Slams,HARD,3,Gilles Simon,Michael Russell,Gilles Simon,7-6(4); 3-6; 5-7; 6-4; 6-1,R128,266,1,2,120,165,76,120,24,45,11,19,25,100,165,6,9,95,167,58,95,34,72,6,15,25,92,167
2012-08-27 00:00:00.000,US Open NY; U.S.A. Grand Slams,HARD,3,Nicolas Almagro,Radek Stepanek,Nicolas Almagro,6-4; 6-7(5); 6-3; 6-4,R128,187,24,8,80,140,61,80,29,60,9,12,21,90,140,13,12,61,125,48,61,27,64,11,17,20,75,125
2012-08-27 00:00:00.000,US Open NY; U.S.A. Grand Slams,HARD,3,Philipp Petzschner,Nicolas Mahut,Philipp Petzschner,1-6; 4-6; 6-4; 7-5; 7-6(3),R128,211,9,5,94,155,71,94,27,61,3,10,25,98,155,8,4,96,164,64,96,37,68,7,13,26,101,164
2012-08-27 00:00:00.000,US Open NY; U.S.A. Grand Slams,HARD,3,Flavio Cipolla,Blaz Kavcic,Flavio Cipolla,6-4; 7-6(5); 3-6; 6-3,R128,233,2,9,95,146,59,95,21,51,15,23,20,80,146,9,7,81,145,50,81,25,64,7,16,20,75,145
2012-08-27 00:00:00.000,US Open NY; U.S.A. Grand Slams,HARD,3,Jack Sock,Florian Mayer,Jack Sock,6-3; 6-2; 3-2 RET,R128,84,9,2,36,63,29,36,18,27,3,3,11,47,63,2,2,44,70,26,44,12,26,7,11,11,38,70
2012-08-27 00:00:00.000,US Open NY; U.S.A. Grand Slams,HARD,3,Sam Querrey,Yen-Hsun Lu,Sam Querrey,6-7(4); 6-4; 6-4; 7-5,R128,181,21,7,67,128,53,67,37,61,1,3,22,90,128,11,10,68,137,53,68,32,69,5,10,22,85,137
2012-08-27 00:00:00.000,US Open NY; U.S.A. Grand Slams,HARD,3,Ruben Ramirez Hidalgo,Somdev Devvarman,Ruben Ramirez Hidalgo,6-3; 6-2; 3-6; 6-4,R128,161,4,5,42,92,29,42,31,50,2,6,18,60,92,2,7,73,119,51,73,13,46,9,16,18,64,119
2012-08-27 00:00:00.000,US Open NY; U.S.A. Grand Slams,HARD,3,Jurgen Zopp,Denis Istomin,Jurgen Zopp,3-6; 6-3; 6-3; 7-5,R128,153,11,4,65,126,51,65,35,61,5,6,19,86,126,18,2,76,117,54,76,23,41,7,11,20,77,117
2012-08-27 00:00:00.000,US Open NY; U.S.A. Grand Slams,HARD,3,Tomas Berdych,David Goffin,Tomas Berdych,7-5; 6-3; 6-3,R128,163,17,1,61,112,47,61,22,51,16,18,15,69,112,6,8,62,111,40,62,21,49,7,13,15,61,111
2012-08-27 00:00:00.000,US Open NY; U.S.A. Grand Slams,HARD,3,Andy Murray,Alex Bogomolov Jr.,Andy Murray,6-2; 6-4; 6-1,R128,135,7,5,45,92,30,45,23,47,8,12,13,53,92,1,2,67,93,36,67,5,26,10,19,12,41,93
2012-08-27 00:00:00.000,US Open NY; U.S.A. Grand Slams,HARD,3,Ivan Dodig,Hiroki Moriya,Ivan Dodig,6-0; 6-1; 6-2,R128,100,9,3,36,65,29,36,20,29,5,5,11,49,65,1,7,50,74,25,50,6,24,7,14,10,31,74
2012-08-27 00:00:00.000,US Open NY; U.S.A. Grand Slams,HARD,3,Pablo Andujar,Thomaz Bellucci,Pablo Andujar,7-6(5); 3-6; 7-6(1); 7-5,R128,228,2,10,80,141,64,80,32,61,4,7,22,96,141,16,8,75,151,57,75,40,76,6,9,23,97,151
2012-08-27 00:00:00.000,US Open NY; U.S.A. Grand Slams,HARD,3,Feliciano Lopez,Robin Haase,Feliciano Lopez,6-3; 7-5; 6-2,R128,108,17,3,46,85,39,46,27,39,1,1,15,66,85,8,4,48,89,33,48,23,41,8,12,14,56,89
2012-08-27 00:00:00.000,US Open NY; U.S.A. Grand Slams,HARD,3,Marcel Granollers,Denis Kudla,Marcel Granollers,6-3; 4-6; 6-3; 7-6(2),R128,194,11,2,81,131,55,81,29,50,6,10,20,84,131,4,4,81,132,50,81,28,51,13,19,20,78,132
2012-08-27 00:00:00.000,US Open NY; U.S.A. Grand Slams,HARD,3,James Blake,Lukas Lacko,James Blake,7-5; 6-2; 3-6; 6-3,R128,148,11,4,68,118,51,68,28,50,10,13,19,79,118,4,4,65,118,43,65,27,53,4,10,19,70,118
2012-08-27 00:00:00.000,US Open NY; U.S.A. Grand Slams,HARD,3,Paul-Henri Mathieu,Igor Andreev,Paul-Henri Mathieu,2-6; 4-6; 7-6(1); 7-6(4); 6-1,R128,228,14,9,77,163,56,77,45,86,9,15,25,101,163,24,7,78,148,57,78,39,70,3,8,24,96,148
2012-08-27 00:00:00.000,US Open NY; U.S.A. Grand Slams,HARD,3,Milos Raonic,Santiago Giraldo,Milos Raonic,6-3; 4-6; 3-6; 6-4; 6-4,R128,205,30,15,76,142,66,76,32,66,8,11,24,98,142,2,0,115,153,74,115,23,38,8,12,24,97,153
2012-08-27 00:00:00.000,US Open NY; U.S.A. Grand Slams,HARD,3,Marin Cilic,Marinko Matosevic,Marin Cilic,5-7; 2-6; 6-4; 6-2; 6-4,R128,237,8,5,70,139,54,70,36,69,5,9,24,90,139,7,2,127,176,74,127,31,49,16,21,24,105,176
2012-08-27 00:00:00.000,US Open NY; U.S.A. Grand Slams,HARD,3,Daniel Brands,Adrian Ungur,Daniel Brands,7-6(4); 6-4; 7-6(5),R128,137,17,6,72,116,56,72,20,44,4,7,17,76,116,5,7,74,115,52,74,17,41,5,9,17,69,115
2012-08-27 00:00:00.000,US Open NY; U.S.A. Grand Slams,HARD,3,Tim Smyczek,Bobby Reynolds,Tim Smyczek,1-6; 6-4; 6-2; 4-6; 6-4,R128,213,13,3,68,128,48,68,35,60,4,9,22,83,128,9,3,84,164,55,84,38,80,9,15,23,93,164
2012-08-27 00:00:00.000,US Open NY; U.S.A. Grand Slams,HARD,3,Kei Nishikori,Guido Andreozzi,Kei Nishikori,6-1; 6-2; 6-4,R128,100,5,2,44,69,37,44,18,25,0,0,13,55,69,8,6,48,91,33,48,17,43,5,10,12,50,91
2012-08-27 00:00:00.000,US Open NY; U.S.A. Grand Slams,HARD,3,Jeremy Chardy,Filippo Volandri,Jeremy Chardy,6-3; 6-4; 6-3,R128,101,18,2,43,76,37,43,24,33,6,6,14,61,76,0,1,52,83,33,52,17,31,2,6,14,50,83
2012-08-27 00:00:00.000,US Open NY; U.S.A. Grand Slams,HARD,3,Matthew Ebden,Tatsuma Ito,Matthew Ebden,7-6(9); 6-3; 6-2,R128,148,11,4,59,101,47,59,21,42,4,6,14,68,101,2,9,56,117,36,56,27,61,12,18,15,63,117
2012-08-27 00:00:00.000,US Open NY; U.S.A. Grand Slams,HARD,3,Martin Klizan,Alejandro Falla,Martin Klizan,6-4; 6-1; 6-2,R128,76,9,5,48,79,36,48,15,31,7,9,12,51,79,2,5,49,81,24,49,12,32,3,11,14,36,81
2012-08-27 00:00:00.000,US Open NY; U.S.A. Grand Slams,HARD,3,Jo-Wilfried Tsonga,Karol Beck,Jo-Wilfried Tsonga,6-3; 6-1; 7-6(2),R128,128,15,1,59,93,48,59,18,34,6,7,14,66,93,9,8,63,109,41,63,17,46,7,12,14,58,109
2012-08-27 00:00:00.000,US Open NY; U.S.A. Grand Slams,HARD,3,Janko Tipsarevic,Guillaume Rufin,Janko Tipsarevic,4-6; 3-6; 6-2; 6-3; 6-2,R128,217,18,3,70,112,59,70,23,42,4,8,22,82,112,15,6,81,159,51,81,39,78,16,23,22,90,159
2012-08-27 00:00:00.000,US Open NY; U.S.A. Grand Slams,HARD,3,Brian Baker,Jan Hajek,Brian Baker,6-3; 6-4; 6-2,R128,116,4,8,65,107,50,65,21,42,6,6,14,71,107,5,5,50,76,35,50,11,26,3,7,13,46,76
2012-08-27 00:00:00.000,US Open NY; U.S.A. Grand Slams,HARD,3,Grega Zemlja,Ricardo Mello,Grega Zemlja,7-5; 7-6(3); 7-5,R128,160,16,3,84,141,64,84,30,57,13,14,18,94,141,6,0,77,107,52,77,19,30,4,7,18,71,107
2012-08-27 00:00:00.000,US Open NY; U.S.A. Grand Slams,HARD,3,Cedrik-Marcel Stebe,Viktor Troicki,Cedrik-Marcel Stebe,6-4; 6-4; 3-6; 6-2,R128,154,1,4,68,106,50,68,21,38,9,12,18,71,106,8,4,68,112,44,68,20,44,4,10,19,64,112
2012-08-27 00:00:00.000,US Open NY; U.S.A. Grand Slams,HARD,3,Philipp Kohlschreiber,Michael Llodra,Philipp Kohlschreiber,7-6(2); 4-6; 7-6(4); 6-1,R128,164,7,3,73,134,53,73,36,61,6,9,20,89,134,11,5,77,122,54,77,21,45,1,6,21,75,122
2012-08-27 00:00:00.000,US Open NY; U.S.A. Grand Slams,HARD,3,Benoit Paire,Grigor Dimitrov,Benoit Paire,5-7; 6-3; 7-6(4); 6-2,R128,166,12,6,66,143,45,66,45,77,6,10,21,90,143,2,9,90,142,61,90,25,52,11,17,20,86,142
2012-08-27 00:00:00.000,US Open NY; U.S.A. Grand Slams,HARD,3,Jarkko Nieminen,Mikhail Kukushkin,Jarkko Nieminen,6-0; 6-2 RET,R128,45,1,0,26,37,22,26,7,11,0,0,7,29,37,0,3,22,37,9,22,5,15,1,6,7,14,37
2012-08-27 00:00:00.000,US Open NY; U.S.A. Grand Slams,HARD,3,John Isner,Xavier Malisse,John Isner,6-3; 7-6(5); 5-7; 7-6(9),R128,176,20,4,91,138,73,91,30,47,3,5,23,103,138,11,4,76,131,59,76,37,55,5,7,22,96,131
2012-08-27 00:00:00.000,US Open NY; U.S.A. Grand Slams,HARD,3,Richard Gasquet,Albert Montanes,Richard Gasquet,4-6; 6-2; 6-3; 6-3,R128,157,22,5,61,104,53,61,23,43,4,6,18,76,104,5,7,62,120,38,62,29,58,5,11,18,67,120
2012-08-27 00:00:00.000,US Open NY; U.S.A. Grand Slams,HARD,3,Bradley Klahn,Jurgen Melzer,Bradley Klahn,4-6; 6-3; 7-5; 5-7; 6-4,R128,214,14,5,121,173,77,121,27,52,5,12,27,104,173,2,9,117,168,72,117,24,51,4,12,26,96,168
2012-08-27 00:00:00.000,US Open NY; U.S.A. Grand Slams,HARD,3,Steve Johnson,Rajeev Ram,Steve Johnson,6-3; 7-6(5); 6-3,R128,120,12,2,65,109,52,65,22,44,11,12,16,74,109,7,2,45,86,34,45,23,41,3,6,14,57,86
2012-08-27 00:00:00.000,US Open NY; U.S.A. Grand Slams,HARD,3,Ernests Gulbis,Tommy Haas,Ernests Gulbis,3-6; 4-6; 6-4; 7-5; 6-3,R128,224,24,7,96,158,73,96,28,62,13,17,25,101,158,7,6,91,159,67,91,33,68,13,18,25,100,159
2012-08-27 00:00:00.000,US Open NY; U.S.A. Grand Slams,HARD,3,Gilles Muller,Mikhail Youzhny,Gilles Muller,2-6; 3-6; 7-5; 7-6(6); 7-6(6),R128,263,25,11,92,176,79,92,36,84,11,16,26,115,176,8,8,104,175,82,104,40,71,4,7,27,122,175
2012-08-27 00:00:00.000,US Open NY; U.S.A. Grand Slams,HARD,3,Lleyton Hewitt,Tobias Kamke,Lleyton Hewitt,4-6; 6-2; 6-1; 6-4,R128,168,6,8,56,118,42,56,29,62,9,13,18,71,118,4,7,52,109,32,52,25,57,7,15,17,57,109
2012-08-27 00:00:00.000,US Open NY; U.S.A. Grand Slams,HARD,3,Igor Sijsling,Daniel Gimeno-Traver,Igor Sijsling,7-5; 6-3; 6-4,R128,102,10,1,63,90,48,63,19,27,4,4,16,67,90,4,2,44,85,32,44,24,41,5,8,15,56,85
2012-08-27 00:00:00.000,US Open NY; U.S.A. Grand Slams,HARD,3,David Ferrer,Kevin Anderson,David Ferrer,6-4; 6-2; 7-6(3),R128,136,4,3,59,91,50,59,17,32,3,3,15,67,91,7,2,57,93,39,57,22,36,4,7,15,61,93
2012-08-27 00:00:00.000,US Open NY; U.S.A. Grand Slams,HARD,3,Juan Martin Del Potro,Florent Serra,Juan Martin Del Potro,6-4; 7-6(4); 6-4,R128,154,19,9,52,94,44,52,27,42,1,1,16,71,94,8,3,73,121,48,73,27,48,8,10,16,75,121
2012-08-27 00:00:00.000,US Open NY; U.S.A. Grand Slams,HARD,3,Ryan Harrison,Benjamin Becker,Ryan Harrison,7-5; 6-4; 6-2,R128,125,11,2,70,109,51,70,20,39,7,8,15,71,109,6,5,46,88,32,46,19,42,1,6,15,51,88
2012-08-27 00:00:00.000,US Open NY; U.S.A. Grand Slams,HARD,3,Leonardo Mayer,Lukasz Kubot,Leonardo Mayer,6-4; 6-4; 7-5,R128,159,9,5,47,89,37,47,25,42,5,7,16,62,89,7,6,63,103,42,63,19,40,3,8,16,61,103
2012-08-27 00:00:00.000,US Open NY; U.S.A. Grand Slams,HARD,3,Tommy Robredo,Andreas Seppi,Tommy Robredo,6-1; 7-5; 6-3,R128,115,10,4,54,86,45,54,17,32,3,3,14,62,86,3,1,47,82,33,47,16,35,2,7,14,49,82
2012-08-27 00:00:00.000,US Open NY; U.S.A. Grand Slams,HARD,3,Andy Roddick,Rhyne Williams,Andy Roddick,6-3; 6-4; 6-4,R128,118,20,4,59,79,53,59,9,20,2,2,15,62,79,8,2,48,78,36,48,15,30,4,7,14,51,78
2012-08-27 00:00:00.000,US Open NY; U.S.A. Grand Slams,HARD,3,Bernard Tomic,Carlos Berlocq,Bernard Tomic,4-6; 7-5; 6-3; 6-4,R128,169,7,3,100,146,59,100,29,46,6,11,21,88,146,4,6,84,124,54,84,20,40,7,14,20,74,124
2012-08-27 00:00:00.000,US Open NY; U.S.A. Grand Slams,HARD,3,Fabio Fognini,Edouard Roger-Vasselin,Fabio Fognini,3-6; 5-7; 6-4; 6-4; 7-5,R128,213,12,11,102,188,74,102,37,86,7,14,27,111,188,7,7,92,148,66,92,27,56,7,14,26,93,148
2012-08-27 00:00:00.000,US Open NY; U.S.A. Grand Slams,HARD,3,Guillermo Garcia-Lopez,Juan Monaco,Guillermo Garcia-Lopez,3-6; 1-6; 6-4; 7-6(6); 7-6(3),R128,271,8,8,101,193,68,101,42,92,20,28,25,110,193,8,5,103,157,64,103,37,54,7,12,25,101,157
2012-08-27 00:00:00.000,US Open NY; U.S.A. Grand Slams,HARD,3,Alexandr Dolgopolov,Jesse Levine,Alexandr Dolgopolov,3-6; 4-6; 6-4; 6-1; 6-2,R128,170,17,6,63,121,49,63,32,58,7,11,22,81,121,7,3,93,153,59,93,31,60,15,22,22,90,153
2012-08-27 00:00:00.000,US Open NY; U.S.A. Grand Slams,HARD,3,Marcos Baghdatis,Matthias Bachinger,Marcos Baghdatis,6-2; 4-6; 6-4; 6-7(8); 7-6(5),R128,233,19,6,95,172,73,95,47,77,10,13,26,120,172,17,10,107,197,77,107,46,90,12,17,26,123,197
2012-08-27 00:00:00.000,US Open NY; U.S.A. Grand Slams,HARD,3,Steve Darcis,Malek Jaziri,Steve Darcis,3-6; 6-1; 6-1; 6-1,R128,133,10,6,60,89,43,60,16,29,4,7,15,59,89,5,12,51,108,34,51,18,57,10,19,15,52,108
2012-08-27 00:00:00.000,US Open NY; U.S.A. Grand Slams,HARD,3,Stan Wawrinka,Sergiy Stakhovsky,Stan Wawrinka,6-7(6); 7-6(2); 6-4; 6-2,R128,183,12,5,62,135,49,62,46,73,5,7,21,95,135,3,5,75,134,53,75,30,59,5,10,21,83,134
2012-08-27 00:00:00.000,US Open NY; U.S.A. Grand Slams,HARD,3,Julien Benneteau,Olivier Rochus,Julien Benneteau,7-6(1); 6-2; 6-3,R128,127,17,3,55,88,45,55,21,33,1,2,15,66,88,1,7,44,102,31,44,25,58,4,8,14,56,102
2012-08-27 00:00:00.000,US Open NY; U.S.A. Grand Slams,HARD,3,Dennis Novikov,Jerzy Janowicz,Dennis Novikov,6-2; 7-6(6); 3-6; 6-3,R128,145,25,6,62,124,50,62,34,62,2,4,19,84,124,12,12,55,107,44,55,29,52,6,10,19,73,107
2012-08-27 00:00:00.000,US Open NY; U.S.A. Grand Slams,HARD,3,Rogerio Dutra Silva,Teymuraz Gabashvili,Rogerio Dutra Silva,4-6; 6-4; 6-7(5); 6-3; 7-5,R128,252,24,2,98,171,76,98,42,73,10,13,27,118,171,2,7,97,159,74,97,29,62,5,10,26,103,159
2012-08-27 00:00:00.000,US Open NY; U.S.A. Grand Slams,HARD,3,Novak Djokovic,Paolo Lorenzi,Novak Djokovic,6-1; 6-0; 6-1,R128,73,7,0,42,53,32,42,7,11,0,1,10,39,53,0,5,32,61,15,32,6,29,4,13,10,21,61
2012-08-27 00:00:00.000,US Open NY; U.S.A. Grand Slams,HARD,3,Roger Federer,Bjorn Phau,Roger Federer,6-2; 6-3; 6-2,R64,90,15,1,52,76,41,52,15,24,1,1,13,56,76,2,7,40,74,26,40,14,34,7,12,12,40,74
2012-08-27 00:00:00.000,US Open NY; U.S.A. Grand Slams,HARD,3,Fernando Verdasco,Albert Ramos-Vinolas,Fernando Verdasco,7-6(4); 5-7; 7-6(5); 6-4,R64,243,9,7,92,151,67,92,33,59,2,6,23,100,151,5,11,98,165,69,98,32,67,9,13,23,101,165
2012-08-27 00:00:00.000,US Open NY; U.S.A. Grand Slams,HARD,3,Mardy Fish,Nikolay Davydenko,Mardy Fish,4-6; 6-7(4); 6-2; 6-1; 6-2,R64,206,16,3,85,150,62,85,38,65,9,12,23,100,150,5,10,85,130,57,85,16,45,5,13,22,73,130
2012-08-27 00:00:00.000,US Open NY; U.S.A. Grand Slams,HARD,3,Gilles Simon,Jimmy Wang,Gilles Simon,6-4; 4-6; 6-4; 6-4,R64,181,3,3,90,127,53,90,25,37,4,9,20,78,127,4,1,81,119,45,81,21,38,7,14,20,66,119
2012-08-27 00:00:00.000,US Open NY; U.S.A. Grand Slams,HARD,3,Nicolas Almagro,Philipp Petzschner,Nicolas Almagro,6-3; 5-7; 5-7; 6-4; 6-4,R64,199,12,6,76,145,58,76,40,69,5,10,27,98,145,17,5,90,163,68,90,35,73,11,17,26,103,163
2012-08-27 00:00:00.000,US Open NY; U.S.A. Grand Slams,HARD,3,Jack Sock,Flavio Cipolla,Jack Sock,6-2; 6-2; 6-4,R64,137,15,8,57,109,42,57,26,52,12,13,13,68,109,0,6,48,67,25,48,11,19,0,6,13,36,67
2012-08-27 00:00:00.000,US Open NY; U.S.A. Grand Slams,HARD,3,Sam Querrey,Ruben Ramirez Hidalgo,Sam Querrey,6-3; 6-4; 6-3,R64,109,19,4,48,75,42,48,16,27,0,0,14,58,75,1,6,57,107,38,57,23,50,4,8,14,61,107
2012-08-27 00:00:00.000,US Open NY; U.S.A. Grand Slams,HARD,3,Tomas Berdych,Jurgen Zopp,Tomas Berdych,6-1; 6-4; 6-2,R64,92,13,1,40,63,34,40,14,23,0,1,13,48,63,3,2,35,72,22,35,14,37,3,9,12,36,72
2012-08-27 00:00:00.000,US Open NY; U.S.A. Grand Slams,HARD,3,Andy Murray,Ivan Dodig,Andy Murray,6-2; 6-1; 6-3,R64,111,9,1,42,74,36,42,17,32,3,3,12,53,74,3,3,43,72,25,43,14,29,3,9,12,39,72
2012-08-27 00:00:00.000,US Open NY; U.S.A. Grand Slams,HARD,3,Feliciano Lopez,Pablo Andujar,Feliciano Lopez,6-4; 6-1; 6-7(5); 3-6; 7-5,R64,255,19,9,97,179,73,97,36,82,10,14,24,109,179,4,5,105,166,60,105,37,61,9,17,26,97,166
2012-08-27 00:00:00.000,US Open NY; U.S.A. Grand Slams,HARD,3,James Blake,Marcel Granollers,James Blake,6-1; 6-4; 6-2,R64,97,2,0,41,64,37,41,15,23,0,0,13,52,64,2,1,61,85,34,61,13,24,11,16,12,47,85
2012-08-27 00:00:00.000,US Open NY; U.S.A. Grand Slams,HARD,3,Milos Raonic,Paul-Henri Mathieu,Milos Raonic,7-5; 6-4; 7-6(4),R64,130,30,5,62,96,56,62,19,34,1,1,17,75,96,6,2,44,82,37,44,29,38,2,4,17,66,82
2012-08-27 00:00:00.000,US Open NY; U.S.A. Grand Slams,HARD,3,Marin Cilic,Daniel Brands,Marin Cilic,6-3; 6-2; 5-7; 4-6; 7-5,R64,220,16,7,74,134,64,74,36,60,0,2,26,100,134,15,12,103,185,75,103,38,82,17,21,25,113,185
2012-08-27 00:00:00.000,US Open NY; U.S.A. Grand Slams,HARD,3,Kei Nishikori,Tim Smyczek,Kei Nishikori,6-2; 6-2; 6-4,R64,106,1,2,44,71,32,44,18,27,0,1,13,50,71,2,8,48,88,30,48,14,40,8,14,13,44,88
2012-08-27 00:00:00.000,US Open NY; U.S.A. Grand Slams,HARD,3,Jeremy Chardy,Matthew Ebden,Jeremy Chardy,6-4; 6-2; 6-2,R64,112,9,4,46,78,37,46,19,32,2,2,13,56,78,3,10,49,90,33,49,16,41,5,10,13,49,90
2012-08-27 00:00:00.000,US Open NY; U.S.A. Grand Slams,HARD,3,Martin Klizan,Jo-Wilfried Tsonga,Martin Klizan,6-4; 1-6; 6-1; 6-3,R64,132,5,7,62,109,40,62,25,47,8,12,16,65,109,4,5,62,102,42,62,15,40,12,19,17,57,102
2012-08-27 00:00:00.000,US Open NY; U.S.A. Grand Slams,HARD,3,Janko Tipsarevic,Brian Baker,Janko Tipsarevic,6-4; 6-3; 6-4,R64,123,14,6,36,79,28,36,28,43,2,3,14,56,79,1,5,58,93,36,58,16,35,7,12,15,52,93
2012-08-27 00:00:00.000,US Open NY; U.S.A. Grand Slams,HARD,3,Grega Zemlja,Cedrik-Marcel Stebe,Grega Zemlja,6-4; 2-6; 6-4; 6-4,R64,147,7,2,65,106,43,65,23,41,5,10,19,66,106,8,4,57,98,39,57,21,41,0,6,19,60,98
2012-08-27 00:00:00.000,US Open NY; U.S.A. Grand Slams,HARD,3,Philipp Kohlschreiber,Benoit Paire,Philipp Kohlschreiber,6-7(4); 6-3; 3-6; 6-2; 7-6(4),R64,218,9,2,100,168,70,100,42,68,11,15,25,112,168,15,11,91,186,71,91,41,95,10,16,25,112,186
2012-08-27 00:00:00.000,US Open NY; U.S.A. Grand Slams,HARD,3,John Isner,Jarkko Nieminen,John Isner,6-3; 6-7(5); 6-4; 6-3,R64,150,23,5,83,116,68,83,18,33,3,4,21,86,116,5,4,74,121,54,74,21,47,3,7,19,75,121
2012-08-27 00:00:00.000,US Open NY; U.S.A. Grand Slams,HARD,3,Richard Gasquet,Bradley Klahn,Richard Gasquet,6-3; 6-3; 6-1,R64,122,6,2,42,77,33,42,23,35,4,4,13,56,77,4,3,55,96,33,55,18,41,10,15,12,51,96
2012-08-27 00:00:00.000,US Open NY; U.S.A. Grand Slams,HARD,3,Steve Johnson,Ernests Gulbis,Steve Johnson,6-7(3); 7-6(5); 6-3; 6-4,R64,191,16,2,98,148,74,98,32,50,9,9,22,106,148,19,4,82,126,68,82,24,44,2,4,21,92,126
2012-08-27 00:00:00.000,US Open NY; U.S.A. Grand Slams,HARD,3,Lleyton Hewitt,Gilles Muller,Lleyton Hewitt,3-6; 7-6(5); 6-7(5); 7-5; 6-4,R64,275,18,13,79,191,62,79,65,112,14,17,27,127,191,35,9,106,179,90,106,34,73,8,12,28,124,179
2012-08-27 00:00:00.000,US Open NY; U.S.A. Grand Slams,HARD,3,David Ferrer,Igor Sijsling,David Ferrer,6-2; 6-3; 7-6(12),R64,127,6,5,51,91,39,51,31,40,3,4,15,70,91,7,5,56,106,43,56,19,50,9,13,14,62,106
2012-08-27 00:00:00.000,US Open NY; U.S.A. Grand Slams,HARD,3,Juan Martin Del Potro,Ryan Harrison,Juan Martin Del Potro,6-2; 6-3; 2-6; 6-2,R64,154,4,3,67,97,49,67,16,30,7,10,16,65,97,6,5,47,92,28,47,22,45,3,10,17,50,92
2012-08-27 00:00:00.000,US Open NY; U.S.A. Grand Slams,HARD,3,Leonardo Mayer,Tommy Robredo,Leonardo Mayer,6-1; 6-4; 4-6; 7-5,R64,187,8,4,72,125,58,72,29,53,9,10,20,87,125,5,4,70,119,45,70,29,49,7,11,19,74,119
2012-08-27 00:00:00.000,US Open NY; U.S.A. Grand Slams,HARD,3,Andy Roddick,Bernard Tomic,Andy Roddick,6-3; 6-4; 6-0,R64,87,13,0,48,66,38,48,15,18,0,0,13,53,66,7,1,51,69,31,51,7,18,2,7,12,38,69
2012-08-27 00:00:00.000,US Open NY; U.S.A. Grand Slams,HARD,3,Fabio Fognini,Guillermo Garcia-Lopez,Fabio Fognini,6-4; 6-4; 6-2,R64,113,5,2,47,75,36,47,15,28,0,2,14,51,75,2,9,51,95,30,51,20,44,4,10,14,50,95
2012-08-27 00:00:00.000,US Open NY; U.S.A. Grand Slams,HARD,3,Alexandr Dolgopolov,Marcos Baghdatis,Alexandr Dolgopolov,6-4; 3-6; 6-0; 7-6(5),R64,150,11,7,56,96,46,56,23,40,1,4,18,69,96,14,9,56,139,40,56,39,83,16,22,19,79,139
2012-08-27 00:00:00.000,US Open NY; U.S.A. Grand Slams,HARD,3,Stan Wawrinka,Steve Darcis,Stan Wawrinka,6-7(6); 6-3; 4-6; 6-1; 7-5,R64,208,27,6,64,147,56,64,50,83,7,9,25,106,147,7,2,88,159,58,88,44,71,9,15,25,102,159
2012-08-27 00:00:00.000,US Open NY; U.S.A. Grand Slams,HARD,3,Julien Benneteau,Dennis Novikov,Julien Benneteau,3-6; 6-4; 7-6(1); 7-5,R64,170,22,10,99,154,76,99,26,55,19,22,21,102,154,16,10,70,142,51,70,36,72,7,11,22,87,142
2012-08-27 00:00:00.000,US Open NY; U.S.A. Grand Slams,HARD,3,Novak Djokovic,Rogerio Dutra Silva,Novak Djokovic,6-2; 6-1; 6-2,R64,99,6,1,41,62,37,41,12,21,0,0,12,49,62,3,1,53,85,29,53,14,32,10,16,11,43,85
2012-08-27 00:00:00.000,US Open NY; U.S.A. Grand Slams,HARD,3,Roger Federer,Fernando Verdasco,Roger Federer,6-3; 6-4; 6-4,R32,122,7,1,56,82,49,56,16,26,1,1,15,65,82,6,10,60,95,44,60,14,35,5,8,14,58,95
2012-08-27 00:00:00.000,US Open NY; U.S.A. Grand Slams,HARD,3,Mardy Fish,Gilles Simon,Mardy Fish,6-1; 5-7; 7-6(5); 6-3,R32,183,15,4,65,120,49,65,29,55,8,11,19,78,120,0,3,110,143,58,110,19,33,9,16,21,77,143
2012-08-27 00:00:00.000,US Open NY; U.S.A. Grand Slams,HARD,3,Nicolas Almagro,Jack Sock,Nicolas Almagro,7-6(3); 6-7(4); 7-6(2); 6-1,R32,190,22,4,71,135,56,71,43,64,10,11,21,99,135,17,11,73,143,55,73,38,70,1,5,22,93,143
2012-08-27 00:00:00.000,US Open NY; U.S.A. Grand Slams,HARD,3,Tomas Berdych,Sam Querrey,Tomas Berdych,6-7(6); 6-4; 6-3; 6-2,R32,196,10,4,74,135,59,74,35,61,10,11,19,94,135,22,3,88,149,64,88,25,61,10,16,20,89,149
2012-08-27 00:00:00.000,US Open NY; U.S.A. Grand Slams,HARD,3,Andy Murray,Feliciano Lopez,Andy Murray,7-6(5); 7-6(5); 4-6; 7-6(4),R32,233,16,7,104,168,78,104,31,64,9,13,23,109,168,18,4,75,146,65,75,37,71,9,12,23,102,146
2012-08-27 00:00:00.000,US Open NY; U.S.A. Grand Slams,HARD,3,Milos Raonic,James Blake,Milos Raonic,6-3; 6-0; 7-6(3),R32,108,29,4,54,94,48,54,19,40,3,4,14,67,94,3,2,46,84,34,46,14,38,6,11,13,48,84
2012-08-27 00:00:00.000,US Open NY; U.S.A. Grand Slams,HARD,3,Marin Cilic,Kei Nishikori,Marin Cilic,6-3; 6-4; 6-7(3); 6-3,R32,213,13,4,61,136,47,61,48,75,8,9,21,95,136,4,8,79,123,52,79,25,44,8,12,19,77,123
2012-08-27 00:00:00.000,US Open NY; U.S.A. Grand Slams,HARD,3,Martin Klizan,Jeremy Chardy,Martin Klizan,6-4; 6-4; 6-4,R32,131,6,5,43,87,34,43,27,44,5,6,15,61,87,5,9,49,91,33,49,23,42,6,10,15,56,91
2012-08-27 00:00:00.000,US Open NY; U.S.A. Grand Slams,HARD,3,Janko Tipsarevic,Grega Zemlja,Janko Tipsarevic,6-4; 6-3; 7-5,R32,136,14,8,66,101,50,66,17,35,6,8,16,67,101,8,2,51,100,32,51,27,49,8,13,15,59,100
2012-08-27 00:00:00.000,US Open NY; U.S.A. Grand Slams,HARD,3,Philipp Kohlschreiber,John Isner,Philipp Kohlschreiber,6-4; 3-6; 4-6; 6-3; 6-4,R32,200,5,1,113,147,81,113,20,34,9,11,24,101,147,24,3,88,137,64,88,31,49,0,3,24,95,137
2012-08-27 00:00:00.000,US Open NY; U.S.A. Grand Slams,HARD,3,Richard Gasquet,Steve Johnson,Richard Gasquet,7-6(4); 6-2; 6-3,R32,118,8,4,46,81,40,46,22,35,3,3,14,62,81,10,8,52,95,34,52,19,43,7,11,15,53,95
2012-08-27 00:00:00.000,US Open NY; U.S.A. Grand Slams,HARD,3,David Ferrer,Lleyton Hewitt,David Ferrer,7-6(9); 4-6; 6-3; 6-0,R32,192,10,7,62,113,51,62,29,51,3,5,19,80,113,8,5,77,147,57,77,27,70,11,16,18,84,147
2012-08-27 00:00:00.000,US Open NY; U.S.A. Grand Slams,HARD,3,Juan Martin Del Potro,Leonardo Mayer,Juan Martin Del Potro,6-3; 7-5; 7-6(9),R32,200,7,3,67,105,57,67,20,38,4,5,16,77,105,10,3,74,130,51,74,26,56,9,13,17,77,130
2012-08-27 00:00:00.000,US Open NY; U.S.A. Grand Slams,HARD,3,Andy Roddick,Fabio Fognini,Andy Roddick,7-5; 7-6(1); 4-6; 6-4,R32,180,10,0,86,130,66,86,22,44,4,8,22,88,130,15,8,76,123,54,76,24,47,3,8,22,78,123
2012-08-27 00:00:00.000,US Open NY; U.S.A. Grand Slams,HARD,3,Stan Wawrinka,Alexandr Dolgopolov,Stan Wawrinka,6-4; 6-4; 6-2,R32,110,14,0,42,73,36,42,22,31,0,0,14,58,73,5,8,58,114,41,58,23,56,19,23,14,64,114
2012-08-27 00:00:00.000,US Open NY; U.S.A. Grand Slams,HARD,3,Novak Djokovic,Julien Benneteau,Novak Djokovic,6-3; 6-2; 6-2,R32,97,13,3,40,66,33,40,19,26,0,0,13,52,66,5,2,46,76,29,46,12,30,3,8,12,41,76
2012-08-27 00:00:00.000,US Open NY; U.S.A. Grand Slams,HARD,3,Roger Federer,Mardy Fish,Roger Federer,W/O,R16,0,0,0,0,0,0,0,0,0,0,0,0,0,0,0,0,0,0,0,0,0,0,0,0,0,0,0
2012-08-27 00:00:00.000,US Open NY; U.S.A. Grand Slams,HARD,3,Tomas Berdych,Nicolas Almagro,Tomas Berdych,7-6(4); 6-4; 6-1,R16,120,17,0,49,80,44,49,19,31,2,2,14,63,80,9,5,43,96,32,43,27,53,5,9,15,59,96
2012-08-27 00:00:00.000,US Open NY; U.S.A. Grand Slams,HARD,3,Andy Murray,Milos Raonic,Andy Murray,6-4; 6-4; 6-2,R16,120,9,1,48,75,42,48,16,27,0,0,14,58,75,14,6,61,87,43,61,8,26,8,12,14,51,87
2012-08-27 00:00:00.000,US Open NY; U.S.A. Grand Slams,HARD,3,Marin Cilic,Martin Klizan,Marin Cilic,7-5; 6-4; 6-0,R16,123,7,2,48,84,35,48,19,36,5,7,14,54,84,5,3,46,83,27,46,17,37,3,10,14,44,83
2012-08-27 00:00:00.000,US Open NY; U.S.A. Grand Slams,HARD,3,Janko Tipsarevic,Philipp Kohlschreiber,Janko Tipsarevic,6-3; 7-6(5); 6-2,R16,143,10,2,53,94,43,53,24,41,5,6,15,67,94,12,4,64,106,45,64,16,42,3,7,14,61,106
2012-08-27 00:00:00.000,US Open NY; U.S.A. Grand Slams,HARD,3,David Ferrer,Richard Gasquet,David Ferrer,7-5; 7-6(2); 6-4,R16,174,1,8,54,113,37,54,37,59,8,11,17,74,113,6,2,68,117,43,68,25,49,8,13,17,68,117
2012-08-27 00:00:00.000,US Open NY; U.S.A. Grand Slams,HARD,3,Juan Martin Del Potro,Andy Roddick,Juan Martin Del Potro,6-7(1); 7-6(4); 6-2; 6-4,R16,195,15,3,88,123,71,88,20,35,3,4,21,91,123,20,6,81,128,64,81,22,47,3,7,21,86,128
2012-08-27 00:00:00.000,US Open NY; U.S.A. Grand Slams,HARD,3,Novak Djokovic,Stan Wawrinka,Novak Djokovic,6-4; 6-1; 3-1 RET,R16,93,4,0,45,68,30,45,13,23,4,6,11,43,68,5,3,23,57,15,23,12,34,1,7,10,27,57
2012-08-27 00:00:00.000,US Open NY; U.S.A. Grand Slams,HARD,3,Tomas Berdych,Roger Federer,Tomas Berdych,7-6(1); 6-4; 3-6; 6-3,Q,162,14,3,65,110,52,65,23,45,2,6,20,75,110,7,3,73,115,52,73,19,42,6,11,20,71,115
2012-08-27 00:00:00.000,US Open NY; U.S.A. Grand Slams,HARD,3,Andy Murray,Marin Cilic,Andy Murray,3-6; 7-6(4); 6-2; 6-0,Q,180,11,4,61,110,43,61,24,49,5,9,17,67,110,3,6,62,119,42,62,20,57,11,19,18,62,119
2012-08-27 00:00:00.000,US Open NY; U.S.A. Grand Slams,HARD,3,David Ferrer,Janko Tipsarevic,David Ferrer,6-3; 6-7(5); 2-6; 6-3; 7-6(4),Q,271,15,6,105,168,73,105,42,63,3,7,26,115,168,10,0,95,164,64,95,42,69,11,15,24,106,164
2012-08-27 00:00:00.000,US Open NY; U.S.A. Grand Slams,HARD,3,Novak Djokovic,Juan Martin Del Potro,Novak Djokovic,6-2; 7-6(3); 6-4,Q,186,7,2,50,88,42,50,21,38,2,3,15,63,88,8,3,78,119,51,78,18,41,9,13,15,69,119
2012-08-27 00:00:00.000,US Open NY; U.S.A. Grand Slams,HARD,3,Andy Murray,Tomas Berdych,Andy Murray,5-7; 6-2; 6-1; 7-6(7),S,238,5,3,85,115,62,85,17,30,3,6,19,79,115,6,6,97,158,58,97,30,61,15,22,20,88,158
2012-08-27 00:00:00.000,US Open NY; U.S.A. Grand Slams,HARD,3,Novak Djokovic,David Ferrer,Novak Djokovic,2-6; 6-1; 6-4; 6-2,S,152,7,1,60,101,43,60,24,41,4,7,17,67,101,2,3,55,92,35,55,17,37,3,9,16,52,92
2012-08-27 00:00:00.000,US Open NY; U.S.A. Grand Slams,HARD,3,Andy Murray,Novak Djokovic,Andy Murray,7-6(10); 7-5; 2-6; 3-6; 6-2,F,294,5,4,99,150,62,99,24,51,9,18,25,86,150,7,5,103,165,65,103,26,62,9,17,24,91,165
2012-09-17 00:00:00.000,Metz France ATP World Tour 250,HARD,2,Jo-Wilfried Tsonga,N/A Bye,Jo-Wilfried Tsonga,,R32,0,0,0,0,0,0,0,0,0,0,0,0,0,0,0,0,0,0,0,0,0,0,0,0,0,0,0
2012-09-17 00:00:00.000,Metz France ATP World Tour 250,HARD,2,Clement Reix,Edouard Roger-Vasselin,Clement Reix,6-3; 3-6; 7-5,R32,106,21,0,75,107,57,75,14,32,8,9,15,71,107,16,1,52,77,43,52,13,25,1,3,15,56,77
2012-09-17 00:00:00.000,Metz France ATP World Tour 250,HARD,2,Jesse Levine,Cedrik-Marcel Stebe,Jesse Levine,6-3; 6-2,R32,66,2,1,27,50,18,27,15,23,4,6,8,33,50,2,2,31,52,11,31,9,21,3,9,9,20,52
2012-09-17 00:00:00.000,Metz France ATP World Tour 250,HARD,2,Michael Berrer,Jan Hajek,Michael Berrer,6-4; 2-0 RET,R32,58,7,0,31,46,20,31,10,15,3,3,6,30,46,1,0,31,46,19,31,7,15,7,9,6,26,46
2012-09-17 00:00:00.000,Metz France ATP World Tour 250,HARD,2,Marcel Granollers,N/A Bye,Marcel Granollers,,R32,0,0,0,0,0,0,0,0,0,0,0,0,0,0,0,0,0,0,0,0,0,0,0,0,0,0,0
2012-09-17 00:00:00.000,Metz France ATP World Tour 250,HARD,2,Ivo Karlovic,Kenny De Schepper,Ivo Karlovic,7-6(5); 7-6(3),R32,113,18,4,55,81,49,55,15,26,3,3,12,64,81,9,7,48,84,39,48,20,36,6,6,12,59,84
2012-09-17 00:00:00.000,Metz France ATP World Tour 250,HARD,2,Gilles Muller,Paul-Henri Mathieu,Gilles Muller,7-6(5); 6-4,R32,93,14,2,44,66,38,44,14,22,2,2,11,52,66,7,5,33,69,29,33,21,36,1,2,11,50,69
2012-09-17 00:00:00.000,Metz France ATP World Tour 250,HARD,2,Nikolay Davydenko,Mischa Zverev,Nikolay Davydenko,2-6; 6-3; 6-3,R32,108,1,5,66,91,39,66,14,25,9,14,13,53,91,7,2,40,73,25,40,14,33,2,8,13,39,73
2012-09-17 00:00:00.000,Metz France ATP World Tour 250,HARD,2,Andreas Seppi,Ivan Dodig,Andreas Seppi,6-7(7); 6-3; 6-4,R32,145,6,3,69,119,48,69,18,50,8,14,16,66,119,11,8,54,99,35,54,15,45,5,13,15,50,99
2012-09-17 00:00:00.000,Metz France ATP World Tour 250,HARD,2,Vincent Millot,Igor Sijsling,Vincent Millot,6-4; 6-4,R32,83,2,1,34,73,25,34,22,39,3,4,10,47,73,10,0,48,65,33,48,6,17,1,4,10,39,65
2012-09-17 00:00:00.000,Metz France ATP World Tour 250,HARD,2,James Blake,Albano Olivetti,James Blake,6-2; 7-6(4),R32,76,6,3,29,53,25,29,17,24,0,1,10,42,53,19,5,39,65,30,39,8,26,7,10,10,38,65
2012-09-17 00:00:00.000,Metz France ATP World Tour 250,HARD,2,Florian Mayer,N/A Bye,Florian Mayer,,R32,0,0,0,0,0,0,0,0,0,0,0,0,0,0,0,0,0,0,0,0,0,0,0,0,0,0,0
2012-09-17 00:00:00.000,Metz France ATP World Tour 250,HARD,2,Gael Monfils,Olivier Rochus,Gael Monfils,6-3; 6-2,R32,64,21,4,28,44,28,28,6,16,0,1,9,34,44,0,4,29,54,20,29,7,25,3,7,8,27,54
2012-09-17 00:00:00.000,Metz France ATP World Tour 250,HARD,2,Nicolas Mahut,Daniel Brands,Nicolas Mahut,7-6(8); 7-6(4),R32,109,15,1,49,83,40,49,24,34,3,3,12,64,83,13,4,47,87,39,47,23,40,6,6,12,62,87
2012-09-17 00:00:00.000,Metz France ATP World Tour 250,HARD,2,Benoit Paire,Xavier Malisse,Benoit Paire,6-1; 6-4,R32,54,3,2,25,55,17,25,20,30,1,2,9,37,55,3,3,26,47,16,26,9,21,3,7,8,25,47
2012-09-17 00:00:00.000,Metz France ATP World Tour 250,HARD,2,Philipp Kohlschreiber,N/A Bye,Philipp Kohlschreiber,,R32,0,0,0,0,0,0,0,0,0,0,0,0,0,0,0,0,0,0,0,0,0,0,0,0,0,0,0
2012-09-17 00:00:00.000,Metz France ATP World Tour 250,HARD,2,Jo-Wilfried Tsonga,Clement Reix,Jo-Wilfried Tsonga,6-3; 6-3,R16,79,6,2,35,57,28,35,13,22,3,3,9,41,57,4,3,44,71,27,44,13,27,9,12,9,40,71
2012-09-17 00:00:00.000,Metz France ATP World Tour 250,HARD,2,Jesse Levine,Michael Berrer,Jesse Levine,6-4; 3-6; 6-0,R16,95,3,2,46,71,34,46,15,25,1,2,12,49,71,7,1,51,78,29,51,15,27,4,8,13,44,78
2012-09-17 00:00:00.000,Metz France ATP World Tour 250,HARD,2,Ivo Karlovic,Marcel Granollers,Ivo Karlovic,7-6(3); 2-2 RET,R16,85,7,3,34,57,27,34,9,23,1,2,8,36,57,2,2,44,61,30,44,8,17,4,5,8,38,61
2012-09-17 00:00:00.000,Metz France ATP World Tour 250,HARD,2,Nikolay Davydenko,Gilles Muller,Nikolay Davydenko,7-5; 6-4,R16,85,5,1,49,64,37,49,9,15,2,2,11,46,64,11,1,42,62,33,42,7,20,3,5,11,40,62
2012-09-17 00:00:00.000,Metz France ATP World Tour 250,HARD,2,Andreas Seppi,Vincent Millot,Andreas Seppi,6-2; 6-1,R16,63,2,1,28,45,22,28,11,17,3,3,7,33,45,2,6,26,52,15,26,9,26,4,9,8,24,52
2012-09-17 00:00:00.000,Metz France ATP World Tour 250,HARD,2,Florian Mayer,James Blake,Florian Mayer,6-7(4); 6-3; 6-4,R16,110,6,1,70,109,48,70,25,39,6,7,16,73,109,12,4,61,97,49,61,15,36,3,6,15,64,97
2012-09-17 00:00:00.000,Metz France ATP World Tour 250,HARD,2,Gael Monfils,Nicolas Mahut,Gael Monfils,7-6(4); 7-5,R16,102,12,8,42,75,36,42,17,33,1,2,12,53,75,7,3,37,75,32,37,17,38,4,6,12,49,75
2012-09-17 00:00:00.000,Metz France ATP World Tour 250,HARD,2,Philipp Kohlschreiber,Benoit Paire,Philipp Kohlschreiber,6-2; 1-6; 6-1,R16,88,1,1,51,82,33,51,17,31,5,7,11,50,82,3,4,36,67,26,36,15,31,2,6,11,41,67
2012-09-17 00:00:00.000,Metz France ATP World Tour 250,HARD,2,Jo-Wilfried Tsonga,Jesse Levine,Jo-Wilfried Tsonga,6-3; 6-4,Q,94,7,1,36,60,28,36,13,24,1,2,10,41,60,6,4,60,86,39,60,8,26,11,14,9,47,86
2012-09-17 00:00:00.000,Metz France ATP World Tour 250,HARD,2,Nikolay Davydenko,Ivo Karlovic,Nikolay Davydenko,6-7(5); 7-6(6); 6-0,Q,129,1,6,77,104,61,77,13,27,9,10,15,74,104,13,5,56,93,46,56,15,37,3,7,15,61,93
2012-09-17 00:00:00.000,Metz France ATP World Tour 250,HARD,2,Andreas Seppi,Florian Mayer,Andreas Seppi,7-5; 6-2,Q,61,1,1,31,48,30,31,6,17,0,1,10,36,48,4,2,33,54,20,33,11,21,2,6,10,31,54
2012-09-17 00:00:00.000,Metz France ATP World Tour 250,HARD,2,Gael Monfils,Philipp Kohlschreiber,Gael Monfils,6-7(3); 6-4; 6-4,Q,146,6,6,41,96,35,41,24,55,6,10,16,59,96,3,2,79,122,52,79,15,43,9,15,16,67,122
2012-09-17 00:00:00.000,Metz France ATP World Tour 250,HARD,2,Jo-Wilfried Tsonga,Nikolay Davydenko,Jo-Wilfried Tsonga,6-0; 3-6; 6-4,S,108,12,5,47,71,38,47,11,24,0,2,13,49,71,1,7,60,89,40,60,10,29,9,13,12,50,89
2012-09-17 00:00:00.000,Metz France ATP World Tour 250,HARD,2,Andreas Seppi,Gael Monfils,Andreas Seppi,3-6; 6-1; 6-4,S,102,5,2,47,75,36,47,17,28,5,6,13,53,75,5,7,55,79,43,55,8,24,4,7,13,51,79
2012-09-17 00:00:00.000,Metz France ATP World Tour 250,HARD,2,Jo-Wilfried Tsonga,Andreas Seppi,Jo-Wilfried Tsonga,6-1; 6-2,F,50,7,1,26,39,25,26,8,13,0,0,8,33,39,1,2,20,35,12,20,6,15,2,6,7,18,35
2012-09-17 00:00:00.000,St. Petersburg Russia ATP World Tour 250,HARD,2,Mikhail Youzhny,Vasek Pospisil,Mikhail Youzhny,7-6(4); 6-1,R32,80,0,1,32,55,24,32,17,23,0,1,10,41,55,2,2,28,58,20,28,14,30,2,5,9,34,58
2012-09-17 00:00:00.000,St. Petersburg Russia ATP World Tour 250,HARD,2,Rajeev Ram,Matthias Bachinger,Rajeev Ram,6-4; 6-4,R32,88,3,2,47,61,33,47,7,14,5,6,10,40,61,5,2,43,68,30,43,11,25,4,7,10,41,68
2012-09-17 00:00:00.000,St. Petersburg Russia ATP World Tour 250,HARD,2,Paolo Lorenzi,Sergey Betov,Paolo Lorenzi,1-6; 6-2; 6-2,R32,120,1,2,28,55,18,28,18,27,2,5,11,36,55,3,3,41,81,28,41,19,40,6,11,12,47,81
2012-09-17 00:00:00.000,St. Petersburg Russia ATP World Tour 250,HARD,2,Guillermo Garcia-Lopez,Evgeny Donskoy,Guillermo Garcia-Lopez,2-6; 6-4; 6-3,R32,132,3,7,40,79,28,40,20,39,3,7,14,48,79,1,0,55,85,34,55,15,30,7,11,13,49,85
2012-09-17 00:00:00.000,St. Petersburg Russia ATP World Tour 250,HARD,2,Martin Klizan,Mikhail Elgin,Martin Klizan,6-4; 6-3,R32,97,2,4,33,58,23,33,10,25,2,5,9,33,58,3,3,30,74,18,30,16,44,7,13,10,34,74
2012-09-17 00:00:00.000,St. Petersburg Russia ATP World Tour 250,HARD,2,Simone Bolelli,Horacio Zeballos,Simone Bolelli,7-6(3); 7-5,R32,123,4,2,30,62,27,30,25,32,0,0,12,52,62,4,5,57,92,39,57,19,35,5,6,12,58,92
2012-09-17 00:00:00.000,St. Petersburg Russia ATP World Tour 250,HARD,2,Ricardas Berankis,Philipp Petzschner,Ricardas Berankis,6-2; 3-3 RET,R32,49,5,2,20,36,17,20,14,16,0,0,7,31,36,3,1,31,54,22,31,8,23,9,11,7,30,54
2012-09-17 00:00:00.000,St. Petersburg Russia ATP World Tour 250,HARD,2,Jurgen Zopp,Andrey Kumantsov,Jurgen Zopp,6-3; 5-3 RET,R32,89,5,1,54,82,39,54,12,28,11,12,9,51,82,2,0,35,50,21,35,7,15,3,6,8,28,50
2012-09-17 00:00:00.000,St. Petersburg Russia ATP World Tour 250,HARD,2,Roberto Bautista Agut,Yen-Hsun Lu,Roberto Bautista Agut,6-4; 6-2,R32,93,0,3,29,55,20,29,15,26,5,7,9,35,55,1,0,30,54,14,30,12,24,2,7,9,26,54
2012-09-17 00:00:00.000,St. Petersburg Russia ATP World Tour 250,HARD,2,Teymuraz Gabashvili,Nikolai Fidirko,Teymuraz Gabashvili,6-2; 6-0,R32,49,3,1,17,37,13,17,16,20,0,0,7,29,37,2,4,22,36,11,22,4,14,3,8,7,15,36
2012-09-17 00:00:00.000,St. Petersburg Russia ATP World Tour 250,HARD,2,Sergiy Stakhovsky,Ivan Nedelko,Sergiy Stakhovsky,7-6(2); 6-2,R32,82,5,2,36,60,26,36,17,24,1,2,10,43,60,0,3,39,69,25,39,13,30,5,8,10,38,69
2012-09-17 00:00:00.000,St. Petersburg Russia ATP World Tour 250,HARD,2,Fabio Fognini,Tobias Kamke,Fabio Fognini,4-6; 6-2; 6-3,R32,126,2,5,65,105,44,65,22,40,8,10,14,66,105,1,5,44,82,30,44,19,38,6,10,13,49,82
2012-09-17 00:00:00.000,St. Petersburg Russia ATP World Tour 250,HARD,2,Grega Zemlja,Lukas Lacko,Grega Zemlja,6-3; 6-2,R32,69,4,1,32,54,23,32,10,22,0,2,9,33,54,4,2,19,41,10,19,10,22,2,7,8,20,41
2012-09-17 00:00:00.000,St. Petersburg Russia ATP World Tour 250,HARD,2,Flavio Cipolla,Andrei Vasilevski,Flavio Cipolla,7-6(4); 7-6(6),R32,129,0,3,67,94,42,67,17,27,8,11,12,59,94,5,5,40,82,29,40,18,42,4,7,12,47,82
2012-09-17 00:00:00.000,St. Petersburg Russia ATP World Tour 250,HARD,2,Daniel Gimeno-Traver,Florent Serra,Daniel Gimeno-Traver,7-6(5); 6-2,R32,91,10,4,35,64,24,35,16,29,0,2,10,40,64,1,4,48,81,28,48,16,33,6,10,10,44,81
2012-09-17 00:00:00.000,St. Petersburg Russia ATP World Tour 250,HARD,2,Lukasz Kubot,Denis Istomin,Lukasz Kubot,4-6; 6-3; 6-4,R32,148,4,5,64,99,43,64,16,35,7,10,15,59,99,4,1,64,101,41,64,17,37,9,13,14,58,101
2012-09-17 00:00:00.000,St. Petersburg Russia ATP World Tour 250,HARD,2,Mikhail Youzhny,Rajeev Ram,Mikhail Youzhny,6-1; 6-4,R16,66,4,1,27,49,23,27,15,22,1,1,9,38,49,1,1,34,46,23,34,2,12,0,3,8,25,46
2012-09-17 00:00:00.000,St. Petersburg Russia ATP World Tour 250,HARD,2,Guillermo Garcia-Lopez,Paolo Lorenzi,Guillermo Garcia-Lopez,6-1; 3-1 RET,R16,45,4,0,17,27,14,17,8,10,0,0,5,22,27,2,1,31,42,16,31,2,11,3,7,6,18,42
2012-09-17 00:00:00.000,St. Petersburg Russia ATP World Tour 250,HARD,2,Martin Klizan,Simone Bolelli,Martin Klizan,6-3; 6-3,R16,70,5,2,35,54,26,35,12,19,0,0,9,38,54,2,1,39,50,28,39,2,11,1,4,9,30,50
2012-09-17 00:00:00.000,St. Petersburg Russia ATP World Tour 250,HARD,2,Ricardas Berankis,Jurgen Zopp,Ricardas Berankis,6-3 RET,R16,36,3,1,14,28,12,14,9,14,0,0,5,21,28,2,1,15,28,10,15,6,13,3,4,4,16,28
2012-09-17 00:00:00.000,St. Petersburg Russia ATP World Tour 250,HARD,2,Roberto Bautista Agut,Teymuraz Gabashvili,Roberto Bautista Agut,6-3; 6-4,R16,100,2,4,37,66,25,37,13,29,5,8,10,38,66,0,1,41,57,22,41,5,16,3,8,9,27,57
2012-09-17 00:00:00.000,St. Petersburg Russia ATP World Tour 250,HARD,2,Fabio Fognini,Sergiy Stakhovsky,Fabio Fognini,7-6(4); 6-4,R16,121,0,6,51,91,30,51,25,40,7,9,11,55,91,3,2,56,93,34,56,17,37,7,10,11,51,93
2012-09-17 00:00:00.000,St. Petersburg Russia ATP World Tour 250,HARD,2,Flavio Cipolla,Grega Zemlja,Flavio Cipolla,6-2; 6-7(5); 6-3,R16,157,1,5,73,103,50,73,11,30,5,9,15,61,103,3,2,52,94,31,52,15,42,5,12,14,46,94
2012-09-17 00:00:00.000,St. Petersburg Russia ATP World Tour 250,HARD,2,Daniel Gimeno-Traver,Lukasz Kubot,Daniel Gimeno-Traver,6-4; 7-6(5),R16,106,7,4,44,70,30,44,15,26,6,9,11,45,70,4,6,51,80,33,51,13,29,6,10,11,46,80
2012-09-17 00:00:00.000,St. Petersburg Russia ATP World Tour 250,HARD,2,Mikhail Youzhny,Guillermo Garcia-Lopez,Mikhail Youzhny,6-4; 0-6; 6-3,Q,126,1,2,40,79,27,40,21,39,5,9,13,48,79,3,6,40,77,25,40,20,37,5,8,12,45,77
2012-09-17 00:00:00.000,St. Petersburg Russia ATP World Tour 250,HARD,2,Martin Klizan,Ricardas Berankis,Martin Klizan,6-3; 6-2,Q,67,6,2,29,50,23,29,13,21,4,4,8,36,50,5,1,21,50,15,21,12,29,0,4,9,27,50
2012-09-17 00:00:00.000,St. Petersburg Russia ATP World Tour 250,HARD,2,Fabio Fognini,Roberto Bautista Agut,Fabio Fognini,6-4; 7-6(1),Q,101,1,4,48,75,35,48,14,27,3,5,11,49,75,1,4,31,62,24,31,15,31,1,4,11,39,62
2012-09-17 00:00:00.000,St. Petersburg Russia ATP World Tour 250,HARD,2,Daniel Gimeno-Traver,Flavio Cipolla,Daniel Gimeno-Traver,6-2; 7-5,Q,87,0,2,34,61,19,34,14,27,2,6,10,33,61,0,3,37,56,17,37,5,19,3,10,10,22,56
2012-09-17 00:00:00.000,St. Petersburg Russia ATP World Tour 250,HARD,2,Martin Klizan,Mikhail Youzhny,Martin Klizan,6-7(11); 6-4; 7-6(3),S,229,4,3,74,130,48,74,26,56,10,17,17,74,130,2,7,78,141,51,78,29,63,9,17,17,80,141
2012-09-17 00:00:00.000,St. Petersburg Russia ATP World Tour 250,HARD,2,Fabio Fognini,Daniel Gimeno-Traver,Fabio Fognini,6-3; 6-4,S,80,3,0,44,62,33,44,9,18,2,3,10,42,62,3,0,35,59,26,35,9,24,3,6,9,35,59
2012-09-17 00:00:00.000,St. Petersburg Russia ATP World Tour 250,HARD,2,Martin Klizan,Fabio Fognini,Martin Klizan,6-2; 6-3,F,69,1,0,25,43,17,25,12,18,0,2,8,29,43,2,2,35,55,14,35,10,20,5,11,9,24,55
2012-09-24 00:00:00.000,Bangkok Thailand ATP World Tour 250,HARD,2,Janko Tipsarevic,N/A Bye,Janko Tipsarevic,,R32,0,0,0,0,0,0,0,0,0,0,0,0,0,0,0,0,0,0,0,0,0,0,0,0,0,0,0
2012-09-24 00:00:00.000,Bangkok Thailand ATP World Tour 250,HARD,2,Hiroki Moriya,Robin Haase,Hiroki Moriya,2-6; 7-6(6); 6-3,R32,128,3,1,56,94,42,56,20,38,6,9,15,62,94,6,1,53,91,39,53,20,38,1,3,14,59,91
2012-09-24 00:00:00.000,Bangkok Thailand ATP World Tour 250,HARD,2,Donald Young,Yen-Hsun Lu,Donald Young,5-7; 6-2; 7-5,R32,137,3,5,59,91,48,59,15,32,4,6,16,63,91,6,3,73,109,50,73,15,36,16,20,16,65,109
2012-09-24 00:00:00.000,Bangkok Thailand ATP World Tour 250,HARD,2,Fernando Verdasco,Tatsuma Ito,Fernando Verdasco,3-6; 6-0; 6-2,R32,124,4,1,56,89,38,56,12,33,10,13,11,50,89,1,3,35,69,18,35,14,34,1,8,12,32,69
2012-09-24 00:00:00.000,Bangkok Thailand ATP World Tour 250,HARD,2,Gilles Simon,N/A Bye,Gilles Simon,,R32,0,0,0,0,0,0,0,0,0,0,0,0,0,0,0,0,0,0,0,0,0,0,0,0,0,0,0
2012-09-24 00:00:00.000,Bangkok Thailand ATP World Tour 250,HARD,2,Go Soeda,Danai Udomchoke,Go Soeda,6-4; 7-5,R32,112,1,2,38,62,25,38,17,24,2,4,11,42,62,5,3,57,86,35,57,12,29,7,11,11,47,86
2012-09-24 00:00:00.000,Bangkok Thailand ATP World Tour 250,HARD,2,Gael Monfils,Kevin Anderson,Gael Monfils,6-4; 2-6; 7-5,R32,145,5,3,76,101,47,76,14,25,3,7,15,61,101,2,6,58,95,40,58,18,37,7,11,15,58,95
2012-09-24 00:00:00.000,Bangkok Thailand ATP World Tour 250,HARD,2,Viktor Troicki,Sergiy Stakhovsky,Viktor Troicki,6-7(4); 7-5; 6-3,R32,135,5,2,68,101,49,68,15,33,4,8,17,64,101,4,0,56,94,37,56,17,38,5,11,16,54,94
2012-09-24 00:00:00.000,Bangkok Thailand ATP World Tour 250,HARD,2,Jarkko Nieminen,Yuichi Sugita,Jarkko Nieminen,6-1 RET,R32,36,1,1,20,26,16,20,2,6,2,2,4,18,26,0,0,8,18,4,8,4,10,1,3,3,8,18
2012-09-24 00:00:00.000,Bangkok Thailand ATP World Tour 250,HARD,2,Philipp Petzschner,Peerakiat Siriluethaiwattana,Philipp Petzschner,6-1; 6-2,R32,57,4,1,26,38,19,26,8,12,2,3,7,27,38,0,7,33,54,15,33,6,21,4,10,8,21,54
2012-09-24 00:00:00.000,Bangkok Thailand ATP World Tour 250,HARD,2,Ivo Karlovic,Marinko Matosevic,Ivo Karlovic,6-3; 6-4,R32,74,9,0,33,49,27,33,10,16,0,1,10,37,49,2,3,37,53,25,37,6,16,0,3,9,31,53
2012-09-24 00:00:00.000,Bangkok Thailand ATP World Tour 250,HARD,2,Milos Raonic,N/A Bye,Milos Raonic,,R32,0,0,0,0,0,0,0,0,0,0,0,0,0,0,0,0,0,0,0,0,0,0,0,0,0,0,0
2012-09-24 00:00:00.000,Bangkok Thailand ATP World Tour 250,HARD,2,Bernard Tomic,Guillermo Garcia-Lopez,Bernard Tomic,6-0; 6-2,R32,71,1,2,32,47,21,32,11,15,5,5,7,32,47,2,2,25,50,13,25,7,25,8,13,7,20,50
2012-09-24 00:00:00.000,Bangkok Thailand ATP World Tour 250,HARD,2,Dudi Sela,Marco Chiudinelli,Dudi Sela,6-4; 6-4,R32,90,1,1,45,63,33,45,10,18,3,4,10,43,63,2,1,42,65,27,42,12,23,1,4,10,39,65
2012-09-24 00:00:00.000,Bangkok Thailand ATP World Tour 250,HARD,2,Grigor Dimitrov,Tsung-Hua Yang,Grigor Dimitrov,6-3; 3-6; 7-6(7),R32,136,12,2,51,88,45,51,21,37,2,3,15,66,88,4,1,56,96,41,56,26,40,1,2,15,67,96
2012-09-24 00:00:00.000,Bangkok Thailand ATP World Tour 250,HARD,2,Richard Gasquet,N/A Bye,Richard Gasquet,,R32,0,0,0,0,0,0,0,0,0,0,0,0,0,0,0,0,0,0,0,0,0,0,0,0,0,0,0
2012-09-24 00:00:00.000,Bangkok Thailand ATP World Tour 250,HARD,2,Janko Tipsarevic,Hiroki Moriya,Janko Tipsarevic,6-4; 6-4,R16,97,8,2,30,51,27,30,13,21,0,0,10,40,51,1,2,46,73,30,46,14,27,8,10,10,44,73
2012-09-24 00:00:00.000,Bangkok Thailand ATP World Tour 250,HARD,2,Fernando Verdasco,Donald Young,Fernando Verdasco,7-5; 6-4,R16,99,3,1,57,65,41,57,4,8,0,0,11,45,65,2,0,56,77,37,56,12,21,7,9,11,49,77
2012-09-24 00:00:00.000,Bangkok Thailand ATP World Tour 250,HARD,2,Gilles Simon,Go Soeda,Gilles Simon,6-4; 6-4,R16,108,3,3,47,76,29,47,18,29,4,6,10,47,76,0,2,46,82,30,46,13,36,8,12,10,43,82
2012-09-24 00:00:00.000,Bangkok Thailand ATP World Tour 250,HARD,2,Gael Monfils,Viktor Troicki,Gael Monfils,7-5; 7-5,R16,112,3,2,60,82,38,60,12,22,5,8,12,50,82,6,0,56,84,38,56,8,28,7,12,12,46,84
2012-09-24 00:00:00.000,Bangkok Thailand ATP World Tour 250,HARD,2,Jarkko Nieminen,Philipp Petzschner,Jarkko Nieminen,7-6(1); 6-2,R16,88,1,0,42,58,29,42,8,16,4,7,10,37,58,0,2,36,68,19,36,14,32,8,13,10,33,68
2012-09-24 00:00:00.000,Bangkok Thailand ATP World Tour 250,HARD,2,Milos Raonic,Ivo Karlovic,Milos Raonic,7-6(3); 6-4,R16,91,14,3,47,66,41,47,10,19,0,0,11,51,66,9,2,40,62,33,40,11,22,2,3,11,44,62
2012-09-24 00:00:00.000,Bangkok Thailand ATP World Tour 250,HARD,2,Bernard Tomic,Dudi Sela,Bernard Tomic,4-6; 6-3; 6-4,R16,142,4,0,87,122,55,87,19,35,11,13,15,74,122,0,1,78,105,54,78,10,27,9,12,14,64,105
2012-09-24 00:00:00.000,Bangkok Thailand ATP World Tour 250,HARD,2,Richard Gasquet,Grigor Dimitrov,Richard Gasquet,5-7; 7-5; 6-4,R16,136,4,1,60,94,41,60,27,34,5,7,17,68,94,21,3,74,100,53,74,12,26,5,8,17,65,100
2012-09-24 00:00:00.000,Bangkok Thailand ATP World Tour 250,HARD,2,Janko Tipsarevic,Fernando Verdasco,Janko Tipsarevic,7-6(5); 6-4,Q,111,7,2,55,84,41,55,16,29,7,9,11,57,84,2,2,48,62,33,48,7,14,2,5,11,40,62
2012-09-24 00:00:00.000,Bangkok Thailand ATP World Tour 250,HARD,2,Gilles Simon,Gael Monfils,Gilles Simon,6-4; 6-1,Q,85,1,0,30,55,21,30,13,25,5,7,9,34,55,1,2,38,51,15,38,7,13,3,8,8,22,51
2012-09-24 00:00:00.000,Bangkok Thailand ATP World Tour 250,HARD,2,Jarkko Nieminen,Milos Raonic,Jarkko Nieminen,6-3; 7-6(3),Q,93,1,2,52,67,42,52,10,15,0,0,11,52,67,8,0,40,71,30,40,17,31,4,5,10,47,71
2012-09-24 00:00:00.000,Bangkok Thailand ATP World Tour 250,HARD,2,Richard Gasquet,Bernard Tomic,Richard Gasquet,7-6(5); 6-4,Q,89,2,0,45,74,29,45,23,29,3,3,11,52,74,4,0,49,62,37,49,8,13,1,2,11,45,62
2012-09-24 00:00:00.000,Bangkok Thailand ATP World Tour 250,HARD,2,Gilles Simon,Janko Tipsarevic,Gilles Simon,6-4; 6-4,S,104,6,1,32,52,27,32,14,20,1,1,10,41,52,7,2,43,72,33,43,11,29,8,10,10,44,72
2012-09-24 00:00:00.000,Bangkok Thailand ATP World Tour 250,HARD,2,Richard Gasquet,Jarkko Nieminen,Richard Gasquet,3-6; 7-5; 6-2,S,116,7,2,56,83,38,56,17,27,3,6,14,55,83,3,3,68,96,43,68,12,28,5,10,15,55,96
2012-09-24 00:00:00.000,Bangkok Thailand ATP World Tour 250,HARD,2,Richard Gasquet,Gilles Simon,Richard Gasquet,6-2; 6-1,F,68,2,0,25,40,20,25,10,15,0,1,8,30,40,3,0,28,48,13,28,7,20,3,8,7,20,48
2012-09-24 00:00:00.000,Kuala Lumpur Malaysia ATP World Tour 250,HARD,2,David Ferrer,N/A Bye,David Ferrer,,R32,0,0,0,0,0,0,0,0,0,0,0,0,0,0,0,0,0,0,0,0,0,0,0,0,0,0,0
2012-09-24 00:00:00.000,Kuala Lumpur Malaysia ATP World Tour 250,HARD,2,Alex Bogomolov Jr.,Dominic Inglot,Alex Bogomolov Jr.,7-5; 6-3,R32,67,2,1,43,53,33,43,8,10,0,0,10,41,53,12,4,41,69,30,41,10,28,9,12,11,40,69
2012-09-24 00:00:00.000,Kuala Lumpur Malaysia ATP World Tour 250,HARD,2,Igor Sijsling,Ariez Elyaas Deen Heshaam,Igor Sijsling,6-2; 6-1,R32,50,3,1,20,36,14,20,12,16,0,1,7,26,36,1,0,25,45,10,25,7,20,2,8,8,17,45
2012-09-24 00:00:00.000,Kuala Lumpur Malaysia ATP World Tour 250,HARD,2,Feliciano Lopez,Lukas Lacko,Feliciano Lopez,6-3; 7-6(3),R32,100,5,5,40,72,31,40,19,32,5,6,10,50,72,1,3,40,70,29,40,12,30,2,5,11,41,70
2012-09-24 00:00:00.000,Kuala Lumpur Malaysia ATP World Tour 250,HARD,2,Alexandr Dolgopolov,N/A Bye,Alexandr Dolgopolov,,R32,0,0,0,0,0,0,0,0,0,0,0,0,0,0,0,0,0,0,0,0,0,0,0,0,0,0,0
2012-09-24 00:00:00.000,Kuala Lumpur Malaysia ATP World Tour 250,HARD,2,Alejandro Falla,Rajeev Ram,Alejandro Falla,7-6(4); 4-2 RET,R32,82,8,3,32,53,26,32,14,21,1,2,9,40,53,2,1,38,63,28,38,12,25,1,3,9,40,63
2012-09-24 00:00:00.000,Kuala Lumpur Malaysia ATP World Tour 250,HARD,2,Matthew Ebden,Philipp Davydenko,Matthew Ebden,6-0; 7-6(3),R32,77,3,3,34,53,29,34,7,19,1,3,9,36,53,0,3,40,65,20,40,12,25,8,13,9,32,65
2012-09-24 00:00:00.000,Kuala Lumpur Malaysia ATP World Tour 250,HARD,2,Julien Benneteau,Carlos Berlocq,Julien Benneteau,7-6(2); 6-3,R32,91,4,2,44,58,33,44,6,14,0,2,10,39,58,4,5,34,66,21,34,15,32,1,5,11,36,66
2012-09-24 00:00:00.000,Kuala Lumpur Malaysia ATP World Tour 250,HARD,2,Denis Istomin,Pablo Andujar,Denis Istomin,6-3; 6-2,R32,74,6,2,35,57,27,35,11,22,0,1,9,38,57,0,3,23,49,14,23,11,26,4,8,8,25,49
2012-09-24 00:00:00.000,Kuala Lumpur Malaysia ATP World Tour 250,HARD,2,Nikolay Davydenko,Sanam Singh,Nikolay Davydenko,7-5; 6-4,R32,104,5,6,44,63,29,44,9,19,3,6,11,38,63,0,1,47,79,28,47,13,32,11,16,11,41,79
2012-09-24 00:00:00.000,Kuala Lumpur Malaysia ATP World Tour 250,HARD,2,Albert Ramos-Vinolas,Julian Knowle,Albert Ramos-Vinolas,6-1; 6-4,R32,69,14,3,30,46,24,30,10,16,1,2,9,34,46,6,0,39,56,23,39,5,17,3,7,8,28,56
2012-09-24 00:00:00.000,Kuala Lumpur Malaysia ATP World Tour 250,HARD,2,Kei Nishikori,N/A Bye,Kei Nishikori,,R32,0,0,0,0,0,0,0,0,0,0,0,0,0,0,0,0,0,0,0,0,0,0,0,0,0,0,0
2012-09-24 00:00:00.000,Kuala Lumpur Malaysia ATP World Tour 250,HARD,2,Vasek Pospisil,Jurgen Melzer,Vasek Pospisil,6-4; 2-0 RET,R32,55,5,3,20,35,17,20,4,15,0,2,6,21,35,0,0,27,40,13,27,6,13,2,6,6,19,40
2012-09-24 00:00:00.000,Kuala Lumpur Malaysia ATP World Tour 250,HARD,2,Michael Yani,Brian Baker,Michael Yani,6-3; 7-6(4),R32,102,5,0,48,66,35,48,9,18,1,3,11,44,66,1,3,52,80,31,52,13,28,7,10,10,44,80
2012-09-24 00:00:00.000,Kuala Lumpur Malaysia ATP World Tour 250,HARD,2,Jimmy Wang,Riccardo Ghedin,Jimmy Wang,6-3; 6-3,R32,87,9,1,41,59,27,41,11,18,2,3,9,38,59,2,1,48,69,28,48,8,21,5,9,9,36,69
2012-09-24 00:00:00.000,Kuala Lumpur Malaysia ATP World Tour 250,HARD,2,Juan Monaco,N/A Bye,Juan Monaco,,R32,0,0,0,0,0,0,0,0,0,0,0,0,0,0,0,0,0,0,0,0,0,0,0,0,0,0,0
2012-09-24 00:00:00.000,Kuala Lumpur Malaysia ATP World Tour 250,HARD,2,David Ferrer,Alex Bogomolov Jr.,David Ferrer,6-4; 6-2,R16,83,1,1,25,50,17,25,19,25,2,3,9,36,50,0,3,39,63,20,39,10,24,4,8,9,30,63
2012-09-24 00:00:00.000,Kuala Lumpur Malaysia ATP World Tour 250,HARD,2,Igor Sijsling,Feliciano Lopez,Igor Sijsling,7-6(0); 7-6(2),R16,96,11,0,49,82,41,49,21,33,6,6,12,62,82,11,2,47,80,36,47,18,33,3,3,12,54,80
2012-09-24 00:00:00.000,Kuala Lumpur Malaysia ATP World Tour 250,HARD,2,Alejandro Falla,Alexandr Dolgopolov,Alejandro Falla,6-3; 3-6; 6-3,R16,92,3,3,60,92,39,60,18,32,5,8,14,57,92,5,1,42,71,29,42,13,29,3,7,13,42,71
2012-09-24 00:00:00.000,Kuala Lumpur Malaysia ATP World Tour 250,HARD,2,Julien Benneteau,Matthew Ebden,Julien Benneteau,7-5; 6-2,R16,75,5,0,36,55,28,36,12,19,2,3,10,40,55,4,3,38,55,26,38,5,17,3,7,10,31,55
2012-09-24 00:00:00.000,Kuala Lumpur Malaysia ATP World Tour 250,HARD,2,Nikolay Davydenko,Denis Istomin,Nikolay Davydenko,7-5; 6-4,R16,101,0,6,54,78,38,54,10,24,5,7,11,48,78,5,0,46,70,32,46,8,24,3,7,11,40,70
2012-09-24 00:00:00.000,Kuala Lumpur Malaysia ATP World Tour 250,HARD,2,Kei Nishikori,Albert Ramos-Vinolas,Kei Nishikori,6-7(5); 6-2; 6-1,R16,133,2,6,43,91,31,43,29,48,3,4,14,60,91,2,2,45,74,30,45,12,29,0,5,13,42,74
2012-09-24 00:00:00.000,Kuala Lumpur Malaysia ATP World Tour 250,HARD,2,Vasek Pospisil,Michael Yani,Vasek Pospisil,6-3; 7-5,R16,110,9,4,49,78,38,49,15,29,5,5,11,53,78,2,6,46,74,32,46,12,28,11,13,10,44,74
2012-09-24 00:00:00.000,Kuala Lumpur Malaysia ATP World Tour 250,HARD,2,Juan Monaco,Jimmy Wang,Juan Monaco,6-4; 7-5,R16,108,3,1,41,61,29,41,10,20,3,6,11,39,61,0,4,39,69,17,39,19,30,6,11,11,36,69
2012-09-24 00:00:00.000,Kuala Lumpur Malaysia ATP World Tour 250,HARD,2,David Ferrer,Igor Sijsling,David Ferrer,4-6; 6-3; 6-4,Q,124,5,3,50,85,32,50,26,35,6,9,15,58,85,10,3,58,92,41,58,12,34,3,7,14,53,92
2012-09-24 00:00:00.000,Kuala Lumpur Malaysia ATP World Tour 250,HARD,2,Julien Benneteau,Alejandro Falla,Julien Benneteau,6-2; 6-2,Q,59,1,3,22,39,19,22,13,17,0,0,8,32,39,1,2,26,46,17,26,4,20,2,6,8,21,46
2012-09-24 00:00:00.000,Kuala Lumpur Malaysia ATP World Tour 250,HARD,2,Kei Nishikori,Nikolay Davydenko,Kei Nishikori,6-4 RET,Q,58,0,0,22,31,17,22,5,9,3,3,5,22,31,2,3,31,47,20,31,7,16,3,4,5,27,47
2012-09-24 00:00:00.000,Kuala Lumpur Malaysia ATP World Tour 250,HARD,2,Juan Monaco,Vasek Pospisil,Juan Monaco,6-3; 6-4,Q,84,1,0,29,47,24,29,13,18,2,2,9,37,47,7,3,34,58,25,34,10,24,4,7,10,35,58
2012-09-24 00:00:00.000,Kuala Lumpur Malaysia ATP World Tour 250,HARD,2,Julien Benneteau,David Ferrer,Julien Benneteau,6-4; 6-1,S,97,3,6,48,80,33,48,13,32,10,12,9,46,80,1,3,33,54,16,33,8,21,1,6,8,24,54
2012-09-24 00:00:00.000,Kuala Lumpur Malaysia ATP World Tour 250,HARD,2,Juan Monaco,Kei Nishikori,Juan Monaco,6-2; 2-6; 7-6(4),S,162,2,3,64,100,45,64,17,36,6,10,14,62,100,3,2,62,91,41,62,15,29,7,11,14,56,91
2012-09-24 00:00:00.000,Kuala Lumpur Malaysia ATP World Tour 250,HARD,2,Juan Monaco,Julien Benneteau,Juan Monaco,7-5; 4-6; 6-3,F,181,6,4,67,98,49,67,11,31,3,7,16,60,98,4,4,93,125,54,93,15,32,15,20,15,69,125
2012-10-01 00:00:00.000,Beijing China ATP World Tour 500,HARD,2,Novak Djokovic,Michael Berrer,Novak Djokovic,6-1; 6-7(3); 6-2,R32,119,6,1,58,85,45,58,18,27,1,1,14,63,85,7,2,62,88,41,62,11,26,3,7,13,52,88
2012-10-01 00:00:00.000,Beijing China ATP World Tour 500,HARD,2,Carlos Berlocq,Marinko Matosevic,Carlos Berlocq,3-6; 6-2; 6-3,R32,114,4,5,46,72,36,46,13,26,2,4,13,49,72,5,3,53,82,31,53,16,29,8,12,13,47,82
2012-10-01 00:00:00.000,Beijing China ATP World Tour 500,HARD,2,Jurgen Melzer,Pablo Andujar,Jurgen Melzer,6-1; 4-6; 7-6(3),R32,145,12,4,54,99,40,54,20,45,10,14,14,60,99,4,5,59,95,34,59,16,36,4,10,15,50,95
2012-10-01 00:00:00.000,Beijing China ATP World Tour 500,HARD,2,Alexandr Dolgopolov,Guillermo Garcia-Lopez,Alexandr Dolgopolov,6-0; 6-4,R32,69,2,0,18,43,16,18,17,25,1,1,8,33,43,3,3,34,62,24,34,7,28,7,11,8,31,62
2012-10-01 00:00:00.000,Beijing China ATP World Tour 500,HARD,2,Marius Copil,Marin Cilic,Marius Copil,3-6; 7-6(0); 6-4,R32,146,21,4,62,102,46,62,15,40,7,11,15,61,102,6,3,50,93,33,50,23,43,2,6,16,56,93
2012-10-01 00:00:00.000,Beijing China ATP World Tour 500,HARD,2,Florian Mayer,Fabio Fognini,Florian Mayer,6-1; 6-2,R32,52,4,2,18,43,14,18,19,25,0,0,8,33,43,1,4,26,40,13,26,5,14,1,5,7,18,40
2012-10-01 00:00:00.000,Beijing China ATP World Tour 500,HARD,2,Ze Zhang,Di Wu,Ze Zhang,6-4; 6-1,R32,78,5,4,23,47,18,23,12,24,2,4,8,30,47,0,3,34,67,17,34,14,33,5,11,9,31,67
2012-10-01 00:00:00.000,Beijing China ATP World Tour 500,HARD,2,Richard Gasquet,Matthew Ebden,Richard Gasquet,6-2; 6-4,R32,81,5,1,28,48,24,28,11,20,2,3,9,35,48,6,5,33,64,23,33,10,31,4,8,9,33,64
2012-10-01 00:00:00.000,Beijing China ATP World Tour 500,HARD,2,Mikhail Youzhny,Tommy Haas,Mikhail Youzhny,6-4; 4-6; 6-2,R32,143,9,2,59,99,42,59,19,40,8,10,14,61,99,5,10,54,96,41,54,15,42,10,14,14,56,96
2012-10-01 00:00:00.000,Beijing China ATP World Tour 500,HARD,2,Kevin Anderson,Brian Baker,Kevin Anderson,5-7; 6-3; 6-1,R32,116,19,3,44,74,36,44,18,30,1,3,14,54,74,5,3,55,92,33,55,19,37,6,11,14,52,92
2012-10-01 00:00:00.000,Beijing China ATP World Tour 500,HARD,2,Nikolay Davydenko,Alex Bogomolov Jr.,Nikolay Davydenko,7-5; 6-1,R32,102,2,0,49,65,30,49,6,16,4,7,9,36,65,2,4,53,83,26,53,12,30,9,16,10,38,83
2012-10-01 00:00:00.000,Beijing China ATP World Tour 500,HARD,2,Jo-Wilfried Tsonga,Denis Istomin,Jo-Wilfried Tsonga,4-6; 6-1; 7-6(3),R32,117,14,4,57,97,47,57,24,40,5,6,15,71,97,9,2,53,85,40,53,19,32,3,5,14,59,85
2012-10-01 00:00:00.000,Beijing China ATP World Tour 500,HARD,2,Sam Querrey,Fernando Verdasco,Sam Querrey,5-7; 6-3; 6-4,R32,117,10,6,51,95,43,51,24,44,6,7,16,67,95,3,3,51,79,41,51,16,28,0,2,15,57,79
2012-10-01 00:00:00.000,Beijing China ATP World Tour 500,HARD,2,Andreas Seppi,Julien Benneteau,Andreas Seppi,6-1; 2-0 RET,R32,33,1,0,20,34,13,20,9,14,4,5,5,22,34,0,2,16,26,5,16,3,10,1,5,4,8,26
2012-10-01 00:00:00.000,Beijing China ATP World Tour 500,HARD,2,Feliciano Lopez,Ryan Harrison,Feliciano Lopez,7-6(3); 5-7; 6-2,R32,131,6,4,55,92,46,55,21,37,3,5,16,67,92,6,4,55,103,40,55,27,48,5,8,16,67,103
2012-10-01 00:00:00.000,Beijing China ATP World Tour 500,HARD,2,Yen-Hsun Lu,David Ferrer,Yen-Hsun Lu,5-4 RET,R32,36,4,0,22,30,15,22,5,8,2,3,5,20,30,1,1,13,23,7,13,8,10,2,3,4,15,23
2012-10-01 00:00:00.000,Beijing China ATP World Tour 500,HARD,2,Novak Djokovic,Carlos Berlocq,Novak Djokovic,6-1; 6-3,R16,75,5,2,39,53,28,39,5,14,1,3,8,33,53,1,3,44,62,21,44,6,18,6,12,8,27,62
2012-10-01 00:00:00.000,Beijing China ATP World Tour 500,HARD,2,Jurgen Melzer,Alexandr Dolgopolov,Jurgen Melzer,7-6(9); 2-6; 6-1,R16,108,6,2,45,81,38,45,23,36,2,4,14,61,81,13,4,46,97,35,46,26,51,9,11,13,61,97
2012-10-01 00:00:00.000,Beijing China ATP World Tour 500,HARD,2,Florian Mayer,Marius Copil,Florian Mayer,3-6; 6-3; 6-2,R16,104,3,2,58,84,39,58,15,26,4,6,13,54,84,13,2,43,74,33,43,14,31,6,10,13,47,74
2012-10-01 00:00:00.000,Beijing China ATP World Tour 500,HARD,2,Ze Zhang,Richard Gasquet,Ze Zhang,6-4; 3-6; 6-4,R16,130,6,3,52,88,37,52,20,36,1,3,14,57,88,5,1,53,86,37,53,18,33,0,3,15,55,86
2012-10-01 00:00:00.000,Beijing China ATP World Tour 500,HARD,2,Mikhail Youzhny,Kevin Anderson,Mikhail Youzhny,6-3; 6-3,R16,92,2,1,31,60,22,31,17,29,4,5,9,39,60,5,0,26,49,13,26,12,23,1,5,9,25,49
2012-10-01 00:00:00.000,Beijing China ATP World Tour 500,HARD,2,Jo-Wilfried Tsonga,Nikolay Davydenko,Jo-Wilfried Tsonga,W/O,R16,0,0,0,0,0,0,0,0,0,0,0,0,0,0,0,0,0,0,0,0,0,0,0,0,0,0,0
2012-10-01 00:00:00.000,Beijing China ATP World Tour 500,HARD,2,Sam Querrey,Andreas Seppi,Sam Querrey,6-1; 6-4,R16,67,6,0,27,49,23,27,14,22,0,0,9,37,49,1,4,32,59,21,32,12,27,6,9,8,33,59
2012-10-01 00:00:00.000,Beijing China ATP World Tour 500,HARD,2,Feliciano Lopez,Yen-Hsun Lu,Feliciano Lopez,6-3; 7-6(7),R16,93,10,3,37,73,29,37,21,36,2,4,11,50,73,8,4,40,63,30,40,9,23,2,5,10,39,63
2012-10-01 00:00:00.000,Beijing China ATP World Tour 500,HARD,2,Novak Djokovic,Jurgen Melzer,Novak Djokovic,6-1; 6-2,Q,54,12,3,30,43,24,30,9,13,2,2,8,33,43,3,0,24,44,14,24,7,20,0,4,7,21,44
2012-10-01 00:00:00.000,Beijing China ATP World Tour 500,HARD,2,Florian Mayer,Ze Zhang,Florian Mayer,6-3; 6-4,Q,84,5,1,45,74,34,45,13,29,10,11,10,47,74,0,3,35,51,23,35,8,16,4,7,9,31,51
2012-10-01 00:00:00.000,Beijing China ATP World Tour 500,HARD,2,Jo-Wilfried Tsonga,Mikhail Youzhny,Jo-Wilfried Tsonga,6-3; 6-2,Q,69,6,2,31,57,24,31,15,26,2,2,9,39,57,0,2,20,39,11,20,12,19,2,5,8,23,39
2012-10-01 00:00:00.000,Beijing China ATP World Tour 500,HARD,2,Feliciano Lopez,Sam Querrey,Feliciano Lopez,4-6; 6-4; 6-4,Q,147,12,4,67,118,47,67,20,51,13,17,15,67,118,10,1,55,93,40,55,15,38,5,10,15,55,93
2012-10-01 00:00:00.000,Beijing China ATP World Tour 500,HARD,2,Novak Djokovic,Florian Mayer,Novak Djokovic,6-1; 6-4,S,60,7,2,40,56,32,40,9,16,2,2,9,41,56,0,0,31,42,18,31,8,11,0,3,8,26,42
2012-10-01 00:00:00.000,Beijing China ATP World Tour 500,HARD,2,Jo-Wilfried Tsonga,Feliciano Lopez,Jo-Wilfried Tsonga,6-1; 4-1 RET,S,42,7,0,19,27,16,19,8,8,0,0,6,24,27,2,2,22,35,11,22,4,13,3,7,6,15,35
2012-10-01 00:00:00.000,Beijing China ATP World Tour 500,HARD,2,Novak Djokovic,Jo-Wilfried Tsonga,Novak Djokovic,7-6(4); 6-2,F,102,1,2,39,66,27,39,17,27,5,6,10,44,66,9,3,43,73,30,43,10,30,5,8,10,40,73
2012-10-01 00:00:00.000,Tokyo Japan ATP World Tour 500,HARD,2,Andy Murray,Ivo Karlovic,Andy Murray,7-6(7); 6-4,R32,98,9,0,33,59,29,33,21,26,0,0,11,50,59,18,2,47,73,37,47,14,26,5,6,11,51,73
2012-10-01 00:00:00.000,Tokyo Japan ATP World Tour 500,HARD,2,Lukas Lacko,Albert Ramos-Vinolas,Lukas Lacko,6-0; 6-2,R32,59,3,2,24,40,18,24,12,16,0,0,7,30,40,1,3,25,37,13,25,2,12,2,7,7,15,37
2012-10-01 00:00:00.000,Tokyo Japan ATP World Tour 500,HARD,2,Jeremy Chardy,Yuichi Sugita,Jeremy Chardy,6-1; 7-5,R32,74,14,0,32,53,26,32,15,21,3,3,10,41,53,1,2,24,49,16,24,13,25,2,5,9,29,49
2012-10-01 00:00:00.000,Tokyo Japan ATP World Tour 500,HARD,2,Stan Wawrinka,Hiroki Moriya,Stan Wawrinka,7-5; 4-6; 6-4,R32,135,10,5,48,101,37,48,28,53,3,5,16,65,101,2,5,67,105,47,67,20,38,7,10,16,67,105
2012-10-01 00:00:00.000,Tokyo Japan ATP World Tour 500,HARD,2,Janko Tipsarevic,Gilles Simon,Janko Tipsarevic,4-6; 6-3; 6-1,R32,145,6,0,75,116,49,75,20,41,13,16,13,69,116,4,3,39,72,27,39,12,33,5,11,13,39,72
2012-10-01 00:00:00.000,Tokyo Japan ATP World Tour 500,HARD,2,Marco Chiudinelli,Martin Klizan,Marco Chiudinelli,7-6(3); 6-2,R32,99,1,2,34,55,27,34,14,21,3,5,10,41,55,1,3,49,80,31,49,13,31,9,13,10,44,80
2012-10-01 00:00:00.000,Tokyo Japan ATP World Tour 500,HARD,2,Viktor Troicki,Robin Haase,Viktor Troicki,6-2; 6-3,R32,65,12,1,31,54,28,31,13,23,4,4,9,41,54,1,2,27,53,17,27,11,26,3,6,8,28,53
2012-10-01 00:00:00.000,Tokyo Japan ATP World Tour 500,HARD,2,Milos Raonic,Radek Stepanek,Milos Raonic,6-4; 6-4,R32,83,10,3,40,61,32,40,11,21,1,1,10,43,61,3,3,38,53,27,38,9,15,2,4,10,36,53
2012-10-01 00:00:00.000,Tokyo Japan ATP World Tour 500,HARD,2,Tatsuma Ito,Nicolas Almagro,Tatsuma Ito,7-6(4); 7-6(5),R32,115,14,6,56,98,48,56,20,42,6,7,12,68,98,8,0,49,81,39,49,16,32,4,5,12,55,81
2012-10-01 00:00:00.000,Tokyo Japan ATP World Tour 500,HARD,2,Dmitry Tursunov,Bernard Tomic,Dmitry Tursunov,6-4; 7-5,R32,82,8,5,33,63,30,33,16,30,1,1,11,46,63,9,1,49,68,34,49,7,19,2,4,11,41,68
2012-10-01 00:00:00.000,Tokyo Japan ATP World Tour 500,HARD,2,Marcos Baghdatis,Sergiy Stakhovsky,Marcos Baghdatis,7-6(3); 7-5,R32,99,6,4,32,71,23,32,27,39,0,1,12,50,71,7,4,53,79,38,53,12,26,3,5,12,50,79
2012-10-01 00:00:00.000,Tokyo Japan ATP World Tour 500,HARD,2,Juan Monaco,Grigor Dimitrov,Juan Monaco,6-2; 6-1,R32,64,3,0,40,46,29,40,4,6,4,4,7,33,46,1,1,39,48,19,39,3,9,2,7,8,22,48
2012-10-01 00:00:00.000,Tokyo Japan ATP World Tour 500,HARD,2,Kei Nishikori,Go Soeda,Kei Nishikori,4-6; 6-2; 6-3,R32,150,2,2,64,102,41,64,15,38,6,10,13,56,102,6,2,55,102,27,55,25,47,12,19,14,52,102
2012-10-01 00:00:00.000,Tokyo Japan ATP World Tour 500,HARD,2,Tommy Robredo,Jarkko Nieminen,Tommy Robredo,6-2; 6-4,R32,73,4,1,34,53,27,34,12,19,2,2,9,39,53,3,2,44,60,27,44,8,16,5,8,9,35,60
2012-10-01 00:00:00.000,Tokyo Japan ATP World Tour 500,HARD,2,Alejandro Falla,Thomaz Bellucci,Alejandro Falla,7-5; 6-2,R32,84,4,1,45,63,31,45,8,18,5,8,10,39,63,0,6,28,62,16,28,13,34,10,16,10,29,62
2012-10-01 00:00:00.000,Tokyo Japan ATP World Tour 500,HARD,2,Tomas Berdych,Benoit Paire,Tomas Berdych,6-1; 7-6(6),R32,104,5,2,46,79,38,46,14,33,4,5,10,52,79,9,1,29,63,20,29,16,34,3,6,9,36,63
2012-10-01 00:00:00.000,Tokyo Japan ATP World Tour 500,HARD,2,Andy Murray,Lukas Lacko,Andy Murray,6-1; 6-2,R16,57,6,3,26,45,20,26,13,19,1,1,8,33,45,0,0,20,32,9,20,3,12,0,4,7,12,32
2012-10-01 00:00:00.000,Tokyo Japan ATP World Tour 500,HARD,2,Stan Wawrinka,Jeremy Chardy,Stan Wawrinka,7-6(1); 6-7(6); 7-5,R16,158,19,1,59,107,55,59,25,48,3,4,18,80,107,8,4,63,101,52,63,22,38,4,6,18,74,101
2012-10-01 00:00:00.000,Tokyo Japan ATP World Tour 500,HARD,2,Janko Tipsarevic,Marco Chiudinelli,Janko Tipsarevic,6-4; 6-2,R16,110,10,1,38,64,29,38,15,26,6,6,9,44,64,6,3,56,86,37,56,10,30,6,9,9,47,86
2012-10-01 00:00:00.000,Tokyo Japan ATP World Tour 500,HARD,2,Milos Raonic,Viktor Troicki,Milos Raonic,3-0 RET,R16,7,2,0,1,4,1,1,3,3,0,0,1,4,4,1,1,2,10,1,2,1,8,0,2,2,2,10
2012-10-01 00:00:00.000,Tokyo Japan ATP World Tour 500,HARD,2,Dmitry Tursunov,Tatsuma Ito,Dmitry Tursunov,7-5; 6-3,R16,96,4,5,47,72,34,47,14,25,6,7,11,48,72,4,2,37,59,24,37,12,22,6,9,10,36,59
2012-10-01 00:00:00.000,Tokyo Japan ATP World Tour 500,HARD,2,Marcos Baghdatis,Juan Monaco,Marcos Baghdatis,7-5; 1-6; 6-3,R16,137,6,7,47,89,35,47,22,42,2,4,14,57,89,3,3,60,88,42,60,15,28,5,7,14,57,88
2012-10-01 00:00:00.000,Tokyo Japan ATP World Tour 500,HARD,2,Kei Nishikori,Tommy Robredo,Kei Nishikori,5-7; 6-1; 6-0,R16,116,4,1,47,72,37,47,14,25,3,5,13,51,72,5,6,49,93,33,49,15,44,14,20,12,48,93
2012-10-01 00:00:00.000,Tokyo Japan ATP World Tour 500,HARD,2,Tomas Berdych,Alejandro Falla,Tomas Berdych,6-3; 7-5,R16,79,9,1,35,51,32,35,12,16,0,0,11,44,51,3,2,32,60,21,32,16,28,3,5,10,37,60
2012-10-01 00:00:00.000,Tokyo Japan ATP World Tour 500,HARD,2,Andy Murray,Stan Wawrinka,Andy Murray,6-2; 3-6; 6-2,Q,121,7,3,45,79,36,45,17,34,6,7,12,53,79,5,1,43,89,30,43,23,46,7,11,13,53,89
2012-10-01 00:00:00.000,Tokyo Japan ATP World Tour 500,HARD,2,Milos Raonic,Janko Tipsarevic,Milos Raonic,6-7(5); 6-2; 7-6(7),Q,164,24,5,68,100,59,68,17,32,0,0,16,76,100,7,4,62,120,50,62,30,58,6,8,16,80,120
2012-10-01 00:00:00.000,Tokyo Japan ATP World Tour 500,HARD,2,Marcos Baghdatis,Dmitry Tursunov,Marcos Baghdatis,6-2; 6-4,Q,81,9,1,40,56,34,40,7,16,3,3,9,41,56,4,4,30,56,21,30,11,26,3,6,9,32,56
2012-10-01 00:00:00.000,Tokyo Japan ATP World Tour 500,HARD,2,Kei Nishikori,Tomas Berdych,Kei Nishikori,7-5; 6-4,Q,118,1,1,37,62,27,37,13,25,1,3,11,40,62,6,1,45,80,29,45,16,35,9,13,11,45,80
2012-10-01 00:00:00.000,Tokyo Japan ATP World Tour 500,HARD,2,Milos Raonic,Andy Murray,Milos Raonic,6-3; 6-7(5); 7-6(4),S,166,13,7,72,111,59,72,18,39,5,6,16,77,111,8,3,75,111,56,75,18,36,4,7,17,74,111
2012-10-01 00:00:00.000,Tokyo Japan ATP World Tour 500,HARD,2,Kei Nishikori,Marcos Baghdatis,Kei Nishikori,6-2; 6-2,S,61,2,1,28,43,21,28,12,15,0,0,8,33,43,0,3,24,48,16,24,10,24,2,6,8,26,48
2012-10-01 00:00:00.000,Tokyo Japan ATP World Tour 500,HARD,2,Kei Nishikori,Milos Raonic,Kei Nishikori,7-6(5); 3-6; 6-0,F,128,0,2,50,78,33,50,21,28,3,5,13,54,78,14,3,65,104,46,65,15,39,6,10,14,61,104
2012-10-07 00:00:00.000,ATP World Tour Masters 1000 Shanghai Shanghai; China ATP World Tour Masters 1000,HARD,2,Roger Federer,N/A Bye,Roger Federer,,R64,0,0,0,0,0,0,0,0,0,0,0,0,0,0,0,0,0,0,0,0,0,0,0,0,0,0,0
2012-10-07 00:00:00.000,ATP World Tour Masters 1000 Shanghai Shanghai; China ATP World Tour Masters 1000,HARD,2,Yen-Hsun Lu,Ze Zhang,Yen-Hsun Lu,6-0; 6-2,R64,54,7,1,24,37,20,24,9,13,0,0,7,29,37,3,2,22,39,10,22,5,17,4,9,7,15,39
2012-10-07 00:00:00.000,ATP World Tour Masters 1000 Shanghai Shanghai; China ATP World Tour Masters 1000,HARD,2,Denis Istomin,Carlos Berlocq,Denis Istomin,4-6; 6-2; 6-1,R64,121,6,1,59,88,40,59,17,29,4,6,13,57,88,3,6,46,69,28,46,8,23,1,6,12,36,69
2012-10-07 00:00:00.000,ATP World Tour Masters 1000 Shanghai Shanghai; China ATP World Tour Masters 1000,HARD,2,Stan Wawrinka,Albert Ramos-Vinolas,Stan Wawrinka,7-6(1); 7-6(5),R64,113,5,2,43,84,34,43,20,41,2,4,12,54,84,2,5,54,87,33,54,20,33,8,10,12,53,87
2012-10-07 00:00:00.000,ATP World Tour Masters 1000 Shanghai Shanghai; China ATP World Tour Masters 1000,HARD,2,Marin Cilic,Lukasz Kubot,Marin Cilic,7-5; 6-3,R64,93,8,2,35,60,24,35,15,25,2,3,10,39,60,2,4,46,67,27,46,10,21,5,9,11,37,67
2012-10-07 00:00:00.000,ATP World Tour Masters 1000 Shanghai Shanghai; China ATP World Tour Masters 1000,HARD,2,Martin Klizan,Thomaz Bellucci,Martin Klizan,6-3; 6-4,R64,88,2,4,42,77,29,42,17,35,9,11,10,46,77,2,1,35,54,23,35,5,19,0,4,9,28,54
2012-10-07 00:00:00.000,ATP World Tour Masters 1000 Shanghai Shanghai; China ATP World Tour Masters 1000,HARD,2,Fernando Verdasco,Go Soeda,Fernando Verdasco,6-2; 6-4,R64,88,6,4,45,68,32,45,11,23,5,6,9,43,68,1,5,30,61,18,30,13,31,2,6,9,31,61
2012-10-07 00:00:00.000,ATP World Tour Masters 1000 Shanghai Shanghai; China ATP World Tour Masters 1000,HARD,2,Juan Monaco,N/A Bye,Juan Monaco,,R64,0,0,0,0,0,0,0,0,0,0,0,0,0,0,0,0,0,0,0,0,0,0,0,0,0,0,0
2012-10-07 00:00:00.000,ATP World Tour Masters 1000 Shanghai Shanghai; China ATP World Tour Masters 1000,HARD,2,Andy Murray,N/A Bye,Andy Murray,,R64,0,0,0,0,0,0,0,0,0,0,0,0,0,0,0,0,0,0,0,0,0,0,0,0,0,0,0
2012-10-07 00:00:00.000,ATP World Tour Masters 1000 Shanghai Shanghai; China ATP World Tour Masters 1000,HARD,2,Florian Mayer,Bernard Tomic,Florian Mayer,6-4; 6-0,R64,46,4,0,27,46,20,27,14,19,4,4,8,34,46,2,4,24,43,14,24,8,19,1,5,8,22,43
2012-10-07 00:00:00.000,ATP World Tour Masters 1000 Shanghai Shanghai; China ATP World Tour Masters 1000,HARD,2,Alexandr Dolgopolov,Jeremy Chardy,Alexandr Dolgopolov,6-3; 6-2,R64,68,4,0,25,52,19,25,18,27,0,0,9,37,52,4,4,34,60,23,34,11,26,7,10,8,34,60
2012-10-07 00:00:00.000,ATP World Tour Masters 1000 Shanghai Shanghai; China ATP World Tour Masters 1000,HARD,2,Gilles Simon,Jurgen Melzer,Gilles Simon,6-4; 6-2,R64,82,2,3,29,61,21,29,19,32,3,3,9,40,61,3,5,38,61,25,38,10,23,4,7,9,35,61
2012-10-07 00:00:00.000,ATP World Tour Masters 1000 Shanghai Shanghai; China ATP World Tour Masters 1000,HARD,2,Richard Gasquet,Brian Baker,Richard Gasquet,6-2; 6-3,R64,71,6,2,31,57,24,31,14,26,1,2,9,38,57,5,2,25,45,18,25,5,20,1,5,8,23,45
2012-10-07 00:00:00.000,ATP World Tour Masters 1000 Shanghai Shanghai; China ATP World Tour Masters 1000,HARD,2,Radek Stepanek,Lleyton Hewitt,Radek Stepanek,7-5; 6-1,R64,86,4,3,28,50,25,28,15,22,0,0,10,40,50,5,0,22,52,15,22,16,30,3,6,9,31,52
2012-10-07 00:00:00.000,ATP World Tour Masters 1000 Shanghai Shanghai; China ATP World Tour Masters 1000,HARD,2,Kevin Anderson,Jarkko Nieminen,Kevin Anderson,6-2; 7-6(4),R64,82,16,1,37,59,34,37,12,22,4,4,10,46,59,3,3,35,66,28,35,14,31,4,6,10,42,66
2012-10-07 00:00:00.000,ATP World Tour Masters 1000 Shanghai Shanghai; China ATP World Tour Masters 1000,HARD,2,John Isner,N/A Bye,John Isner,,R64,0,0,0,0,0,0,0,0,0,0,0,0,0,0,0,0,0,0,0,0,0,0,0,0,0,0,0
2012-10-07 00:00:00.000,ATP World Tour Masters 1000 Shanghai Shanghai; China ATP World Tour Masters 1000,HARD,2,Jo-Wilfried Tsonga,N/A Bye,Jo-Wilfried Tsonga,,R64,0,0,0,0,0,0,0,0,0,0,0,0,0,0,0,0,0,0,0,0,0,0,0,0,0,0,0
2012-10-07 00:00:00.000,ATP World Tour Masters 1000 Shanghai Shanghai; China ATP World Tour Masters 1000,HARD,2,Benoit Paire,Philipp Petzschner,Benoit Paire,7-6(2); 6-4,R64,76,6,3,35,69,27,35,22,34,5,6,11,49,69,4,3,39,65,25,39,17,26,2,4,11,42,65
2012-10-07 00:00:00.000,ATP World Tour Masters 1000 Shanghai Shanghai; China ATP World Tour Masters 1000,HARD,2,Marcos Baghdatis,Fabio Fognini,Marcos Baghdatis,6-2; 6-2,R64,73,3,2,29,41,27,29,6,12,0,0,8,33,41,1,4,36,74,24,36,14,38,9,13,8,38,74
2012-10-07 00:00:00.000,ATP World Tour Masters 1000 Shanghai Shanghai; China ATP World Tour Masters 1000,HARD,2,Milos Raonic,Marinko Matosevic,Milos Raonic,7-6(4); 6-3,R64,89,14,4,51,73,41,51,9,22,1,2,11,50,73,4,2,40,73,23,40,20,33,4,6,10,43,73
2012-10-07 00:00:00.000,ATP World Tour Masters 1000 Shanghai Shanghai; China ATP World Tour Masters 1000,HARD,2,Kei Nishikori,Di Wu,Kei Nishikori,6-2; 6-4,R64,72,1,1,32,49,26,32,10,17,2,3,9,36,49,0,2,35,58,19,35,9,23,5,9,9,28,58
2012-10-07 00:00:00.000,ATP World Tour Masters 1000 Shanghai Shanghai; China ATP World Tour Masters 1000,HARD,2,Sam Querrey,Zhe Li,Sam Querrey,6-3; 6-1,R64,59,11,2,23,43,21,23,9,20,0,1,8,30,43,0,1,29,49,15,29,8,20,5,10,8,23,49
2012-10-07 00:00:00.000,ATP World Tour Masters 1000 Shanghai Shanghai; China ATP World Tour Masters 1000,HARD,2,Andreas Seppi,Michael Berrer,Andreas Seppi,6-2; 7-6(5),R64,89,9,2,44,73,33,44,16,29,5,6,10,49,73,3,4,41,61,24,41,12,20,2,5,10,36,61
2012-10-07 00:00:00.000,ATP World Tour Masters 1000 Shanghai Shanghai; China ATP World Tour Masters 1000,HARD,2,Tomas Berdych,N/A Bye,Tomas Berdych,,R64,0,0,0,0,0,0,0,0,0,0,0,0,0,0,0,0,0,0,0,0,0,0,0,0,0,0,0
2012-10-07 00:00:00.000,ATP World Tour Masters 1000 Shanghai Shanghai; China ATP World Tour Masters 1000,HARD,2,Janko Tipsarevic,N/A Bye,Janko Tipsarevic,,R64,0,0,0,0,0,0,0,0,0,0,0,0,0,0,0,0,0,0,0,0,0,0,0,0,0,0,0
2012-10-07 00:00:00.000,ATP World Tour Masters 1000 Shanghai Shanghai; China ATP World Tour Masters 1000,HARD,2,Viktor Troicki,Mikhail Youzhny,Viktor Troicki,6-3; 2-6; 6-4,R64,117,15,2,53,91,36,53,18,38,8,11,13,54,91,1,0,51,82,33,51,17,31,4,8,14,50,82
2012-10-07 00:00:00.000,ATP World Tour Masters 1000 Shanghai Shanghai; China ATP World Tour Masters 1000,HARD,2,Tommy Robredo,Alex Bogomolov Jr.,Tommy Robredo,7-6(4); 6-4,R64,94,9,1,44,67,38,44,11,23,3,4,11,49,67,2,1,49,68,33,49,12,19,0,2,11,45,68
2012-10-07 00:00:00.000,ATP World Tour Masters 1000 Shanghai Shanghai; China ATP World Tour Masters 1000,HARD,2,Tommy Haas,Nicolas Almagro,Tommy Haas,4-6; 7-6(4); 6-2,R64,123,10,7,72,111,51,72,24,39,7,8,15,75,111,18,3,54,87,43,54,18,33,5,7,15,61,87
2012-10-07 00:00:00.000,ATP World Tour Masters 1000 Shanghai Shanghai; China ATP World Tour Masters 1000,HARD,2,Philipp Kohlschreiber,Ryan Harrison,Philipp Kohlschreiber,6-4; 6-4,R64,73,8,1,32,54,27,32,14,22,1,1,10,41,54,5,2,25,54,18,25,16,29,1,3,10,34,54
2012-10-07 00:00:00.000,ATP World Tour Masters 1000 Shanghai Shanghai; China ATP World Tour Masters 1000,HARD,2,Feliciano Lopez,Alejandro Falla,Feliciano Lopez,6-3; 1-6; 6-3,R64,110,8,3,58,93,39,58,17,35,3,5,13,56,93,3,0,38,70,25,38,22,32,4,6,12,47,70
2012-10-07 00:00:00.000,ATP World Tour Masters 1000 Shanghai Shanghai; China ATP World Tour Masters 1000,HARD,2,Grigor Dimitrov,Pablo Andujar,Grigor Dimitrov,7-5; 6-3,R64,92,7,2,37,66,27,37,22,29,2,2,11,49,66,1,4,38,62,23,38,15,24,0,2,10,38,62
2012-10-07 00:00:00.000,ATP World Tour Masters 1000 Shanghai Shanghai; China ATP World Tour Masters 1000,HARD,2,Novak Djokovic,N/A Bye,Novak Djokovic,,R64,0,0,0,0,0,0,0,0,0,0,0,0,0,0,0,0,0,0,0,0,0,0,0,0,0,0,0
2012-10-07 00:00:00.000,ATP World Tour Masters 1000 Shanghai Shanghai; China ATP World Tour Masters 1000,HARD,2,Roger Federer,Yen-Hsun Lu,Roger Federer,6-3; 7-5,R32,80,5,1,30,56,28,30,18,26,1,1,11,46,56,4,5,43,70,30,43,13,27,3,5,10,43,70
2012-10-07 00:00:00.000,ATP World Tour Masters 1000 Shanghai Shanghai; China ATP World Tour Masters 1000,HARD,2,Stan Wawrinka,Denis Istomin,Stan Wawrinka,6-4; 4-6; 6-4,R32,119,9,3,53,94,41,53,21,41,5,7,15,62,94,9,2,57,91,39,57,18,34,4,7,15,57,91
2012-10-07 00:00:00.000,ATP World Tour Masters 1000 Shanghai Shanghai; China ATP World Tour Masters 1000,HARD,2,Marin Cilic,Martin Klizan,Marin Cilic,7-5; 6-1,R32,94,3,4,36,69,27,36,16,33,3,4,10,43,69,3,4,35,65,21,35,12,30,12,16,9,33,65
2012-10-07 00:00:00.000,ATP World Tour Masters 1000 Shanghai Shanghai; China ATP World Tour Masters 1000,HARD,2,Fernando Verdasco,Juan Monaco,Fernando Verdasco,6-4; 6-2,R32,85,1,1,40,55,30,40,9,15,2,2,9,39,55,2,2,30,51,19,30,12,21,4,7,9,31,51
2012-10-07 00:00:00.000,ATP World Tour Masters 1000 Shanghai Shanghai; China ATP World Tour Masters 1000,HARD,2,Andy Murray,Florian Mayer,Andy Murray,W/O,R32,0,0,0,0,0,0,0,0,0,0,0,0,0,0,0,0,0,0,0,0,0,0,0,0,0,0,0
2012-10-07 00:00:00.000,ATP World Tour Masters 1000 Shanghai Shanghai; China ATP World Tour Masters 1000,HARD,2,Alexandr Dolgopolov,Gilles Simon,Alexandr Dolgopolov,6-3; 6-4,R32,76,5,3,35,68,26,35,22,33,4,4,10,48,68,5,4,37,62,25,37,11,25,4,6,9,36,62
2012-10-07 00:00:00.000,ATP World Tour Masters 1000 Shanghai Shanghai; China ATP World Tour Masters 1000,HARD,2,Radek Stepanek,Richard Gasquet,Radek Stepanek,6-4; 6-4,R32,88,8,3,33,59,28,33,13,26,2,3,10,41,59,3,1,45,58,29,45,7,13,3,6,10,36,58
2012-10-07 00:00:00.000,ATP World Tour Masters 1000 Shanghai Shanghai; China ATP World Tour Masters 1000,HARD,2,John Isner,Kevin Anderson,John Isner,7-6(3); 6-7(8); 7-6(7),R32,166,24,3,90,116,77,90,15,26,3,3,18,92,116,21,2,85,121,73,85,20,36,4,4,18,93,121
2012-10-07 00:00:00.000,ATP World Tour Masters 1000 Shanghai Shanghai; China ATP World Tour Masters 1000,HARD,2,Jo-Wilfried Tsonga,Benoit Paire,Jo-Wilfried Tsonga,7-6(7); 7-5,R32,116,10,1,42,84,31,42,19,42,2,6,12,50,84,5,2,44,92,27,44,22,48,5,10,12,49,92
2012-10-07 00:00:00.000,ATP World Tour Masters 1000 Shanghai Shanghai; China ATP World Tour Masters 1000,HARD,2,Marcos Baghdatis,Milos Raonic,Marcos Baghdatis,7-6(4); 6-7(5); 7-6(3),R32,160,12,6,55,105,48,55,31,50,0,2,18,79,105,15,2,75,129,56,75,33,54,9,11,18,89,129
2012-10-07 00:00:00.000,ATP World Tour Masters 1000 Shanghai Shanghai; China ATP World Tour Masters 1000,HARD,2,Sam Querrey,Kei Nishikori,Sam Querrey,2-6; 6-1; 6-4,R32,101,20,4,44,77,39,44,14,33,4,7,13,53,77,3,3,50,85,30,50,17,35,7,11,12,47,85
2012-10-07 00:00:00.000,ATP World Tour Masters 1000 Shanghai Shanghai; China ATP World Tour Masters 1000,HARD,2,Tomas Berdych,Andreas Seppi,Tomas Berdych,6-3; 6-3,R32,79,6,2,36,57,30,36,10,21,1,1,9,40,57,4,1,30,60,16,30,17,30,3,6,9,33,60
2012-10-07 00:00:00.000,ATP World Tour Masters 1000 Shanghai Shanghai; China ATP World Tour Masters 1000,HARD,2,Janko Tipsarevic,Viktor Troicki,Janko Tipsarevic,6-2; 7-6(3),R32,114,4,3,33,70,26,33,24,37,8,8,10,50,70,5,2,47,83,32,47,14,36,4,6,10,46,83
2012-10-07 00:00:00.000,ATP World Tour Masters 1000 Shanghai Shanghai; China ATP World Tour Masters 1000,HARD,2,Tommy Haas,Tommy Robredo,Tommy Haas,6-3; 6-3,R32,65,3,0,27,46,18,27,14,19,0,2,9,32,46,1,0,29,51,17,29,8,22,5,10,9,25,51
2012-10-07 00:00:00.000,ATP World Tour Masters 1000 Shanghai Shanghai; China ATP World Tour Masters 1000,HARD,2,Feliciano Lopez,Philipp Kohlschreiber,Feliciano Lopez,6-3; 6-4,R32,72,5,4,26,55,23,26,19,29,3,3,10,42,55,7,6,26,61,19,26,19,35,5,7,9,38,61
2012-10-07 00:00:00.000,ATP World Tour Masters 1000 Shanghai Shanghai; China ATP World Tour Masters 1000,HARD,2,Novak Djokovic,Grigor Dimitrov,Novak Djokovic,6-3; 6-2,R32,54,5,0,32,41,29,32,7,9,0,0,9,36,41,1,3,35,46,24,35,2,11,2,5,8,26,46
2012-10-07 00:00:00.000,ATP World Tour Masters 1000 Shanghai Shanghai; China ATP World Tour Masters 1000,HARD,2,Roger Federer,Stan Wawrinka,Roger Federer,4-6; 7-6(4); 6-0,R16,116,6,1,54,86,36,54,21,32,1,3,14,57,86,7,1,45,92,29,45,22,47,5,9,14,51,92
2012-10-07 00:00:00.000,ATP World Tour Masters 1000 Shanghai Shanghai; China ATP World Tour Masters 1000,HARD,2,Marin Cilic,Fernando Verdasco,Marin Cilic,4-6; 6-1; 6-4,R16,128,6,2,52,88,40,52,20,36,3,4,14,60,88,3,6,61,87,40,61,12,26,9,12,13,52,87
2012-10-07 00:00:00.000,ATP World Tour Masters 1000 Shanghai Shanghai; China ATP World Tour Masters 1000,HARD,2,Andy Murray,Alexandr Dolgopolov,Andy Murray,6-2; 6-2,R16,58,7,0,29,40,24,29,6,11,0,1,8,30,40,2,4,25,48,15,25,9,23,1,6,8,24,48
2012-10-07 00:00:00.000,ATP World Tour Masters 1000 Shanghai Shanghai; China ATP World Tour Masters 1000,HARD,2,Radek Stepanek,John Isner,Radek Stepanek,6-4; 6-7(5); 6-3,R16,147,4,2,61,94,47,61,24,33,1,1,16,71,94,17,2,71,103,50,71,19,32,6,8,15,69,103
2012-10-07 00:00:00.000,ATP World Tour Masters 1000 Shanghai Shanghai; China ATP World Tour Masters 1000,HARD,2,Jo-Wilfried Tsonga,Marcos Baghdatis,Jo-Wilfried Tsonga,6-2; 7-6(2),R16,81,11,3,33,59,28,33,10,26,1,4,10,38,59,2,6,29,57,18,29,11,28,1,6,10,29,57
2012-10-07 00:00:00.000,ATP World Tour Masters 1000 Shanghai Shanghai; China ATP World Tour Masters 1000,HARD,2,Tomas Berdych,Sam Querrey,Tomas Berdych,6-2; 6-7(3); 6-4,R16,134,12,2,50,95,39,50,25,45,2,3,15,64,95,17,8,64,97,49,64,13,33,6,10,15,62,97
2012-10-07 00:00:00.000,ATP World Tour Masters 1000 Shanghai Shanghai; China ATP World Tour Masters 1000,HARD,2,Tommy Haas,Janko Tipsarevic,Tommy Haas,6-2; 6-1,R16,66,8,3,27,45,25,27,9,18,1,1,8,34,45,7,4,38,62,25,38,5,24,8,12,7,30,62
2012-10-07 00:00:00.000,ATP World Tour Masters 1000 Shanghai Shanghai; China ATP World Tour Masters 1000,HARD,2,Novak Djokovic,Feliciano Lopez,Novak Djokovic,6-3; 6-3,R16,68,12,1,29,43,27,29,9,14,0,0,9,36,43,3,2,26,54,20,26,11,28,4,7,9,31,54
2012-10-07 00:00:00.000,ATP World Tour Masters 1000 Shanghai Shanghai; China ATP World Tour Masters 1000,HARD,2,Roger Federer,Marin Cilic,Roger Federer,6-3; 6-4,Q,82,8,2,42,62,27,42,11,20,4,6,9,38,62,1,1,35,66,19,35,13,31,2,7,10,32,66
2012-10-07 00:00:00.000,ATP World Tour Masters 1000 Shanghai Shanghai; China ATP World Tour Masters 1000,HARD,2,Andy Murray,Radek Stepanek,Andy Murray,4-6; 6-2; 6-3,Q,139,5,4,45,83,34,45,23,38,6,8,14,57,83,3,5,47,79,32,47,14,32,5,9,13,46,79
2012-10-07 00:00:00.000,ATP World Tour Masters 1000 Shanghai Shanghai; China ATP World Tour Masters 1000,HARD,2,Tomas Berdych,Jo-Wilfried Tsonga,Tomas Berdych,6-3; 7-6(4),Q,95,9,1,43,70,38,43,17,27,4,4,11,55,70,7,1,37,58,30,37,11,21,3,4,10,41,58
2012-10-07 00:00:00.000,ATP World Tour Masters 1000 Shanghai Shanghai; China ATP World Tour Masters 1000,HARD,2,Novak Djokovic,Tommy Haas,Novak Djokovic,6-3; 6-3,Q,82,4,2,37,56,29,37,7,19,0,2,9,36,56,2,1,35,58,19,35,8,23,4,9,9,27,58
2012-10-07 00:00:00.000,ATP World Tour Masters 1000 Shanghai Shanghai; China ATP World Tour Masters 1000,HARD,2,Andy Murray,Roger Federer,Andy Murray,6-4; 6-4,S,98,5,3,30,57,26,30,12,27,0,1,10,38,57,4,5,47,80,31,47,12,33,8,11,10,43,80
2012-10-07 00:00:00.000,ATP World Tour Masters 1000 Shanghai Shanghai; China ATP World Tour Masters 1000,HARD,2,Novak Djokovic,Tomas Berdych,Novak Djokovic,6-3; 6-4,S,86,5,3,42,56,35,42,6,14,2,3,10,41,56,4,1,34,61,24,34,10,27,0,3,9,34,61
2012-10-07 00:00:00.000,ATP World Tour Masters 1000 Shanghai Shanghai; China ATP World Tour Masters 1000,HARD,2,Novak Djokovic,Andy Murray,Novak Djokovic,5-7; 7-6(11); 6-3,F,201,3,4,62,104,43,62,20,42,1,6,16,63,104,4,3,71,128,46,71,26,57,7,13,17,72,128
2012-10-15 00:00:00.000,Moscow Russia ATP World Tour 250,HARD,2,Alexandr Dolgopolov,N/A Bye,Alexandr Dolgopolov,,R32,0,0,0,0,0,0,0,0,0,0,0,0,0,0,0,0,0,0,0,0,0,0,0,0,0,0,0
2012-10-15 00:00:00.000,Moscow Russia ATP World Tour 250,HARD,2,Edouard Roger-Vasselin,Evgeny Donskoy,Edouard Roger-Vasselin,6-4; 4-6; 6-3,R32,134,5,6,59,96,41,59,22,37,5,6,14,63,96,8,2,50,84,36,50,20,34,3,6,15,56,84
2012-10-15 00:00:00.000,Moscow Russia ATP World Tour 250,HARD,2,Ivo Karlovic,Simone Bolelli,Ivo Karlovic,6-4; 7-6(4),R32,101,20,4,45,67,37,45,11,22,2,4,11,48,67,2,3,37,65,30,37,11,28,1,4,11,41,65
2012-10-15 00:00:00.000,Moscow Russia ATP World Tour 250,HARD,2,Alex Bogomolov Jr.,Nikolay Davydenko,Alex Bogomolov Jr.,7-5; 6-4,R32,95,0,2,46,61,27,46,5,15,3,7,11,32,61,1,2,62,74,33,62,5,12,7,13,11,38,74
2012-10-15 00:00:00.000,Moscow Russia ATP World Tour 250,HARD,2,Thomaz Bellucci,N/A Bye,Thomaz Bellucci,,R32,0,0,0,0,0,0,0,0,0,0,0,0,0,0,0,0,0,0,0,0,0,0,0,0,0,0,0
2012-10-15 00:00:00.000,Moscow Russia ATP World Tour 250,HARD,2,Flavio Cipolla,Teymuraz Gabashvili,Flavio Cipolla,6-4; 6-4,R32,85,0,2,45,57,32,45,7,12,2,3,10,39,57,5,4,47,67,33,47,5,20,4,7,10,38,67
2012-10-15 00:00:00.000,Moscow Russia ATP World Tour 250,HARD,2,Jerzy Janowicz,Benjamin Becker,Jerzy Janowicz,7-6(6); 6-3,R32,94,6,4,35,66,27,35,18,31,3,5,10,45,66,3,5,45,78,29,45,14,33,3,7,11,43,78
2012-10-15 00:00:00.000,Moscow Russia ATP World Tour 250,HARD,2,Carlos Berlocq,Andrey Kuznetsov,Carlos Berlocq,1-6; 6-4; 6-3,R32,133,2,4,61,93,38,61,14,32,8,11,13,52,93,5,2,47,86,36,47,17,39,5,8,13,53,86
2012-10-15 00:00:00.000,Moscow Russia ATP World Tour 250,HARD,2,Denis Istomin,Bjorn Phau,Denis Istomin,5-7; 7-5; 6-1,R32,132,12,3,68,99,47,68,15,31,5,9,16,62,99,3,5,63,102,42,63,16,39,4,10,15,58,102
2012-10-15 00:00:00.000,Moscow Russia ATP World Tour 250,HARD,2,Lukas Rosol,Daniel Gimeno-Traver,Lukas Rosol,7-6(9); 7-6(2),R32,106,11,3,55,91,44,55,18,36,3,3,12,62,91,10,2,48,88,36,48,23,40,4,4,12,59,88
2012-10-15 00:00:00.000,Moscow Russia ATP World Tour 250,HARD,2,Malek Jaziri,Rajeev Ram,Malek Jaziri,6-3; 6-1,R32,59,4,0,23,37,21,23,11,14,0,0,8,32,37,2,1,22,45,14,22,9,23,4,8,8,23,45
2012-10-15 00:00:00.000,Moscow Russia ATP World Tour 250,HARD,2,Viktor Troicki,N/A Bye,Viktor Troicki,,R32,0,0,0,0,0,0,0,0,0,0,0,0,0,0,0,0,0,0,0,0,0,0,0,0,0,0,0
2012-10-15 00:00:00.000,Moscow Russia ATP World Tour 250,HARD,2,Tatsuma Ito,Roberto Bautista Agut,Tatsuma Ito,6-3; 1-6; 6-2,R32,104,7,6,38,80,26,38,18,42,7,12,12,44,80,1,6,46,68,28,46,8,22,3,9,12,36,68
2012-10-15 00:00:00.000,Moscow Russia ATP World Tour 250,HARD,2,Konstantin Kravchuk,Evgeny Korolev,Konstantin Kravchuk,6-4; 6-3,R32,71,16,5,33,58,28,33,14,25,3,4,10,42,58,2,2,29,54,20,29,13,25,4,7,9,33,54
2012-10-15 00:00:00.000,Moscow Russia ATP World Tour 250,HARD,2,Igor Sijsling,Michael Berrer,Igor Sijsling,7-6(7); 6-3,R32,91,6,1,47,68,36,47,13,21,0,0,11,49,68,4,1,46,66,29,46,14,20,1,2,10,43,66
2012-10-15 00:00:00.000,Moscow Russia ATP World Tour 250,HARD,2,Andreas Seppi,N/A Bye,Andreas Seppi,,R32,0,0,0,0,0,0,0,0,0,0,0,0,0,0,0,0,0,0,0,0,0,0,0,0,0,0,0
2012-10-15 00:00:00.000,Moscow Russia ATP World Tour 250,HARD,2,Edouard Roger-Vasselin,Alexandr Dolgopolov,Edouard Roger-Vasselin,6-3; 5-7; 7-6(6),R16,143,8,0,78,106,56,78,16,28,6,8,17,72,106,11,1,56,107,38,56,34,51,5,7,16,72,107
2012-10-15 00:00:00.000,Moscow Russia ATP World Tour 250,HARD,2,Ivo Karlovic,Alex Bogomolov Jr.,Ivo Karlovic,7-6(11); 6-4,R16,100,16,4,37,67,33,37,16,30,3,4,11,49,67,1,1,59,70,41,59,7,11,3,5,11,48,70
2012-10-15 00:00:00.000,Moscow Russia ATP World Tour 250,HARD,2,Thomaz Bellucci,Flavio Cipolla,Thomaz Bellucci,6-4; 6-1,R16,90,2,2,31,53,21,31,13,22,4,5,8,34,53,0,6,42,73,23,42,12,31,9,14,9,35,73
2012-10-15 00:00:00.000,Moscow Russia ATP World Tour 250,HARD,2,Jerzy Janowicz,Carlos Berlocq,Jerzy Janowicz,6-3; 6-4,R16,70,8,0,37,49,32,37,10,12,1,1,10,42,49,3,0,27,48,17,27,16,21,1,3,9,33,48
2012-10-15 00:00:00.000,Moscow Russia ATP World Tour 250,HARD,2,Lukas Rosol,Denis Istomin,Lukas Rosol,4-6; 6-4; 6-3,R16,118,7,3,49,83,39,49,20,34,3,4,15,59,83,10,0,67,98,45,67,17,31,4,6,14,62,98
2012-10-15 00:00:00.000,Moscow Russia ATP World Tour 250,HARD,2,Malek Jaziri,Viktor Troicki,Malek Jaziri,6-1; 3-6; 6-2,R16,100,1,3,47,75,36,47,14,28,4,5,12,50,75,6,2,44,70,28,44,12,26,3,7,12,40,70
2012-10-15 00:00:00.000,Moscow Russia ATP World Tour 250,HARD,2,Tatsuma Ito,Konstantin Kravchuk,Tatsuma Ito,7-6(7); 2-6; 6-3,R16,123,3,3,48,86,37,48,24,38,1,3,15,61,86,18,6,65,94,52,65,12,29,3,4,14,64,94
2012-10-15 00:00:00.000,Moscow Russia ATP World Tour 250,HARD,2,Andreas Seppi,Igor Sijsling,Andreas Seppi,7-5; 6-2,R16,68,9,0,31,50,25,31,13,19,0,1,10,38,50,9,2,40,68,27,40,10,28,1,5,10,37,68
2012-10-15 00:00:00.000,Moscow Russia ATP World Tour 250,HARD,2,Ivo Karlovic,Edouard Roger-Vasselin,Ivo Karlovic,7-6(4); 6-3,Q,83,23,1,43,62,36,43,12,19,0,1,11,48,62,5,1,37,59,28,37,11,22,0,2,10,39,59
2012-10-15 00:00:00.000,Moscow Russia ATP World Tour 250,HARD,2,Thomaz Bellucci,Jerzy Janowicz,Thomaz Bellucci,6-4; 7-6(3),Q,106,6,1,59,79,38,59,14,20,2,3,11,52,79,7,1,43,66,32,43,12,23,2,4,11,44,66
2012-10-15 00:00:00.000,Moscow Russia ATP World Tour 250,HARD,2,Malek Jaziri,Lukas Rosol,Malek Jaziri,7-6(5); 6-3,Q,104,5,1,50,74,41,50,12,24,7,7,11,53,74,1,2,38,72,24,38,24,34,7,8,10,48,72
2012-10-15 00:00:00.000,Moscow Russia ATP World Tour 250,HARD,2,Andreas Seppi,Tatsuma Ito,Andreas Seppi,6-2; 6-1,Q,59,5,1,29,47,25,29,9,18,3,3,8,34,47,0,7,25,44,14,25,9,19,1,5,7,23,44
2012-10-15 00:00:00.000,Moscow Russia ATP World Tour 250,HARD,2,Thomaz Bellucci,Ivo Karlovic,Thomaz Bellucci,6-7(5); 6-4; 6-4,S,141,13,1,68,94,51,68,20,26,3,3,16,71,94,19,4,73,113,53,73,22,40,7,9,16,75,113
2012-10-15 00:00:00.000,Moscow Russia ATP World Tour 250,HARD,2,Andreas Seppi,Malek Jaziri,Andreas Seppi,6-3; 6-1,S,80,2,0,33,53,23,33,11,20,2,3,8,34,53,1,5,34,66,20,34,10,32,7,12,8,30,66
2012-10-15 00:00:00.000,Moscow Russia ATP World Tour 250,HARD,2,Andreas Seppi,Thomaz Bellucci,Andreas Seppi,3-6; 7-6(3); 6-3,F,146,2,1,54,78,37,54,17,24,0,3,14,54,78,13,3,72,110,46,72,19,38,10,14,16,65,110
2012-10-15 00:00:00.000,Stockholm Sweden ATP World Tour 250,HARD,2,Jo-Wilfried Tsonga,N/A Bye,Jo-Wilfried Tsonga,,R32,0,0,0,0,0,0,0,0,0,0,0,0,0,0,0,0,0,0,0,0,0,0,0,0,0,0,0
2012-10-15 00:00:00.000,Stockholm Sweden ATP World Tour 250,HARD,2,Go Soeda,Maxime Teixeira,Go Soeda,6-3; 3-6; 6-3,R32,115,3,0,48,78,34,48,18,30,1,3,14,52,78,12,9,49,82,36,49,15,33,6,9,13,51,82
2012-10-15 00:00:00.000,Stockholm Sweden ATP World Tour 250,HARD,2,Sergiy Stakhovsky,Yannick Mertens,Sergiy Stakhovsky,6-3; 6-4,R32,66,7,4,42,70,32,42,16,28,5,5,10,48,70,1,2,39,57,26,39,11,18,5,7,9,37,57
2012-10-15 00:00:00.000,Stockholm Sweden ATP World Tour 250,HARD,2,Feliciano Lopez,Paul-Henri Mathieu,Feliciano Lopez,7-6(5); 6-7(4); 6-2,R32,164,26,5,75,127,57,75,24,52,5,7,16,81,127,11,5,65,106,46,65,22,41,5,9,16,68,106
2012-10-15 00:00:00.000,Stockholm Sweden ATP World Tour 250,HARD,2,Florian Mayer,N/A Bye,Florian Mayer,,R32,0,0,0,0,0,0,0,0,0,0,0,0,0,0,0,0,0,0,0,0,0,0,0,0,0,0,0
2012-10-15 00:00:00.000,Stockholm Sweden ATP World Tour 250,HARD,2,Ricardas Berankis,Albert Ramos-Vinolas,Ricardas Berankis,4-6; 6-4; 6-1,R32,101,9,5,34,76,29,34,22,42,4,6,13,51,76,8,3,52,91,34,52,17,39,8,13,14,51,91
2012-10-15 00:00:00.000,Stockholm Sweden ATP World Tour 250,HARD,2,Alejandro Falla,Jan Hajek,Alejandro Falla,6-3; 3-6; 7-6(7),R32,152,3,4,62,112,42,62,27,50,5,9,15,69,112,4,5,52,104,38,52,24,52,7,11,15,62,104
2012-10-15 00:00:00.000,Stockholm Sweden ATP World Tour 250,HARD,2,Marcos Baghdatis,David Goffin,Marcos Baghdatis,6-4; 6-2,R32,73,9,2,32,53,25,32,12,21,2,3,9,37,53,1,3,25,49,18,25,10,24,0,4,9,28,49
2012-10-15 00:00:00.000,Stockholm Sweden ATP World Tour 250,HARD,2,Jarkko Nieminen,Tobias Kamke,Jarkko Nieminen,6-3; 6-4,R32,87,5,0,49,70,37,49,8,21,7,8,10,45,70,4,2,39,69,27,39,13,30,6,9,9,40,69
2012-10-15 00:00:00.000,Stockholm Sweden ATP World Tour 250,HARD,2,Lleyton Hewitt,Kevin Anderson,Lleyton Hewitt,6-4; 4-6; 6-4,R32,148,9,4,62,100,44,62,22,38,10,12,15,66,100,11,2,65,93,45,65,12,28,3,6,15,57,93
2012-10-15 00:00:00.000,Stockholm Sweden ATP World Tour 250,HARD,2,Marius Copil,Federico Delbonis,Marius Copil,6-1; 7-5,R32,75,8,1,34,56,29,34,13,22,2,2,10,42,56,2,4,23,56,18,23,13,33,2,5,9,31,56
2012-10-15 00:00:00.000,Stockholm Sweden ATP World Tour 250,HARD,2,Nicolas Almagro,N/A Bye,Nicolas Almagro,,R32,0,0,0,0,0,0,0,0,0,0,0,0,0,0,0,0,0,0,0,0,0,0,0,0,0,0,0
2012-10-15 00:00:00.000,Stockholm Sweden ATP World Tour 250,HARD,2,Mikhail Youzhny,Brian Baker,Mikhail Youzhny,6-3; 6-1,R32,78,4,1,26,48,19,26,12,22,0,1,8,31,48,1,4,33,54,17,33,8,21,5,10,8,25,54
2012-10-15 00:00:00.000,Stockholm Sweden ATP World Tour 250,HARD,2,Patrik Rosenholm,Gael Monfils,Patrik Rosenholm,6-3; 1-6; 6-3,R32,78,3,2,48,63,33,48,11,15,0,3,13,44,63,10,7,43,78,33,43,14,35,4,7,12,47,78
2012-10-15 00:00:00.000,Stockholm Sweden ATP World Tour 250,HARD,2,Jurgen Zopp,Pablo Andujar,Jurgen Zopp,6-4; 6-4,R32,89,5,3,37,53,28,37,9,16,0,1,10,37,53,4,2,48,77,31,48,13,29,11,14,10,44,77
2012-10-15 00:00:00.000,Stockholm Sweden ATP World Tour 250,HARD,2,Tomas Berdych,N/A Bye,Tomas Berdych,,R32,0,0,0,0,0,0,0,0,0,0,0,0,0,0,0,0,0,0,0,0,0,0,0,0,0,0,0
2012-10-15 00:00:00.000,Stockholm Sweden ATP World Tour 250,HARD,2,Jo-Wilfried Tsonga,Go Soeda,Jo-Wilfried Tsonga,6-2; 7-6(6),R16,98,8,0,46,78,34,46,17,32,5,6,10,51,78,2,1,36,64,26,36,12,28,2,5,10,38,64
2012-10-15 00:00:00.000,Stockholm Sweden ATP World Tour 250,HARD,2,Sergiy Stakhovsky,Feliciano Lopez,Sergiy Stakhovsky,7-6(5); 7-5,R16,97,16,4,56,84,44,56,16,28,3,3,12,60,84,12,1,49,74,42,49,10,25,1,2,12,52,74
2012-10-15 00:00:00.000,Stockholm Sweden ATP World Tour 250,HARD,2,Ricardas Berankis,Florian Mayer,Ricardas Berankis,4-6; 6-4; 6-2,R16,103,10,1,51,82,40,51,18,31,2,3,14,58,82,5,0,61,98,33,61,25,37,3,6,14,58,98
2012-10-15 00:00:00.000,Stockholm Sweden ATP World Tour 250,HARD,2,Marcos Baghdatis,Alejandro Falla,Marcos Baghdatis,6-0; 3-0 RET,R16,44,3,0,15,31,12,15,8,16,4,4,4,20,31,0,1,14,30,6,14,2,16,3,8,5,8,30
2012-10-15 00:00:00.000,Stockholm Sweden ATP World Tour 250,HARD,2,Lleyton Hewitt,Jarkko Nieminen,Lleyton Hewitt,7-6(2); 2-6; 6-4,R16,139,9,1,49,91,36,49,14,42,1,7,15,50,91,5,3,65,97,37,65,16,32,3,8,15,53,97
2012-10-15 00:00:00.000,Stockholm Sweden ATP World Tour 250,HARD,2,Nicolas Almagro,Marius Copil,Nicolas Almagro,6-4; 7-6(4),R16,82,5,0,34,66,25,34,25,32,1,1,11,50,66,15,2,49,79,39,49,13,30,2,3,11,52,79
2012-10-15 00:00:00.000,Stockholm Sweden ATP World Tour 250,HARD,2,Mikhail Youzhny,Patrik Rosenholm,Mikhail Youzhny,6-0; 6-2,R16,64,4,0,24,44,18,24,12,20,0,0,7,30,44,2,3,26,45,15,26,5,19,2,7,7,20,45
2012-10-15 00:00:00.000,Stockholm Sweden ATP World Tour 250,HARD,2,Tomas Berdych,Jurgen Zopp,Tomas Berdych,6-1; 6-4,R16,72,11,0,32,50,25,32,13,18,1,1,9,38,50,5,2,35,54,20,35,10,19,1,4,8,30,54
2012-10-15 00:00:00.000,Stockholm Sweden ATP World Tour 250,HARD,2,Jo-Wilfried Tsonga,Sergiy Stakhovsky,Jo-Wilfried Tsonga,6-3; 6-4,Q,84,7,2,32,59,26,32,15,27,4,5,10,41,59,3,3,41,76,26,41,17,35,10,13,9,43,76
2012-10-15 00:00:00.000,Stockholm Sweden ATP World Tour 250,HARD,2,Marcos Baghdatis,Ricardas Berankis,Marcos Baghdatis,6-3; 7-6(4),Q,89,7,0,36,68,32,36,20,32,4,4,11,52,68,1,3,26,65,19,26,26,39,4,5,10,45,65
2012-10-15 00:00:00.000,Stockholm Sweden ATP World Tour 250,HARD,2,Nicolas Almagro,Lleyton Hewitt,Nicolas Almagro,6-1; 6-4,Q,67,11,1,30,62,23,30,18,32,3,4,9,41,62,4,2,21,42,13,21,8,21,2,6,8,21,42
2012-10-15 00:00:00.000,Stockholm Sweden ATP World Tour 250,HARD,2,Tomas Berdych,Mikhail Youzhny,Tomas Berdych,6-3; 7-6(2),Q,126,8,0,53,89,39,53,17,36,9,10,10,56,89,5,3,40,70,29,40,13,30,4,7,11,42,70
2012-10-15 00:00:00.000,Stockholm Sweden ATP World Tour 250,HARD,2,Jo-Wilfried Tsonga,Marcos Baghdatis,Jo-Wilfried Tsonga,6-4; 4-6; 5-2 RET,S,110,11,3,57,88,45,57,16,31,5,6,14,61,88,5,2,40,69,31,40,16,29,1,3,13,47,69
2012-10-15 00:00:00.000,Stockholm Sweden ATP World Tour 250,HARD,2,Tomas Berdych,Nicolas Almagro,Tomas Berdych,6-3; 6-2,S,69,9,1,32,54,27,32,11,22,0,0,9,38,54,6,2,24,40,17,24,6,16,4,7,8,23,40
2012-10-15 00:00:00.000,Stockholm Sweden ATP World Tour 250,HARD,2,Tomas Berdych,Jo-Wilfried Tsonga,Tomas Berdych,4-6; 6-4; 6-4,F,149,11,1,64,104,47,64,21,40,7,9,15,68,104,10,2,54,90,43,54,18,36,7,10,15,61,90
2012-10-15 00:00:00.000,Vienna Austria ATP World Tour 250,HARD,2,Juan Martin Del Potro,N/A Bye,Juan Martin Del Potro,,R32,0,0,0,0,0,0,0,0,0,0,0,0,0,0,0,0,0,0,0,0,0,0,0,0,0,0,0
2012-10-15 00:00:00.000,Vienna Austria ATP World Tour 250,HARD,2,Daniel Brands,Ruben Bemelmans,Daniel Brands,6-7(5); 6-4; 6-3,R32,110,23,1,60,85,54,60,15,25,0,0,16,69,85,11,1,61,92,47,61,18,31,3,5,15,65,92
2012-10-15 00:00:00.000,Vienna Austria ATP World Tour 250,HARD,2,Dominic Thiem,Lukas Lacko,Dominic Thiem,7-6(3); 6-3,R32,93,3,2,55,84,40,55,15,29,9,10,11,55,84,7,1,37,57,28,37,9,20,2,4,10,37,57
2012-10-15 00:00:00.000,Vienna Austria ATP World Tour 250,HARD,2,Marinko Matosevic,Robin Haase,Marinko Matosevic,1-6; 6-3; 6-2,R32,98,5,0,52,77,33,52,12,25,2,5,12,45,77,5,3,44,74,31,44,14,30,4,8,12,45,74
2012-10-15 00:00:00.000,Vienna Austria ATP World Tour 250,HARD,2,Jurgen Melzer,N/A Bye,Jurgen Melzer,,R32,0,0,0,0,0,0,0,0,0,0,0,0,0,0,0,0,0,0,0,0,0,0,0,0,0,0,0
2012-10-15 00:00:00.000,Vienna Austria ATP World Tour 250,HARD,2,Gilles Muller,Steve Darcis,Gilles Muller,6-7(3); 6-4; 6-3,R32,148,16,4,63,90,51,63,11,27,3,4,15,62,90,7,0,74,117,48,74,22,43,5,9,16,70,117
2012-10-15 00:00:00.000,Vienna Austria ATP World Tour 250,HARD,2,Vasek Pospisil,Andreas Haider-Maurer,Vasek Pospisil,3-6; 7-6(3); 6-1,R32,127,11,1,56,83,46,56,15,27,3,4,13,61,83,9,5,70,106,51,70,12,36,4,7,15,63,106
2012-10-15 00:00:00.000,Vienna Austria ATP World Tour 250,HARD,2,Paolo Lorenzi,Benoit Paire,Paolo Lorenzi,6-4; 6-4,R32,85,1,1,41,65,29,41,16,24,2,2,10,45,65,11,1,47,73,30,47,14,26,4,6,10,44,73
2012-10-15 00:00:00.000,Vienna Austria ATP World Tour 250,HARD,2,Grega Zemlja,Xavier Malisse,Grega Zemlja,4-6; 6-1; 7-6(6),R32,148,7,4,66,116,44,66,24,50,7,11,15,68,116,9,2,59,96,39,59,15,37,1,6,14,54,96
2012-10-15 00:00:00.000,Vienna Austria ATP World Tour 250,HARD,2,Matthew Ebden,Filippo Volandri,Matthew Ebden,7-5; 0-6; 6-0,R32,108,9,3,61,88,38,61,12,27,2,6,12,50,88,0,2,59,80,37,59,8,21,6,11,12,45,80
2012-10-15 00:00:00.000,Vienna Austria ATP World Tour 250,HARD,2,Jesse Levine,Lukasz Kubot,Jesse Levine,6-3; 6-4,R32,77,3,1,35,54,23,35,9,19,3,6,9,32,54,4,3,28,53,17,28,8,25,2,8,10,25,53
2012-10-15 00:00:00.000,Vienna Austria ATP World Tour 250,HARD,2,Tommy Haas,N/A Bye,Tommy Haas,,R32,0,0,0,0,0,0,0,0,0,0,0,0,0,0,0,0,0,0,0,0,0,0,0,0,0,0,0
2012-10-15 00:00:00.000,Vienna Austria ATP World Tour 250,HARD,2,Donald Young,Fabio Fognini,Donald Young,7-6(8); 6-3,R32,107,2,4,56,90,33,56,17,34,13,16,10,50,90,1,6,48,82,27,48,16,34,10,15,11,43,82
2012-10-15 00:00:00.000,Vienna Austria ATP World Tour 250,HARD,2,Aljaz Bedene,Guillermo Garcia-Lopez,Aljaz Bedene,6-4; 1-0 RET,R32,52,3,1,15,34,13,15,8,19,3,4,5,21,34,3,3,13,35,12,13,7,22,4,7,6,19,35
2012-10-15 00:00:00.000,Vienna Austria ATP World Tour 250,HARD,2,Ernests Gulbis,Somdev Devvarman,Ernests Gulbis,7-6(6); 6-3,R32,104,9,5,40,67,30,40,13,27,0,2,11,43,67,1,1,43,82,26,43,19,39,7,10,10,45,82
2012-10-15 00:00:00.000,Vienna Austria ATP World Tour 250,HARD,2,Janko Tipsarevic,N/A Bye,Janko Tipsarevic,,R32,0,0,0,0,0,0,0,0,0,0,0,0,0,0,0,0,0,0,0,0,0,0,0,0,0,0,0
2012-10-15 00:00:00.000,Vienna Austria ATP World Tour 250,HARD,2,Juan Martin Del Potro,Daniel Brands,Juan Martin Del Potro,6-7(5); 7-6(4); 7-6(6),R16,186,30,3,78,125,64,78,28,47,5,5,18,92,125,32,6,77,131,66,77,28,54,10,10,18,94,131
2012-10-15 00:00:00.000,Vienna Austria ATP World Tour 250,HARD,2,Marinko Matosevic,Dominic Thiem,Marinko Matosevic,6-3; 7-6(5),R16,96,7,0,40,66,32,40,19,26,1,1,11,51,66,8,0,50,73,39,50,10,23,3,4,10,49,73
2012-10-15 00:00:00.000,Vienna Austria ATP World Tour 250,HARD,2,Gilles Muller,Jurgen Melzer,Gilles Muller,6-3; 3-6; 7-6(4),R16,112,18,1,57,82,41,57,16,25,1,3,15,57,82,8,0,56,84,40,56,16,28,0,2,15,56,84
2012-10-15 00:00:00.000,Vienna Austria ATP World Tour 250,HARD,2,Paolo Lorenzi,Vasek Pospisil,Paolo Lorenzi,6-4; 6-4,R16,88,2,1,30,52,24,30,17,22,1,1,10,41,52,5,4,36,68,29,36,15,32,3,5,10,44,68
2012-10-15 00:00:00.000,Vienna Austria ATP World Tour 250,HARD,2,Grega Zemlja,Matthew Ebden,Grega Zemlja,7-5; 6-4,R16,104,8,1,41,69,31,41,13,28,5,7,11,44,69,8,3,54,79,37,54,6,25,5,9,11,43,79
2012-10-15 00:00:00.000,Vienna Austria ATP World Tour 250,HARD,2,Tommy Haas,Jesse Levine,Tommy Haas,6-4; 6-2,R16,80,7,1,37,56,31,37,9,19,2,2,9,40,56,4,3,38,61,26,38,9,23,7,10,9,35,61
2012-10-15 00:00:00.000,Vienna Austria ATP World Tour 250,HARD,2,Aljaz Bedene,Donald Young,Aljaz Bedene,7-6(4); 6-7(2); 6-3,R16,168,11,4,66,99,50,66,18,33,6,8,16,68,99,3,3,97,133,64,97,16,36,14,18,17,80,133
2012-10-15 00:00:00.000,Vienna Austria ATP World Tour 250,HARD,2,Janko Tipsarevic,Ernests Gulbis,Janko Tipsarevic,6-3; 6-4,R16,78,0,3,37,60,27,37,12,23,2,4,10,39,60,4,4,32,52,19,32,8,20,2,6,9,27,52
2012-10-15 00:00:00.000,Vienna Austria ATP World Tour 250,HARD,2,Juan Martin Del Potro,Marinko Matosevic,Juan Martin Del Potro,6-2; 6-2,Q,73,6,1,32,47,29,32,6,15,3,3,8,35,47,2,2,32,59,16,32,14,27,8,12,8,30,59
2012-10-15 00:00:00.000,Vienna Austria ATP World Tour 250,HARD,2,Gilles Muller,Paolo Lorenzi,Gilles Muller,6-3; 6-4,Q,76,10,0,28,52,25,28,16,24,0,0,10,41,52,3,1,26,47,19,26,13,21,0,2,9,32,47
2012-10-15 00:00:00.000,Vienna Austria ATP World Tour 250,HARD,2,Grega Zemlja,Tommy Haas,Grega Zemlja,6-4; 4-6; 6-2,Q,112,9,3,44,75,33,44,17,31,7,11,14,50,75,4,5,49,79,37,49,5,30,2,8,14,42,79
2012-10-15 00:00:00.000,Vienna Austria ATP World Tour 250,HARD,2,Janko Tipsarevic,Aljaz Bedene,Janko Tipsarevic,6-2; 4-2 RET,Q,63,6,2,23,40,19,23,11,17,0,0,7,30,40,3,4,25,46,18,25,7,21,2,5,7,25,46
2012-10-15 00:00:00.000,Vienna Austria ATP World Tour 250,HARD,2,Juan Martin Del Potro,Gilles Muller,Juan Martin Del Potro,7-6(4); 7-6(5),S,111,17,1,54,75,48,54,11,21,1,1,12,59,75,16,0,64,81,53,64,6,17,2,2,12,59,81
2012-10-15 00:00:00.000,Vienna Austria ATP World Tour 250,HARD,2,Grega Zemlja,Janko Tipsarevic,Grega Zemlja,3-6; 7-6(5); 6-2,S,154,10,1,57,95,43,57,19,38,8,10,14,62,95,11,5,63,101,47,63,17,38,10,13,15,64,101
2012-10-15 00:00:00.000,Vienna Austria ATP World Tour 250,HARD,2,Juan Martin Del Potro,Grega Zemlja,Juan Martin Del Potro,7-5; 6-3,F,102,10,2,49,79,40,49,12,30,4,5,11,52,79,7,1,30,51,21,30,10,21,2,5,10,31,51
2012-10-21 00:00:00.000,Valencia Spain ATP World Tour 500,HARD,2,David Ferrer,Olivier Rochus,David Ferrer,7-5; 7-5,R32,134,7,4,38,79,28,38,19,41,1,4,12,47,79,1,4,47,88,30,47,18,41,13,18,12,48,88
2012-10-21 00:00:00.000,Valencia Spain ATP World Tour 500,HARD,2,Albert Ramos-Vinolas,Rajeev Ram,Albert Ramos-Vinolas,6-3; 6-3,R32,101,2,3,28,57,22,28,18,29,7,7,9,40,57,4,4,48,82,34,48,10,34,10,13,9,44,82
2012-10-21 00:00:00.000,Valencia Spain ATP World Tour 500,HARD,2,Sam Querrey,Feliciano Lopez,Sam Querrey,6-3; 7-6(4),R32,80,13,4,42,73,34,42,19,31,1,1,11,53,73,11,3,40,63,32,40,12,23,1,2,10,44,63
2012-10-21 00:00:00.000,Valencia Spain ATP World Tour 500,HARD,2,Nicolas Almagro,Juan Carlos Ferrero,Nicolas Almagro,7-5; 6-3,R32,101,12,3,40,86,31,40,19,46,8,11,11,50,86,8,0,44,62,27,44,6,18,3,8,10,33,62
2012-10-21 00:00:00.000,Valencia Spain ATP World Tour 500,HARD,2,Lleyton Hewitt,Juan Monaco,Lleyton Hewitt,6-3; 6-4,R32,102,5,2,42,72,29,42,13,30,2,5,10,42,72,2,2,42,58,20,42,8,16,7,12,9,28,58
2012-10-21 00:00:00.000,Valencia Spain ATP World Tour 500,HARD,2,Ivan Dodig,Philipp Kohlschreiber,Ivan Dodig,6-2; 7-6(6),R32,111,11,3,45,74,36,45,16,29,6,6,10,52,74,5,3,41,74,29,41,15,33,8,10,10,44,74
2012-10-21 00:00:00.000,Valencia Spain ATP World Tour 500,HARD,2,Fernando Verdasco,Tommy Robredo,Fernando Verdasco,6-3; 6-4,R32,90,0,2,35,52,24,35,9,17,1,3,9,33,52,1,4,40,74,24,40,14,34,7,12,10,38,74
2012-10-21 00:00:00.000,Valencia Spain ATP World Tour 500,HARD,2,Marin Cilic,Martin Klizan,Marin Cilic,1-6; 6-0; 6-3,R32,107,5,3,44,67,30,44,11,23,2,5,11,41,67,3,9,43,78,29,43,13,35,9,14,11,42,78
2012-10-21 00:00:00.000,Valencia Spain ATP World Tour 500,HARD,2,Gilles Muller,Milos Raonic,Gilles Muller,7-5; 7-6(1),R32,98,8,3,46,74,40,46,12,28,4,5,12,52,74,16,3,40,71,30,40,17,31,1,3,12,47,71
2012-10-21 00:00:00.000,Valencia Spain ATP World Tour 500,HARD,2,Alexandr Dolgopolov,Filippo Volandri,Alexandr Dolgopolov,6-3; 7-6(5),R32,74,9,0,39,60,33,39,17,21,0,0,11,50,60,2,2,49,80,32,49,17,31,4,5,10,49,80
2012-10-21 00:00:00.000,Valencia Spain ATP World Tour 500,HARD,2,Marcel Granollers,Jan Hajek,Marcel Granollers,7-5; 6-4,R32,111,8,1,40,68,28,40,13,28,3,6,11,41,68,1,2,35,67,21,35,13,32,7,12,11,34,67
2012-10-21 00:00:00.000,Valencia Spain ATP World Tour 500,HARD,2,Gilles Simon,Janko Tipsarevic,Gilles Simon,5-4 RET,R32,45,3,0,15,24,10,15,5,9,1,2,4,15,24,1,2,22,39,14,22,6,17,2,4,5,20,39
2012-10-21 00:00:00.000,Valencia Spain ATP World Tour 500,HARD,2,John Isner,Fabio Fognini,John Isner,6-3; 6-7(4); 7-5,R32,136,11,3,70,95,59,70,13,25,2,3,17,72,95,12,6,67,121,47,67,28,54,10,13,16,75,121
2012-10-21 00:00:00.000,Valencia Spain ATP World Tour 500,HARD,2,David Goffin,Pablo Andujar,David Goffin,6-2; 6-2,R32,72,3,7,24,46,13,24,10,22,4,8,8,23,46,1,6,20,49,8,20,7,29,3,11,8,15,49
2012-10-21 00:00:00.000,Valencia Spain ATP World Tour 500,HARD,2,Jurgen Melzer,Carlos Berlocq,Jurgen Melzer,6-3; 6-3,R32,110,4,2,42,75,25,42,19,33,12,14,9,44,75,3,2,33,65,18,33,14,32,8,13,9,32,65
2012-10-21 00:00:00.000,Valencia Spain ATP World Tour 500,HARD,2,Xavier Malisse,Jo-Wilfried Tsonga,Xavier Malisse,3-1 RET,R32,24,3,0,4,10,3,4,5,6,0,0,2,8,10,0,1,7,14,4,7,3,7,2,3,2,7,14
2012-10-21 00:00:00.000,Valencia Spain ATP World Tour 500,HARD,2,David Ferrer,Albert Ramos-Vinolas,David Ferrer,6-4; 6-2,R16,84,1,3,30,50,24,30,11,20,5,6,9,35,50,1,5,40,67,25,40,11,27,5,9,9,36,67
2012-10-21 00:00:00.000,Valencia Spain ATP World Tour 500,HARD,2,Nicolas Almagro,Sam Querrey,Nicolas Almagro,6-4; 6-7(4); 6-0,R16,111,3,1,44,84,35,44,24,40,1,2,14,59,84,9,5,48,84,36,48,14,36,5,10,14,50,84
2012-10-21 00:00:00.000,Valencia Spain ATP World Tour 500,HARD,2,Ivan Dodig,Lleyton Hewitt,Ivan Dodig,6-1; 3-6; 6-2,R16,124,10,3,45,80,35,45,16,35,3,5,12,51,80,2,1,38,78,26,38,14,40,3,8,12,40,78
2012-10-21 00:00:00.000,Valencia Spain ATP World Tour 500,HARD,2,Marin Cilic,Fernando Verdasco,Marin Cilic,6-1; 6-4,R16,77,3,1,26,50,22,26,16,24,1,2,9,38,50,3,2,30,49,16,30,9,19,3,7,8,25,49
2012-10-21 00:00:00.000,Valencia Spain ATP World Tour 500,HARD,2,Alexandr Dolgopolov,Gilles Muller,Alexandr Dolgopolov,6-4; 6-4,R16,80,6,1,28,47,27,28,13,19,0,0,10,40,47,7,2,53,82,37,53,13,29,8,10,10,50,82
2012-10-21 00:00:00.000,Valencia Spain ATP World Tour 500,HARD,2,Marcel Granollers,Gilles Simon,Marcel Granollers,6-7(4); 6-3; 6-2,R16,155,3,2,59,105,47,59,23,46,6,7,15,70,105,2,3,47,84,30,47,23,37,3,7,14,53,84
2012-10-21 00:00:00.000,Valencia Spain ATP World Tour 500,HARD,2,David Goffin,John Isner,David Goffin,7-6(2); 4-6; 6-4,R16,132,9,3,60,89,46,60,17,29,0,2,16,63,89,21,2,79,107,58,79,15,28,6,8,16,73,107
2012-10-21 00:00:00.000,Valencia Spain ATP World Tour 500,HARD,2,Jurgen Melzer,Xavier Malisse,Jurgen Melzer,7-5; 6-2,R16,72,4,4,25,55,21,25,19,30,1,2,10,40,55,4,9,27,58,17,27,13,31,2,6,10,30,58
2012-10-21 00:00:00.000,Valencia Spain ATP World Tour 500,HARD,2,David Ferrer,Nicolas Almagro,David Ferrer,6-3; 7-5,Q,82,5,1,45,63,35,45,12,18,4,4,11,47,63,3,1,30,55,22,30,14,25,0,2,10,36,55
2012-10-21 00:00:00.000,Valencia Spain ATP World Tour 500,HARD,2,Ivan Dodig,Marin Cilic,Ivan Dodig,6-2; 7-6(6),Q,124,5,4,46,76,35,46,12,30,6,9,10,47,76,10,3,35,75,25,35,16,40,6,11,10,41,75
2012-10-21 00:00:00.000,Valencia Spain ATP World Tour 500,HARD,2,Alexandr Dolgopolov,Marcel Granollers,Alexandr Dolgopolov,6-0; 6-2,Q,65,5,1,23,41,21,23,10,18,1,1,7,31,41,1,1,22,46,9,22,10,24,2,7,7,19,46
2012-10-21 00:00:00.000,Valencia Spain ATP World Tour 500,HARD,2,Jurgen Melzer,David Goffin,Jurgen Melzer,7-6(7); 6-4,Q,99,3,7,41,72,30,41,16,31,2,5,11,46,72,1,4,43,72,28,43,13,29,1,5,11,41,72
2012-10-21 00:00:00.000,Valencia Spain ATP World Tour 500,HARD,2,David Ferrer,Ivan Dodig,David Ferrer,6-4; 6-7(5); 6-1,S,162,3,0,48,85,39,48,25,37,1,2,15,64,85,6,5,67,116,48,67,18,49,5,9,14,66,116
2012-10-21 00:00:00.000,Valencia Spain ATP World Tour 500,HARD,2,Alexandr Dolgopolov,Jurgen Melzer,Alexandr Dolgopolov,6-4; 6-2,S,75,9,0,27,49,23,27,12,22,0,1,9,35,49,4,2,31,56,18,31,12,25,0,4,9,30,56
2012-10-21 00:00:00.000,Valencia Spain ATP World Tour 500,HARD,2,David Ferrer,Alexandr Dolgopolov,David Ferrer,6-1; 3-6; 6-4,F,108,4,1,55,78,39,55,17,23,4,5,13,56,78,6,4,39,74,33,39,15,35,3,6,13,48,74
2012-10-22 00:00:00.000,Basel Switzerland ATP World Tour 500,HARD,2,Roger Federer,Benjamin Becker,Roger Federer,7-5; 6-3,R32,89,10,2,34,61,28,34,15,27,1,2,11,43,61,3,5,46,78,29,46,15,32,9,12,10,44,78
2012-10-22 00:00:00.000,Basel Switzerland ATP World Tour 500,HARD,2,Thomaz Bellucci,Go Soeda,Thomaz Bellucci,4-6; 6-4; 6-3,R32,129,13,2,61,94,40,61,19,33,8,11,15,59,94,1,5,43,89,27,43,23,46,2,6,14,50,89
2012-10-22 00:00:00.000,Basel Switzerland ATP World Tour 500,HARD,2,Lukasz Kubot,Lukas Lacko,Lukasz Kubot,6-4; 6-4,R32,84,4,1,31,50,24,31,11,19,1,3,10,35,50,3,1,39,60,20,39,12,21,1,5,10,32,60
2012-10-22 00:00:00.000,Basel Switzerland ATP World Tour 500,HARD,2,Benoit Paire,Andreas Seppi,Benoit Paire,4-6; 6-2; 6-3,R32,92,8,5,42,82,32,42,20,40,4,7,14,52,82,5,2,41,72,32,41,10,31,1,6,13,42,72
2012-10-22 00:00:00.000,Basel Switzerland ATP World Tour 500,HARD,2,Nikolay Davydenko,Stan Wawrinka,Nikolay Davydenko,7-6(7); 7-6(3),R32,133,0,4,62,95,44,62,17,33,9,11,12,61,95,7,2,47,95,33,47,25,48,5,7,12,58,95
2012-10-22 00:00:00.000,Basel Switzerland ATP World Tour 500,HARD,2,Paul-Henri Mathieu,Henri Laaksonen,Paul-Henri Mathieu,6-2; 7-5,R32,99,4,3,29,56,25,29,15,27,1,2,10,40,56,9,6,48,90,32,48,16,42,7,11,10,48,90
2012-10-22 00:00:00.000,Basel Switzerland ATP World Tour 500,HARD,2,Julien Benneteau,Andrey Kuznetsov,Julien Benneteau,4-6; 6-3; 6-3,R32,104,12,5,42,77,33,42,21,35,5,7,14,54,77,3,2,43,76,30,43,16,33,4,8,14,46,76
2012-10-22 00:00:00.000,Basel Switzerland ATP World Tour 500,HARD,2,Grigor Dimitrov,Viktor Troicki,Grigor Dimitrov,6-3; 6-2,R32,73,7,2,33,51,29,33,9,18,1,1,9,38,51,5,3,32,61,24,32,9,29,3,6,8,33,61
2012-10-22 00:00:00.000,Basel Switzerland ATP World Tour 500,HARD,2,Mikhail Youzhny,Bernard Tomic,Mikhail Youzhny,6-0; 6-2,R32,57,7,0,25,33,21,25,8,8,1,1,7,29,33,1,1,26,52,17,26,5,26,2,7,7,22,52
2012-10-22 00:00:00.000,Basel Switzerland ATP World Tour 500,HARD,2,Matthew Ebden,Victor Hanescu,Matthew Ebden,6-3; 7-6(3),R32,88,5,0,37,62,29,37,20,25,0,0,11,49,62,4,0,58,73,40,58,9,15,5,6,10,49,73
2012-10-22 00:00:00.000,Basel Switzerland ATP World Tour 500,HARD,2,Marco Chiudinelli,Guillermo Garcia-Lopez,Marco Chiudinelli,5-7; 6-3; 6-4,R32,161,6,3,53,96,40,53,21,43,5,8,16,61,96,10,9,48,107,33,48,31,59,9,13,15,64,107
2012-10-22 00:00:00.000,Basel Switzerland ATP World Tour 500,HARD,2,Richard Gasquet,Robin Haase,Richard Gasquet,4-6; 6-3; 6-2,R32,104,10,3,56,81,44,56,14,25,3,4,14,58,81,13,0,46,79,37,46,13,33,2,5,13,50,79
2012-10-22 00:00:00.000,Basel Switzerland ATP World Tour 500,HARD,2,Marinko Matosevic,Florian Mayer,Marinko Matosevic,6-2; 6-3,R32,62,2,3,35,49,28,35,5,14,1,2,9,33,49,0,3,35,60,22,35,8,25,3,7,8,30,60
2012-10-22 00:00:00.000,Basel Switzerland ATP World Tour 500,HARD,2,Kevin Anderson,Jarkko Nieminen,Kevin Anderson,7-6(4); 6-3,R32,85,9,2,37,57,27,37,11,20,1,4,10,38,57,2,5,45,79,27,45,14,34,6,11,11,41,79
2012-10-22 00:00:00.000,Basel Switzerland ATP World Tour 500,HARD,2,Brian Baker,Radek Stepanek,Brian Baker,2-6; 7-6(5); 6-3,R32,157,3,3,50,83,36,50,14,33,3,8,14,50,83,11,3,76,111,51,76,12,35,11,16,15,63,111
2012-10-22 00:00:00.000,Basel Switzerland ATP World Tour 500,HARD,2,Juan Martin Del Potro,Alejandro Falla,Juan Martin Del Potro,6-4; 6-1,R32,86,3,2,33,53,27,33,8,20,3,4,8,35,53,3,0,31,58,19,31,8,27,5,10,9,27,58
2012-10-22 00:00:00.000,Basel Switzerland ATP World Tour 500,HARD,2,Roger Federer,Thomaz Bellucci,Roger Federer,6-3; 6-7(6); 7-5,R16,124,8,0,59,96,48,59,26,37,2,2,17,74,96,6,1,58,90,48,58,17,32,1,3,16,65,90
2012-10-22 00:00:00.000,Basel Switzerland ATP World Tour 500,HARD,2,Benoit Paire,Lukasz Kubot,Benoit Paire,6-4; 6-4,R16,86,6,2,28,56,25,28,15,28,1,2,10,40,56,3,3,41,68,29,41,12,27,4,7,10,41,68
2012-10-22 00:00:00.000,Basel Switzerland ATP World Tour 500,HARD,2,Paul-Henri Mathieu,Nikolay Davydenko,Paul-Henri Mathieu,6-3; 6-7(2); 6-4,R16,137,8,4,48,97,41,48,29,49,5,6,16,70,97,7,7,56,96,40,56,22,40,3,6,15,62,96
2012-10-22 00:00:00.000,Basel Switzerland ATP World Tour 500,HARD,2,Grigor Dimitrov,Julien Benneteau,Grigor Dimitrov,7-6(5); 6-7(1); 7-6(3),R16,173,17,5,75,119,58,75,24,44,4,6,18,82,119,5,7,79,123,60,79,18,44,2,4,18,78,123
2012-10-22 00:00:00.000,Basel Switzerland ATP World Tour 500,HARD,2,Mikhail Youzhny,Matthew Ebden,Mikhail Youzhny,6-3; 6-1,R16,59,6,0,31,41,26,31,8,10,2,2,8,34,41,4,4,28,49,17,28,9,21,3,7,8,26,49
2012-10-22 00:00:00.000,Basel Switzerland ATP World Tour 500,HARD,2,Richard Gasquet,Marco Chiudinelli,Richard Gasquet,6-1; 6-4,R16,66,8,2,29,42,28,29,8,13,0,0,9,36,42,0,2,21,44,13,21,13,23,2,5,8,26,44
2012-10-22 00:00:00.000,Basel Switzerland ATP World Tour 500,HARD,2,Kevin Anderson,Marinko Matosevic,Kevin Anderson,6-3; 6-7(5); 6-3,R16,140,17,2,58,92,49,58,19,34,3,4,16,68,92,5,0,67,101,44,67,18,34,6,9,14,62,101
2012-10-22 00:00:00.000,Basel Switzerland ATP World Tour 500,HARD,2,Juan Martin Del Potro,Brian Baker,Juan Martin Del Potro,7-5; 6-1,R16,79,10,1,35,47,27,35,9,12,0,0,9,36,47,4,3,33,57,22,33,11,24,3,7,10,33,57
2012-10-22 00:00:00.000,Basel Switzerland ATP World Tour 500,HARD,2,Roger Federer,Benoit Paire,Roger Federer,6-2; 6-2,Q,55,4,1,25,39,24,25,8,14,0,0,8,32,39,7,5,34,60,24,34,6,26,8,12,8,30,60
2012-10-22 00:00:00.000,Basel Switzerland ATP World Tour 500,HARD,2,Paul-Henri Mathieu,Grigor Dimitrov,Paul-Henri Mathieu,7-6(2); 7-6(4),Q,121,2,5,44,77,37,44,15,33,3,5,12,52,77,15,6,53,93,38,53,18,40,3,5,12,56,93
2012-10-22 00:00:00.000,Basel Switzerland ATP World Tour 500,HARD,2,Richard Gasquet,Mikhail Youzhny,Richard Gasquet,6-2; 7-6(5),Q,105,6,4,44,65,31,44,14,21,0,1,10,45,65,7,2,40,75,31,40,14,35,7,10,10,45,75
2012-10-22 00:00:00.000,Basel Switzerland ATP World Tour 500,HARD,2,Juan Martin Del Potro,Kevin Anderson,Juan Martin Del Potro,3-6; 7-6(3); 6-2,Q,143,2,2,70,82,50,70,7,12,0,1,14,57,82,20,6,68,107,51,68,15,39,5,7,15,66,107
2012-10-22 00:00:00.000,Basel Switzerland ATP World Tour 500,HARD,2,Roger Federer,Paul-Henri Mathieu,Roger Federer,7-5; 6-4,S,86,10,0,35,60,28,35,17,25,0,0,11,45,60,4,4,32,69,25,32,20,37,2,4,11,45,69
2012-10-22 00:00:00.000,Basel Switzerland ATP World Tour 500,HARD,2,Juan Martin Del Potro,Richard Gasquet,Juan Martin Del Potro,6-2; 6-2,S,68,8,2,30,43,22,30,7,13,1,2,8,29,43,3,0,23,47,10,23,11,24,3,8,8,21,47
2012-10-22 00:00:00.000,Basel Switzerland ATP World Tour 500,HARD,2,Juan Martin Del Potro,Roger Federer,Juan Martin Del Potro,6-4; 6-7(5); 7-6(3),F,164,10,4,62,111,54,62,30,49,5,5,17,84,111,18,1,75,111,57,75,23,36,1,2,17,80,111
2012-10-29 00:00:00.000,ATP World Tour Masters 1000 Paris France ATP World Tour Masters 1000,HARD,2,Victor Hanescu,N/A Bye,Victor Hanescu,,R64,0,0,0,0,0,0,0,0,0,0,0,0,0,0,0,0,0,0,0,0,0,0,0,0,0,0,0
2012-10-29 00:00:00.000,ATP World Tour Masters 1000 Paris France ATP World Tour Masters 1000,HARD,2,Gilles Simon,Marcos Baghdatis,Gilles Simon,7-5; 6-1,R64,77,5,2,31,57,25,31,15,26,3,4,10,40,57,4,2,31,57,15,31,13,26,7,11,9,28,57
2012-10-29 00:00:00.000,ATP World Tour Masters 1000 Paris France ATP World Tour Masters 1000,HARD,2,Benoit Paire,Pablo Andujar,Benoit Paire,6-3; 6-4,R64,86,5,3,31,61,24,31,13,30,3,6,10,37,61,1,4,44,73,23,44,14,29,11,16,9,37,73
2012-10-29 00:00:00.000,ATP World Tour Masters 1000 Paris France ATP World Tour Masters 1000,HARD,2,Kei Nishikori,N/A Bye,Kei Nishikori,,R64,0,0,0,0,0,0,0,0,0,0,0,0,0,0,0,0,0,0,0,0,0,0,0,0,0,0,0
2012-10-29 00:00:00.000,ATP World Tour Masters 1000 Paris France ATP World Tour Masters 1000,HARD,2,Richard Gasquet,N/A Bye,Richard Gasquet,,R64,0,0,0,0,0,0,0,0,0,0,0,0,0,0,0,0,0,0,0,0,0,0,0,0,0,0,0
2012-10-29 00:00:00.000,ATP World Tour Masters 1000 Paris France ATP World Tour Masters 1000,HARD,2,Kevin Anderson,Thomaz Bellucci,Kevin Anderson,6-2; 6-1,R64,64,9,0,31,46,25,31,8,15,1,1,8,33,46,2,1,30,46,16,30,5,16,3,7,7,21,46
2012-10-29 00:00:00.000,ATP World Tour Masters 1000 Paris France ATP World Tour Masters 1000,HARD,2,Andreas Seppi,Martin Klizan,Andreas Seppi,6-2; 2-6; 7-6(5),R64,110,12,3,62,93,46,62,11,31,3,7,14,57,93,5,5,47,81,35,47,17,34,3,7,14,52,81
2012-10-29 00:00:00.000,ATP World Tour Masters 1000 Paris France ATP World Tour Masters 1000,HARD,2,Tomas Berdych,N/A Bye,Tomas Berdych,,R64,0,0,0,0,0,0,0,0,0,0,0,0,0,0,0,0,0,0,0,0,0,0,0,0,0,0,0
2012-10-29 00:00:00.000,ATP World Tour Masters 1000 Paris France ATP World Tour Masters 1000,HARD,2,Andy Murray,N/A Bye,Andy Murray,,R64,0,0,0,0,0,0,0,0,0,0,0,0,0,0,0,0,0,0,0,0,0,0,0,0,0,0,0
2012-10-29 00:00:00.000,ATP World Tour Masters 1000 Paris France ATP World Tour Masters 1000,HARD,2,Paul-Henri Mathieu,Roberto Bautista Agut,Paul-Henri Mathieu,6-4; 7-5,R64,138,6,7,55,96,40,55,17,41,15,18,11,57,96,5,3,53,87,34,53,11,34,6,11,11,45,87
2012-10-29 00:00:00.000,ATP World Tour Masters 1000 Paris France ATP World Tour Masters 1000,HARD,2,Jerzy Janowicz,Philipp Kohlschreiber,Jerzy Janowicz,7-6(5); 6-4,R64,83,9,2,33,61,30,33,18,28,0,0,11,48,61,5,0,35,63,26,35,20,28,1,2,11,46,63
2012-10-29 00:00:00.000,ATP World Tour Masters 1000 Paris France ATP World Tour Masters 1000,HARD,2,Marin Cilic,N/A Bye,Marin Cilic,,R64,0,0,0,0,0,0,0,0,0,0,0,0,0,0,0,0,0,0,0,0,0,0,0,0,0,0,0
2012-10-29 00:00:00.000,ATP World Tour Masters 1000 Paris France ATP World Tour Masters 1000,HARD,2,Juan Monaco,N/A Bye,Juan Monaco,,R64,0,0,0,0,0,0,0,0,0,0,0,0,0,0,0,0,0,0,0,0,0,0,0,0,0,0,0
2012-10-29 00:00:00.000,ATP World Tour Masters 1000 Paris France ATP World Tour Masters 1000,HARD,2,Grigor Dimitrov,Jurgen Melzer,Grigor Dimitrov,7-6(2); 6-2,R64,87,16,0,35,63,28,35,18,28,1,2,10,46,63,3,3,33,58,24,33,13,25,2,5,10,37,58
2012-10-29 00:00:00.000,ATP World Tour Masters 1000 Paris France ATP World Tour Masters 1000,HARD,2,Igor Sijsling,Alexandr Dolgopolov,Igor Sijsling,6-4; 6-2,R64,60,9,1,23,51,21,23,19,28,4,4,9,40,51,4,1,24,48,17,24,11,24,4,7,9,28,48
2012-10-29 00:00:00.000,ATP World Tour Masters 1000 Paris France ATP World Tour Masters 1000,HARD,2,Janko Tipsarevic,N/A Bye,Janko Tipsarevic,,R64,0,0,0,0,0,0,0,0,0,0,0,0,0,0,0,0,0,0,0,0,0,0,0,0,0,0,0
2012-10-29 00:00:00.000,ATP World Tour Masters 1000 Paris France ATP World Tour Masters 1000,HARD,2,Jo-Wilfried Tsonga,N/A Bye,Jo-Wilfried Tsonga,,R64,0,0,0,0,0,0,0,0,0,0,0,0,0,0,0,0,0,0,0,0,0,0,0,0,0,0,0
2012-10-29 00:00:00.000,ATP World Tour Masters 1000 Paris France ATP World Tour Masters 1000,HARD,2,Julien Benneteau,Viktor Troicki,Julien Benneteau,6-4; 7-5,R64,84,2,3,45,68,31,45,13,23,3,5,11,44,68,14,1,44,65,30,44,8,21,3,7,11,38,65
2012-10-29 00:00:00.000,ATP World Tour Masters 1000 Paris France ATP World Tour Masters 1000,HARD,2,Albert Ramos-Vinolas,Feliciano Lopez,Albert Ramos-Vinolas,7-6(5); 6-4,R64,110,3,1,52,83,37,52,20,31,9,10,11,57,83,10,5,32,69,25,32,21,37,2,4,11,46,69
2012-10-29 00:00:00.000,ATP World Tour Masters 1000 Paris France ATP World Tour Masters 1000,HARD,2,Nicolas Almagro,N/A Bye,Nicolas Almagro,,R64,0,0,0,0,0,0,0,0,0,0,0,0,0,0,0,0,0,0,0,0,0,0,0,0,0,0,0
2012-10-29 00:00:00.000,ATP World Tour Masters 1000 Paris France ATP World Tour Masters 1000,HARD,2,Stan Wawrinka,N/A Bye,Stan Wawrinka,,R64,0,0,0,0,0,0,0,0,0,0,0,0,0,0,0,0,0,0,0,0,0,0,0,0,0,0,0
2012-10-29 00:00:00.000,ATP World Tour Masters 1000 Paris France ATP World Tour Masters 1000,HARD,2,Carlos Berlocq,Denis Istomin,Carlos Berlocq,7-6(2); 6-2,R64,123,6,3,58,94,42,58,17,36,7,8,10,59,94,5,2,44,76,29,44,14,32,3,6,10,43,76
2012-10-29 00:00:00.000,ATP World Tour Masters 1000 Paris France ATP World Tour Masters 1000,HARD,2,Marcel Granollers,Mikhail Youzhny,Marcel Granollers,6-4; 6-3,R64,89,3,5,30,55,24,30,12,25,2,4,9,36,55,3,4,37,68,25,37,10,31,3,8,10,35,68
2012-10-29 00:00:00.000,ATP World Tour Masters 1000 Paris France ATP World Tour Masters 1000,HARD,2,David Ferrer,N/A Bye,David Ferrer,,R64,0,0,0,0,0,0,0,0,0,0,0,0,0,0,0,0,0,0,0,0,0,0,0,0,0,0,0
2012-10-29 00:00:00.000,ATP World Tour Masters 1000 Paris France ATP World Tour Masters 1000,HARD,2,Juan Martin Del Potro,N/A Bye,Juan Martin Del Potro,,R64,0,0,0,0,0,0,0,0,0,0,0,0,0,0,0,0,0,0,0,0,0,0,0,0,0,0,0
2012-10-29 00:00:00.000,ATP World Tour Masters 1000 Paris France ATP World Tour Masters 1000,HARD,2,Alejandro Falla,Florian Mayer,Alejandro Falla,7-6(3); 6-2,R64,77,4,1,26,55,24,26,17,29,1,2,10,41,55,4,2,39,60,26,39,10,21,2,5,10,36,60
2012-10-29 00:00:00.000,ATP World Tour Masters 1000 Paris France ATP World Tour Masters 1000,HARD,2,Michael Llodra,Daniel Gimeno-Traver,Michael Llodra,7-5; 6-3,R64,69,8,4,37,59,32,37,13,22,0,0,11,45,59,2,0,27,51,20,27,15,24,0,2,10,35,51
2012-10-29 00:00:00.000,ATP World Tour Masters 1000 Paris France ATP World Tour Masters 1000,HARD,2,John Isner,N/A Bye,John Isner,,R64,0,0,0,0,0,0,0,0,0,0,0,0,0,0,0,0,0,0,0,0,0,0,0,0,0,0,0
2012-10-29 00:00:00.000,ATP World Tour Masters 1000 Paris France ATP World Tour Masters 1000,HARD,2,Milos Raonic,N/A Bye,Milos Raonic,,R64,0,0,0,0,0,0,0,0,0,0,0,0,0,0,0,0,0,0,0,0,0,0,0,0,0,0,0
2012-10-29 00:00:00.000,ATP World Tour Masters 1000 Paris France ATP World Tour Masters 1000,HARD,2,Jeremy Chardy,Guillermo Garcia-Lopez,Jeremy Chardy,6-0; 6-3,R64,72,7,1,27,46,22,27,12,19,2,2,8,34,46,3,5,31,54,15,31,11,23,4,8,7,26,54
2012-10-29 00:00:00.000,ATP World Tour Masters 1000 Paris France ATP World Tour Masters 1000,HARD,2,Sam Querrey,Fernando Verdasco,Sam Querrey,6-1; 1-1 RET,R64,30,6,0,15,24,13,15,7,9,0,0,5,20,24,0,4,13,30,6,13,6,17,3,5,4,12,30
2012-10-29 00:00:00.000,ATP World Tour Masters 1000 Paris France ATP World Tour Masters 1000,HARD,2,Novak Djokovic,N/A Bye,Novak Djokovic,,R64,0,0,0,0,0,0,0,0,0,0,0,0,0,0,0,0,0,0,0,0,0,0,0,0,0,0,0
2012-10-29 00:00:00.000,ATP World Tour Masters 1000 Paris France ATP World Tour Masters 1000,HARD,2,Gilles Simon,Victor Hanescu,Gilles Simon,7-5; 6-3,R32,87,8,1,30,58,23,30,17,28,0,1,11,40,58,3,2,36,59,21,36,13,23,1,4,10,34,59
2012-10-29 00:00:00.000,ATP World Tour Masters 1000 Paris France ATP World Tour Masters 1000,HARD,2,Kei Nishikori,Benoit Paire,Kei Nishikori,7-6(2); 6-2,R32,95,4,3,42,64,32,42,11,22,3,5,10,43,64,6,4,31,79,19,31,21,48,6,10,10,40,79
2012-10-29 00:00:00.000,ATP World Tour Masters 1000 Paris France ATP World Tour Masters 1000,HARD,2,Kevin Anderson,Richard Gasquet,Kevin Anderson,7-6(5); 4-6; 6-1,R32,137,13,0,49,88,44,49,22,39,6,7,15,66,88,4,1,47,87,34,47,24,40,3,5,14,58,87
2012-10-29 00:00:00.000,ATP World Tour Masters 1000 Paris France ATP World Tour Masters 1000,HARD,2,Tomas Berdych,Andreas Seppi,Tomas Berdych,7-6(6); 6-2,R32,101,5,3,47,75,35,47,15,28,2,3,10,50,75,4,2,41,67,30,41,10,26,6,9,10,40,67
2012-10-29 00:00:00.000,ATP World Tour Masters 1000 Paris France ATP World Tour Masters 1000,HARD,2,Andy Murray,Paul-Henri Mathieu,Andy Murray,7-5; 6-3,R32,93,12,0,32,60,27,32,13,28,4,5,10,40,60,2,3,23,60,16,23,19,37,1,5,11,35,60
2012-10-29 00:00:00.000,ATP World Tour Masters 1000 Paris France ATP World Tour Masters 1000,HARD,2,Jerzy Janowicz,Marin Cilic,Jerzy Janowicz,7-6(6); 6-2,R32,87,9,1,38,55,33,38,12,17,0,0,10,45,55,6,3,34,65,26,34,16,31,3,5,10,42,65
2012-10-29 00:00:00.000,ATP World Tour Masters 1000 Paris France ATP World Tour Masters 1000,HARD,2,Juan Monaco,Grigor Dimitrov,Juan Monaco,7-6(4); 6-2,R32,97,0,1,40,64,33,40,16,24,1,1,10,49,64,5,1,33,64,23,33,20,31,1,3,10,43,64
2012-10-29 00:00:00.000,ATP World Tour Masters 1000 Paris France ATP World Tour Masters 1000,HARD,2,Janko Tipsarevic,Igor Sijsling,Janko Tipsarevic,6-4; 7-6(0),R32,108,8,5,37,66,30,37,17,29,3,5,11,47,66,10,2,40,88,29,40,20,48,4,7,11,49,88
2012-10-29 00:00:00.000,ATP World Tour Masters 1000 Paris France ATP World Tour Masters 1000,HARD,2,Jo-Wilfried Tsonga,Julien Benneteau,Jo-Wilfried Tsonga,6-2; 4-6; 7-6(2),R32,145,15,4,62,102,45,62,21,40,8,11,15,66,102,5,4,65,92,43,65,13,27,3,7,15,56,92
2012-10-29 00:00:00.000,ATP World Tour Masters 1000 Paris France ATP World Tour Masters 1000,HARD,2,Nicolas Almagro,Albert Ramos-Vinolas,Nicolas Almagro,7-6(1); 6-7(4); 6-3,R32,163,13,1,71,123,58,71,27,52,9,11,17,85,123,4,4,71,121,48,71,27,50,10,13,16,75,121
2012-10-29 00:00:00.000,ATP World Tour Masters 1000 Paris France ATP World Tour Masters 1000,HARD,2,Stan Wawrinka,Carlos Berlocq,Stan Wawrinka,6-3; 6-2,R32,67,6,2,27,50,20,27,16,23,3,3,8,36,50,1,5,27,51,21,27,7,24,1,5,9,28,51
2012-10-29 00:00:00.000,ATP World Tour Masters 1000 Paris France ATP World Tour Masters 1000,HARD,2,David Ferrer,Marcel Granollers,David Ferrer,6-1; 6-3,R32,77,1,2,33,57,25,33,12,24,2,3,8,37,57,0,1,19,43,11,19,8,24,1,6,8,19,43
2012-10-29 00:00:00.000,ATP World Tour Masters 1000 Paris France ATP World Tour Masters 1000,HARD,2,Juan Martin Del Potro,Alejandro Falla,Juan Martin Del Potro,6-2; 6-2,R32,77,6,1,30,51,23,30,10,21,5,7,8,33,51,3,1,28,63,16,28,10,35,6,12,8,26,63
2012-10-29 00:00:00.000,ATP World Tour Masters 1000 Paris France ATP World Tour Masters 1000,HARD,2,Michael Llodra,John Isner,Michael Llodra,6-4; 7-6(5),R32,79,7,0,43,62,36,43,12,19,0,0,11,48,62,15,1,49,77,37,49,14,28,4,5,11,51,77
2012-10-29 00:00:00.000,ATP World Tour Masters 1000 Paris France ATP World Tour Masters 1000,HARD,2,Milos Raonic,Jeremy Chardy,Milos Raonic,6-7(4); 7-6(4); 6-3,R32,129,26,8,65,99,58,65,20,34,3,3,17,78,99,9,5,66,95,55,66,15,29,1,2,16,70,95
2012-10-29 00:00:00.000,ATP World Tour Masters 1000 Paris France ATP World Tour Masters 1000,HARD,2,Sam Querrey,Novak Djokovic,Sam Querrey,0-6; 7-6(5); 6-4,R32,121,18,5,55,95,40,55,16,40,6,10,14,56,95,8,3,57,93,45,57,15,36,2,4,14,60,93
2012-10-29 00:00:00.000,ATP World Tour Masters 1000 Paris France ATP World Tour Masters 1000,HARD,2,Gilles Simon,Kei Nishikori,Gilles Simon,W/O,R16,0,0,0,0,0,0,0,0,0,0,0,0,0,0,0,0,0,0,0,0,0,0,0,0,0,0,0
2012-10-29 00:00:00.000,ATP World Tour Masters 1000 Paris France ATP World Tour Masters 1000,HARD,2,Tomas Berdych,Kevin Anderson,Tomas Berdych,1-6; 6-3; 6-4,R16,132,6,3,49,83,31,49,23,34,2,4,13,54,83,15,2,50,80,38,50,14,30,5,7,13,52,80
2012-10-29 00:00:00.000,ATP World Tour Masters 1000 Paris France ATP World Tour Masters 1000,HARD,2,Jerzy Janowicz,Andy Murray,Jerzy Janowicz,5-7; 7-6(4); 6-2,R16,145,22,3,65,105,54,65,17,40,5,7,16,71,105,9,3,62,100,46,62,18,38,3,6,16,64,100
2012-10-29 00:00:00.000,ATP World Tour Masters 1000 Paris France ATP World Tour Masters 1000,HARD,2,Janko Tipsarevic,Juan Monaco,Janko Tipsarevic,6-3; 3-6; 6-3,R16,134,6,3,45,76,37,45,18,31,0,1,14,55,76,3,2,53,90,37,53,18,37,1,3,13,55,90
2012-10-29 00:00:00.000,ATP World Tour Masters 1000 Paris France ATP World Tour Masters 1000,HARD,2,Jo-Wilfried Tsonga,Nicolas Almagro,Jo-Wilfried Tsonga,7-6(4); 7-6(3),R16,105,10,2,54,81,43,54,19,27,3,3,12,62,81,6,2,56,79,42,56,15,23,0,0,12,57,79
2012-10-29 00:00:00.000,ATP World Tour Masters 1000 Paris France ATP World Tour Masters 1000,HARD,2,David Ferrer,Stan Wawrinka,David Ferrer,6-2; 4-6; 6-2,R16,123,1,0,49,82,38,49,17,33,3,5,13,55,82,4,3,52,87,32,52,15,35,9,14,13,47,87
2012-10-29 00:00:00.000,ATP World Tour Masters 1000 Paris France ATP World Tour Masters 1000,HARD,2,Michael Llodra,Juan Martin Del Potro,Michael Llodra,6-4; 6-3,R16,69,8,1,30,50,27,30,13,20,0,0,10,40,50,6,1,37,51,25,37,7,14,2,4,9,32,51
2012-10-29 00:00:00.000,ATP World Tour Masters 1000 Paris France ATP World Tour Masters 1000,HARD,2,Sam Querrey,Milos Raonic,Sam Querrey,6-3; 7-6(1),R16,71,12,2,36,61,30,36,19,25,0,0,11,49,61,10,5,39,63,30,39,12,24,3,4,10,42,63
2012-10-29 00:00:00.000,ATP World Tour Masters 1000 Paris France ATP World Tour Masters 1000,HARD,2,Gilles Simon,Tomas Berdych,Gilles Simon,6-4; 6-4,Q,112,2,3,57,79,38,57,13,22,9,10,10,51,79,5,1,33,64,25,33,11,31,4,7,10,36,64
2012-10-29 00:00:00.000,ATP World Tour Masters 1000 Paris France ATP World Tour Masters 1000,HARD,2,Jerzy Janowicz,Janko Tipsarevic,Jerzy Janowicz,3-6; 6-1; 4-1 RET,Q,108,11,4,35,63,27,35,19,28,0,1,10,46,63,2,3,38,77,26,38,17,39,4,8,11,43,77
2012-10-29 00:00:00.000,ATP World Tour Masters 1000 Paris France ATP World Tour Masters 1000,HARD,2,David Ferrer,Jo-Wilfried Tsonga,David Ferrer,6-2; 7-5,Q,81,1,3,31,56,24,31,17,25,0,0,10,41,56,5,0,36,53,27,36,6,17,6,9,10,33,53
2012-10-29 00:00:00.000,ATP World Tour Masters 1000 Paris France ATP World Tour Masters 1000,HARD,2,Michael Llodra,Sam Querrey,Michael Llodra,7-6(4); 6-3,Q,79,13,1,47,70,38,47,14,23,5,5,11,52,70,9,3,30,61,26,30,15,31,1,2,10,41,61
2012-10-29 00:00:00.000,ATP World Tour Masters 1000 Paris France ATP World Tour Masters 1000,HARD,2,Jerzy Janowicz,Gilles Simon,Jerzy Janowicz,6-4; 7-5,S,89,12,1,40,58,33,40,12,18,0,0,11,45,58,3,2,29,63,21,29,18,34,2,4,11,39,63
2012-10-29 00:00:00.000,ATP World Tour Masters 1000 Paris France ATP World Tour Masters 1000,HARD,2,David Ferrer,Michael Llodra,David Ferrer,7-5; 6-3,S,111,2,1,73,101,46,73,13,28,10,11,11,59,101,5,1,38,62,28,38,9,24,4,7,10,37,62
2012-10-29 00:00:00.000,ATP World Tour Masters 1000 Paris France ATP World Tour Masters 1000,HARD,2,David Ferrer,Jerzy Janowicz,David Ferrer,6-4; 6-3,F,88,5,2,52,66,38,52,9,14,3,4,10,47,66,11,6,33,58,23,33,11,25,4,7,9,34,58
